Kashmiri	Urdu		
آ	آ		
أ	أ		
ؤ	ؤ		
إ	إ		
اُ	اُ		
اَ	اَ		
اِ	اِ		
ئ	ئ		
ا	ا		
ب	ب		
ت	ت		
ث	ث		
ج	ج		
ح	ح		
خ	خ		
د	د		
ذ	ذ		
ر	ر		
ز	ز		
س	س		
ش	ش		
ص	ص		
ض	ض		
ط	ط		
ظ	ظ		
ع	ع		
غ	غ		
ف	ف		
ق	ق		
ل	ل		
م	م		
ن	ن		
ہ	ہ		
و	و		
ی	ی		
ک	ک		
پ	پ		
چ	چ		
گ	گ		
ژ	ژ		
ں	ں		
ڑ	ڑ		
ٹ	ٹ		
ڈ	ڈ		
ھ	ھ		
ە	ە		
ے	ے		
ےٚ	ے		
ۄ	و		
ۆ	و		
وٗ	و		
ٲ	اُ	ا	
ٳ	إ	اِ	ا
ؠ	ے		