او	او
بز	بز
خو	خو
ده	ده
سه	سه
شش	شش
نه	نه
نو	نو
گل	گل
گپ	گپ
یک	یک
اهل	اهل
دار	دار
سحر	سحر
شکر	شکر
لنگ	لنگ
هشت	هشت
هفت	هفت
دمبک	دمبک
سلام	سلام
لینگ	لنگ
چاشت	چاشت
کشور	کشور
دمبک	دمبک
ئیران	ایران
اجاره	اجاره
خوتکا	خوتکا
فرهنگ	فرهنگ
جعفری	جعفری
اوهایو	اوهایو
مرغانه	مرغانه
مسلمون	مسلمون