آ	آ
آخر	آخر
آرام	آرام
آزاد	آزاد
آزمائش	آزمائش
آسان	آسان
آسمان	آسمان
آفت	آفت
آلو	آلو
آمد	آمد
آنا	آنا
آواز	آواز
ات	ات
اتحاد	اتحاد
اتر	اتر
اتفاق	اتفاق
اثر	اثر
اجلاس	اجلاس
احتجاج	احتجاج
احساس	احساس
احسان	احسان
اخبار	اخبار
ادا	ادا
اداس	اداس
اداکارہ	اداکارہ
ادب	ادب
اربع	اربع
استاد	استاد
استعمال	استعمال
استقبال	استقبال
اسپتال	اسپتال
اشاعت	اشاعت
اصل	اصل
اصول	اصول
اعتراض	اعتراض
اعتماد	اعتماد
اعلان	اعلان
افسوس	افسوس
اقتباس	اقتباس
الارم	الارم
امتحان	امتحان
امداد	امداد
ان	ان
اناج	اناج
انبار	انبار
انتظار	انتظار
انتظام	انتظام
انجام	انجام
انجمن	انجمن
انداز	انداز
اندر	اندر
انسان	انسان
انعام	انعام
انقلاب	انقلاب
انچ	انچ
او	او
اوت	اوت
اوزار	اوزار
اوسر	اوسر
اون	اون
اپر	اپر
اچرج	اچرج
اک	اک
باب	باب
بار	بار
باغ	باغ
بالغ	بالغ
باوجود	باوجود
بت	بت
بجا	بجا
بحث	بحث
بحران	بحران
بخلاف	بخلاف
بدتر	بَدتَر
بدصورت	بدصورت
برآمد	برآمد
برابر	برابر
برداشت	برداشت
برش	برش
برطرف	برطرف
برف	برف
برقرار	برقرار
بزرگ	بزرگ
بس	بس
بسم	بسم
بصر	بصر
بل	بل
بلبل	بلبل
بلند	بلند
بم	بم
بن	بن
بند	بند
بندا	بندا
بندر	بندر
بندوبست	بندوبست
بوتل	بوتل
بور	بور
بوند	بوند
ت	ت
تاثر	تاثر
تار	تار
تارو	تارو
تالا	تالا
تتر	تتر
تحفظ	تحفظ
ترا	ترا
ترنم	ترنم
تسلسل	تسلسل
تشدد	تشدد
تصور	تصور
تعارف	تعارف
تعجب	تعجب
تعداد	تعداد
تعلق	تعلق
تمام	تمام
تنور	تنور
تنگ	تنگ
تہ	تہ
ثابت	ثابت
ثقافت	ثقافت
ج	ج
جادو	جادو
جال	جال
جان	جان
جاندار	جاندار
جبل	جبل
جج	جج
جدا	جدا
جدول	جدول
جذبا	جذبا
جرم	جرم
جستجو	جستجو
جسم	جسم
جشن	جشن
جلد	جلد
جم	جم
جمع	جمع
جنگ	جنگ
جواب	جواب
جوالا	جوالا
جوش	جوش
جون	جون
حاصل	حاصل
حالت	حالت
حد	حد
حساب	حساب
حساس	حساس
حسن	حسن
حضور	حضور
حفاظت	حفاظت
حل	حل
خادم	خادم
خاص	خاص
خال	خال
خالص	خالص
خاموش	خاموش
خاندان	خاندان
خبر	خبر
خبردار	خبردار
ختم	ختم
خدا	خدا
خدمت	خدمت
خراب	خراب
خروج	خروج
خروش	خروش
خرچ	خرچ
خصلت	خصلت
خضر	خضر
خط	خط
خلا	خلا
خلاف	خلاف
خلق	خلق
خواب	خواب
خود	خود
خوش	خوش
خوف	خوف
د	د
داخل	داخل
داد	داد
داستان	داستان
دامن	دامن
دان	دان
در	در
درآمد	درآمد
درخواست	درخواست
درد	درد
درس	درس
دشمن	دشمن
دعوت	دعوت
دفاع	دفاع
دفن	دفن
دل	دل
دلدار	دلدار
دم	دم
دماغ	دماغ
دوا	دوا
دوران	دوران
دوزخ	دوزخ
دوست	دوست
ذات	ذات
را	را
رات	رات
راز	راز
راغب	راغب
راقم	راقم
رت	رت
رجحان	رجحان
رخ	رخ
رد	رد
رس	رس
رش	رش
رعب	رعب
رفتار	رفتار
رقم	رقم
رنگ	رنگ
رواج	رواج
روح	روح
روزگار	روزگار
روشن	روشن
رول	رول
رکان	رکان
زال	زال
زبان	زبان
زبردست	زبردست
زخم	زخم
زور	زور
زون	زون
سا	سا
سائنس	سائنس
ساخت	ساخت
سال	سال
سامان	سامان
سان	سان
سبب	سبب
سبق	سبق
ست	ست
ستر	ستر
سج	سج
سخت	سخت
سر	سر
سرحد	سرحد
سرنگ	سرنگ
سرگرم	سرگرم
سزا	سزا
سست	سست
سطح	سطح
سفارش	سفارش
سفر	سفر
سلاد	سلاد
سلام	سلام
سماج	سماج
سمجھ	سمجھ
سن	سن
سند	سند
سندس	سندس
سو	سو
سوال	سوال
سور	سور
سوراخ	سوراخ
سوپ	سوپ
سوچ	سوچ
سچ	سچ
سک	سک
سگنل	سگنل
شاخ	شاخ
شاعر	شاعر
شام	شام
شامل	شامل
شانت	شانت
شاگرد	شاگرد
شراب	شراب
شرح	شرح
شرم	شرم
شروع	شروع
شروعات	شروعات
شعر	شعر
شق	شق
شمار	شمار
شو	شو
شور	شور
شوق	شوق
صاف	صاف
صبح	صبح
صبر	صبر
صحت	صحت
صدر	صدر
صرف	صرف
صفا	صفا
صلاح	صلاح
صنعت	صنعت
صنف	صنف
صور	صور
صورت	صورت
ضرب	ضرب
ضرور	ضرور
ضرورت	ضرورت
ضمانت	ضمانت
طبل	طبل
طرز	طرز
طلب	طلب
طوفان	طوفان
ظالم	ظالم
ظرف	ظرف
ظلم	ظلم
عائد	عائد
عادت	عادت
عام	عام
عامل	عامل
عبرت	عبرت
عجب	عجب
عذر	عذر
عزت	عزت
عزم	عزم
عشق	عشق
عصر	عصر
علاج	علاج
علم	علم
عمارت	عمارت
عمر	عمر
عمل	عمل
عنوان	عنوان
عورت	عورت
غائب	غائب
غربت	غربت
غسل	غسل
غلام	غلام
غور	غور
فائرنگ	فائرنگ
فاتح	فاتح
فارم	فارم
فتح	فتح
فر	فر
فرار	فرار
فرد	فرد
فرصت	فرصت
فرض	فرض
فرق	فرق
فرم	فرم
فروغ	فروغ
فصل	فصل
فضا	فضا
فطرت	فطرت
فعل	فعل
فلم	فلم
فلو	فلو
فن	فن
فوج	فوج
فون	فون
قائم	قائم
قابل	قابل
قانون	قانون
قبول	قبول
قتل	قتل
قد	قد
قدر	قدر
قدرت	قدرت
قدم	قدم
قرض	قرض
قسم	قسم
قطار	قطار
قلم	قلم
قوت	قوت
قوم	قوم
لاء	لاء
لائسنس	لائسنس
لات	لات
لانچ	لانچ
لاچار	لاچار
لباس	لباس
لطف	لطف
لغت	لغت
لفظ	لفظ
لنچ	لنچ
لوز	لوز
لک	لک
ماء	ماء
ماجرا	ماجرا
ماحول	ماحول
مارچ	مارچ
مال	مال
مان	مان
ماپ	ماپ
متاثر	متاثر
متفق	متفق
متن	متن
مثال	مثال
مجال	مجال
محدود	محدود
محفل	محفل
محفوظ	محفوظ
محقق	محقق
محل	محل
محلات	محلات
مخالف	مخالف
مختصر	مختصر
مختلف	مختلف
مخلص	مخلص
مدت	مدت
مدد	مدد
مددگار	مددگار
مدمقابل	مدمقابل
مذاق	مذاق
مرد	مرد
مرعوب	مرعوب
مرمت	مرمت
مرچ	مرچ
مزاج	مزاج
مزاح	مزاح
مزاحمت	مزاحمت
مزدور	مزدور
مسافر	مسافر
مست	مست
مستقبل	مستقبل
مستقل	مستقل
مسجد	مسجد
مسلسل	مسلسل
مسند	مسند
مشتمل	مشتمل
مشغول	مشغول
مشن	مشن
مصروف	مصروف
مضبوط	مضبوط
مضطرب	مضطرب
مضمون	مضمون
مطابقت	مطابقت
مطلب	مطلب
مطلق	مطلق
مطمئن	مطمئن
معاف	معاف
معتبر	معتبر
معصوم	معصوم
مفت	مفت
مفصل	مفصل
مقتول	مقتول
مقدار	مقدار
مقرر	مقرر
مقصد	مقصد
مقطع	مقطع
ملاح	ملاح
ملازم	ملازم
ملازمت	ملازمت
ملامت	ملامت
من	من
مناسب	مناسب
مناسبت	مناسبت
منتظم	منتظم
منزل	منزل
منظر	منظر
منظم	منظم
منظور	منظور
منفرد	منفرد
مواد	مواد
موبائل	موبائل
موت	موت
موثر	موثر
موج	موج
موجود	موجود
موسم	موسم
موضوع	موضوع
موقف	موقف
نابالغ	نابالغ
ناجائز	ناجائز
نادر	نادر
ناراض	ناراض
ناز	ناز
نازل	نازل
ناس	ناس
نامعلوم	نامعلوم
ناول	ناول
ناچ	ناچ
نرم	نرم
نروس	نروس
نس	نس
نسبتا	نسبتا
نشان	نشان
نشر	نشر
نظام	نظام
نظر	نظر
نظم	نظم
نعمت	نعمت
نفرت	نفرت
نقاب	نقاب
نقاد	نقاد
نقد	نقد
نقصان	نقصان
نمائش	نمائش
نماز	نماز
نمودار	نمودار
نو	نو
نوجوان	نوجوان
نومبر	نومبر
وات	وات
واحد	واحد
وار	وار
واضح	واضح
واقع	واقع
واقف	واقف
واپس	واپس
واچ	واچ
واہ	واہ
وجوب	وجوب
وجود	وجود
ور	ور
ورق	ورق
وزن	وزن
وسعت	وسعت
وصف	وصف
وقت	وقت
پار	پار
پالتو	پالتو
پان	پان
پاپ	پاپ
پتلون	پتلون
پر	پر
پرامن	پرامن
پرت	پرت
پرجوش	پرجوش
پرواز	پرواز
پروگرام	پروگرام
پرچم	پرچم
پرک	پرک
پسند	پسند
پل	پل
پلنگ	پلنگ
پن	پن
پنج	پنج
پورو	پورو
پکا	پکا
چاء	چاء
چار	چار
چارج	چارج
چال	چال
چراغ	چراغ
چرچ	چرچ
چلم	چلم
چند	چند
چور	چور
چورس	چورس
چپ	چپ
کان	کان
کن	کن
کوکر	کوکر
گانا	گانا
گر	گر
گرم	گرم
گرمائش	گرمائش
گروپ	گروپ
گریبان	گریبان
گفتگو	گفتگو
گلاس	گلاس
گمان	گمان
گن	گن
گنجائش	گنجائش
گوشت	گوشت
گھر	گھر