ەو	و
ڕق	رق
ڕک	رك
ڕی	ري
ڤی	وي
کر	كر
کم	كم
کو	كو
کۆ	كو
کی	كي
یا	يا
یش	يش
یه	يه
ەوە	و
ڕوو	رو
ڕێز	رز
ڕێو	رو
ڕێک	رك
ڕێی	ري
ڕەت	رت
ڕەخ	رخ
ڕەد	رد
ڕەز	رز
ڕەش	رش
ڕەق	رق
ڕەی	ري
ڤەب	وب
ڤەد	ود
ڤەل	ول
کرێ	كر
کوو	كو
کوێ	كو
کێت	كت
کێر	كر
کێش	كش
کێف	كف
کێم	كم
کێن	كن
کێی	كي
کەت	كت
کەد	كد
کەر	كر
کەس	كث
کەش	كش
کەل	كل
کەم	كم
کەن	كن
کەو	كو
کەڕ	كر
کەی	كي
یێن	ين
یەد	يد
یەل	يل
یەم	يم
یەن	ين
ڕام	رام
ڕان	ران
ڕزا	رضا
ڕشو	رشو
ڕفو	رفو
ڕقی	رقي
ڕوح	روح
ڕود	رود
ڕوز	روض
ڕوس	روث
ڕول	رول
ڕون	رون
ڕووە	رو
ڕوی	روي
ڕوەو	رو
ڕکن	ركن
ڕۆب	روب
ڕۆح	روح
ڕۆد	رود
ڕۆز	روض
ڕۆس	روث
ڕۆل	رول
ڕۆم	روم
ڕۆن	رون
ڕۆک	روك
ڕۆڵ	رول
ڕۆی	روي
ڕیا	ريا
ڕید	ريد
ڕیز	ريض
ڕیس	ريث
ڕیش	ريش
ڕین	رين
ڕێزێ	رز
ڕێکێ	رك
ڕەئس	رث
ڕەئی	ري
ڕەشە	رش
ڤین	وين
ڤەدێ	ود
کات	كات
کار	كار
کال	كال
کان	كان
کاڵ	كال
کتی	كتي
کرا	كرا
کرس	كرس
کرم	كرم
کرن	كرن
کرو	كرو
کرۆ	كرو
کری	كري
کشت	كشط
کلم	كلم
کلک	كلك
کلی	كلي
کوت	كوت
کوخ	كوخ
کور	كور
کوم	كوم
کون	كون
کوڕ	كور
کڕی	كري
کۆت	كوت
کۆد	كود
کۆر	كور
کۆم	كوم
کۆن	كون
کۆڕ	كور
کۆک	كوك
کۆی	كوي
کیت	كيت
کیر	كير
کیس	كيس
کیف	كيف
کین	كين
کێشێ	كش
کێشە	كش
کێلێ	كل
کێیە	كي
کەبێ	كب
کەبە	كب
کەسێ	كث
کەسە	كث
کەشە	كش
کەلە	كل
کەمە	كم
کەڕێ	كر
یدا	يدآ
یشی	يشي
ینک	ينك
یون	يون
یۆن	يون
ڕولێ	رول
ڕووت	روت
ڕووس	روث
ڕووم	روم
ڕوون	رون
ڕووی	روي
ڕویێ	روي
ڕوەوە	رو
ڕۆلێ	رول
ڕۆڵە	رول
ڕیشە	ريش
ڕیێس	ريث
ڕێزا	رضا
ڕێزم	رزم
ڕێزن	رزن
ڕێزو	رضو
ڕێزی	رضي
ڕێسا	رثا
ڕێکا	ركا
ڕێکی	ركي
ڕێیا	ريا
ڕەبۆ	ربو
ڕەتی	رتي
ڕەحۆ	رحو
ڕەدی	ردي
ڕەزا	رضا
ڕەزم	رزم
ڕەزو	رضو
ڕەشت	رشت
ڕەشی	رشي
ڕەعد	رعد
ڕەها	رها
ڕەوا	روا
ڕەوت	روت
ڕەوش	روش
ڕەوی	روي
ڤێرا	ورآ
ڤێلا	ولا
ڤەکر	وكر
کاتێ	كات
کاتە	كات
کارێ	كار
کارە	كار
کانێ	كان
کانە	كان
کاڵێ	كال
کتێب	كتب
کرنێ	كرن
کروو	كرو
کریە	كري
کرێم	كرم
کرێن	كرن
کرێک	كرك
کرێی	كري
کورێ	كور
کورە	كور
کوڕە	كور
کوێت	كوت
کوێر	كور
کوێی	كوي
کۆنە	كون
کۆڕێ	كور
کۆیە	كوي
کێری	كري
کێشا	كشا
کێشی	كشي
کێلی	كلي
کێمی	كمي
کێنت	كنت
کێوی	كوي
کێڵی	كلي
کێیت	كيت
کەئەم	كم
کەئەو	كو
کەبۆ	كبو
کەتا	كتا
کەتی	كتي
کەرت	كرت
کەری	كري
کەسا	كسا
کەسم	كثم
کەسن	كثن
کەسو	كسو
کەسی	كثي
کەشی	كشي
کەلا	كلا
کەمن	كمن
کەمی	كمي
کەنا	كنا
کەهی	كهي
کەوت	كوت
کەوی	كوي
کەڤن	كون
کەڵک	كلك
کەیت	كيت
کەیس	كيس
کەیف	كيف
کەین	كين
یەزد	يضد
یەنی	يني
یەکم	يكم
یەکن	يكن
یەکو	يكو
ڕامی	رامي
ڕاوی	راوي
ڕایس	رايس
ڕحمن	رحمن
ڕحیم	رحيم
ڕستم	رستم
ڕستن	رثتن
ڕسول	رسول
ڕشاد	رشاد
ڕشتن	رشتن
ڕشید	رشيد
ڕفعت	رفعت
ڕفیق	رفيق
ڕقیب	رقيب
ڕمزی	رمزي
ڕوبن	روبن
ڕوحی	روحي
ڕوزی	روضي
ڕوسی	روسي
ڕولی	رولي
ڕوما	روما
ڕوونە	رون
ڕووەک	روك
ڕوڵی	رولي
ڕۆبن	روبن
ڕۆحی	روحي
ڕۆزا	روضا
ڕۆسی	روسي
ڕۆشن	روشن
ڕۆلا	رولا
ڕۆلی	رولي
ڕۆما	روما
ڕۆمی	رومي
ڕۆڵی	رولي
ڕیاز	رياض
ڕیال	ريال
ڕیان	ريان
ڕیاڵ	ريال
ڕیزا	ريضا
ڕیمی	ريمي
ڕێزێن	رزن
ڕێکێن	ركن
ڕەجەب	رجب
ڕەخنێ	رخن
ڕەخنە	رخن
ڕەسەن	رسن
ڕەفەح	رفح
ڕەوشە	روش
ڕەوەز	روض
ڤارت	وارت
ڤاری	واري
ڤیلا	ويلا
ڤەلەد	ولد
ڤەکەن	وكن
کادر	كادر
کارا	كارا
کارت	كارت
کارل	كارل
کارم	كارم
کارن	كارن
کارڵ	كارل
کاری	كاري
کازم	كاظم
کاسی	كاسي
کافی	كافي
کامل	كامل
کامڵ	كامل
کاڵا	كالا
کاڵی	كالي
کتاب	كتاب
کتێبە	كتب
کحول	كحول
کراس	كراث
کرام	كرام
کران	كران
کردی	كردي
کرمی	كرمي
کرنا	كرنا
کروز	كروز
کرۆز	كروز
کرۆم	كروم
کریم	كريم
کرین	كرين
کریک	كريك
کفاح	كفاح
کفری	كفري
کلۆر	كلور
کمال	كمال
کهول	كهول
کوبا	كوبا
کورت	كورت
کوری	كوري
کوفی	كوفي
کوما	كوما
کونی	كوني
کوڕن	كورن
کوڕی	كوري
کویت	كويت
کوین	كوين
کوەێت	كوت
کڕین	كرين
کۆئێن	كون
کۆتا	كوتا
کۆدی	كودي
کۆرا	كورا
کۆرت	كورت
کۆری	كوري
کۆفی	كوفي
کۆلا	كولا
کۆما	كوما
کۆنن	كونن
کۆنی	كوني
کۆڕی	كوري
کۆکا	كوكا
کیان	كيان
کیری	كيري
کیفن	كيفن
کیلو	كيلو
کیلۆ	كيلو
کیلی	كيلي
کینی	كيني
کێشێن	كشن
کێشەی	كشي
کەبوو	كبو
کەبەر	كبر
کەبەو	كبو
کەدوو	كدو
کەرتێ	كرت
کەرتە	كرت
کەرەم	كرم
کەسێت	كثت
کەسێن	كثن
کەسەر	كسر
کەسەو	كسو
کەسەی	كثي
کەشێک	كشك
کەشەڕ	كشر
کەلێن	كلن
کەلێی	كلي
کەلەف	كلف
کەلەم	كلم
کەلەک	كلك
کەهەم	كهم
کەهەن	كهن
کەوتە	كوت
کەوێت	كوت
کەوەک	كوك
کەڕوو	كرو
کەڕێز	كرز
کەیسە	كيس
یادی	يادي
یاسر	ياسر
یحیی	يحيي
یشدا	يشدا
یوئێن	يون
یوتا	يوطا
یورۆ	يورو
یوری	يوري
یوسا	يوصا
یوسف	يوسف
یوسی	يوصي
یونس	يونس
یۆتا	يوطا
یۆرو	يورو
یۆرک	يورك
یۆرۆ	يورو
یۆسف	يوسف
یۆنس	يونس
یەدەک	يدك
یەمەن	يمن
یەکەم	يكم
یەکەو	يكو
ەوەتا	وطا
ڕوئیا	رويا
ڕولێن	رولن
ڕووحی	روحي
ڕووسی	روسي
ڕۆبێن	روبن
ڕۆسێل	روسل
ڕۆمەن	رومن
ڕۆڵەی	رولي
ڕیشەی	ريشي
ڕێباز	رباض
ڕێبین	ربين
ڕێزان	رزان
ڕێمان	رمان
ڕێنما	رنما
ڕێڤین	روين
ڕێکان	ركان
ڕێیان	ريان
ڕەبان	ربان
ڕەحیم	رحيم
ڕەخسا	رخصا
ڕەدیف	رديف
ڕەزاق	رزاق
ڕەسام	رسام
ڕەسمی	رسمي
ڕەسول	رسول
ڕەسوڵ	رسول
ڕەسەنێ	رسن
ڕەشاد	رشاد
ڕەشدا	رشدا
ڕەشید	رشيد
ڕەشەوە	رشو
ڕەفیق	رفيق
ڕەقیب	رقيب
ڕەمزی	رمزي
ڕەوتا	روتا
ڕەوشا	روشا
ڕەوشی	روشي
ڕەیان	ريان
ڤەکرن	وكرن
ڤەکری	وكري
کادرێ	كادر
کارتە	كارت
کارێن	كارن
کارەب	كارب
کارەم	كارم
کارەی	كاري
کازمە	كاظم
کاسێت	كاست
کاهێل	كاهل
کاوەی	كاوي
کتێبی	كتبي
کردەی	كردي
کرینە	كرين
کورتە	كورت
کورێن	كورن
کورەی	كوري
کوڕەی	كوري
کوێری	كوري
کوەیت	كويت
کڵێسا	كلسا
کیسەی	كيسي
کێبڵی	كبلي
کێشان	كشان
کێشەکە	كشك
کێشەیە	كشي
کێڤین	كوين
کەئەبو	كبو
کەباس	كباس
کەبری	كبري
کەبڕی	كبري
کەبیر	كبير
کەبەبێ	كبب
کەتاب	كتاب
کەدان	كدان
کەدوا	كدوا
کەرار	كرار
کەریم	كريم
کەسان	كثان
کەسدا	كسدا
کەسەوە	كسو
کەشان	كشان
کەلها	كلها
کەلەسێ	كلس
کەمال	كمال
کەمان	كمان
کەماڵ	كمال
کەمدا	كمدا
کەمین	كمين
کەنان	كنان
کەندا	كندا
کەننا	كننا
کەهەیە	كهي
کەڵکم	كلكم
کەیان	كيان
کەیسی	كيسي
کەیفی	كيفي
یووسف	يوسف
یوونس	يونس
یۆزێف	يوزف
یەحیا	يحيا
یەشار	يشار
یەلدا	يلدا
یەمین	يمين
یەکان	يكان
یەکتر	يكتر
یەکدا	يكدا
یەکدی	يكدي
یەکرن	يكرن
یەکلا	يكلا
یەکێتێ	يكت
یەکەمە	يكم
یەکەوە	يكو
یەڵدا	يلدا
ڕامین	رامين
ڕحمان	رحمان
ڕوبین	روبين
ڕوسیا	روسيا
ڕومان	رومان
ڕویان	رويان
ڕۆبرت	روبرت
ڕۆبۆت	روبوت
ڕۆبین	روبين
ڕۆتین	روتين
ڕۆمان	رومان
ڕیازی	رياضي
ڕیسوا	ريثوا
ڕێکەوت	ركوت
ڕەبیعە	ربيع
ڕەجەبی	رجبي
ڕەحمەت	رحمت
ڕەحیمە	رحيم
ڕەستەن	رثتن
ڕەسوول	رسول
ڕەسووڵ	رسول
ڕەسەنن	رصنن
ڕەسەنی	رصني
ڕەفعەت	رفعت
ڕەقەمی	رقمي
ڕەوشەن	روشن
ڕەوشەی	روشي
ڕەوەشی	روشي
ڕەوەند	روند
کابول	كابول
کابوڵ	كابول
کابۆل	كابول
کارلۆ	كارلو
کارین	كارين
کارەبێ	كارب
کاستا	كاستا
کانون	كانون
کاکاو	كاكاو
کتێبەی	كتبي
کراسی	كراسي
کرمان	کرمان
کرینا	كرينا
کشمیر	كشمير
کلارک	كلارك
کلێسەی	كلسي
کوبای	كوباي
کوبرا	كوبرا
کوران	كوران
کوریا	كوريا
کوڕان	كوران
کڵێسەی	كلسي
کۆریا	كوريا
کۆستی	كوستي
کۆلۆن	كولون
کۆمان	كومان
کۆنان	كونان
کۆڵۆن	كولون
کۆیان	كويان
کینیا	كينيا
کێشانە	كشان
کەئاوی	كاوي
کەئێمەش	كمش
کەئەمەش	كمش
کەئەمەی	كمي
کەئەوەی	كوي
کەبەشی	كبشي
کەدەست	كدست
کەرەمی	كرمي
کەسانە	كثان
کەسبەی	كسبي
کەسوود	كسود
کەسەدا	كسدا
کەشەڕی	كشري
کەمینە	كمين
کەنەدا	كندا
کەهێزی	كهذي
کەهەوڵ	كهول
کەوسەر	كوثر
کەڕوون	كرون
کەڕووی	كروي
کەڤنێن	كونن
یابان	يابان
یاسری	ياسري
یاسین	ياسين
یشیان	يشيآن
یعقوب	يعقوب
یلینا	يلينا
ینایر	يناير
یوسفی	يوسفي
یولیا	يوليا
یولیۆ	يوليو
یونان	يونان
یونیۆ	يونيو
یۆسفی	يوسفي
یۆلیۆ	يوليو
یۆنان	يونان
یۆنیۆ	يونيو
یۆهان	يوهان
یەمەنی	يمني
یەکانە	يكان
یەکسەر	يكسر
یەکەمن	يكمن
یەکەمی	يكمي
ڕووسیا	روسيا
ڕوویان	رويان
ڕۆبۆتە	روبوت
ڕۆبێرت	روبرت
ڕۆبەرت	روبرت
ڕۆمانێ	رومان
ڕۆمانە	رومان
ڕێزمان	رزمان
ڕێزیان	رضيان
ڕەبانی	رباني
ڕەحمان	رحمان
ڕەزوان	رضوان
ڕەسوڵی	رسولي
ڕەشوان	رشوان
ڕەمادی	رمادي
ڤەدیتن	وديتن
ڤەکرنا	وكرنا
کارتەر	كارتر
کربوون	كربون
کرێدان	كردان
کووریا	كوريا
کوەیتی	كويتي
کۆسرەت	كوثرت
کێبەریێ	كبري
کێشەکەش	كشكش
کێشەیەش	كشيش
کەئێران	كران
کەئێستا	كثتا
کەئەرکی	كركي
کەبڕوا	كبروا
کەبەرەی	كبري
کەدوێنێ	كدون
کەرەستێ	كرست
کەرەستە	كرست
کەرەوەی	كروي
کەشمیر	كشمير
کەلێوەی	كلوي
کەمالی	كمالي
کەماڵی	كمالي
کەممان	كممان
کەناری	كناري
کەنعان	كنعان
کەوێنەی	كوني
یاریێن	يارين
یەرموک	يرموك
یەزدان	يضدان
یەزیدی	يزيدي
یەعقوب	يعقوب
یەمینی	يميني
یەهودی	يهودي
یەکترن	يكترن
یەکتری	يكتري
یەکسان	يكثان
یەکمان	يكمان
ڕسومات	رسومات
ڕواندا	رواندا
ڕوحانی	روحاني
ڕوسیاو	روسياو
ڕومانی	روماني
ڕوودانێ	رودان
ڕۆتینی	روتيني
ڕۆحانی	روحاني
ڕۆمانی	روماني
ڕۆناڵد	رونالد
ڕێکەوتن	ركوتن
ڕەبیعەی	ربيعي
ڕەسووڵی	رسولي
ڕەمەزان	رمضان
ڤیلیام	ويليام
کارتۆن	كارتون
کارلوس	كارلوس
کارلۆس	كارلوس
کارمان	كارمان
کاریان	كاريان
کاریبی	كاريبي
کارینا	كارينا
کازینۆ	كازينو
کالۆری	كالوري
کامیرا	كاميرا
کراوین	كراوين
کرملین	كرملين
کرواتی	كرواتي
کلدانی	كلداني
کومیدی	كوميدي
کۆمیدی	كوميدي
کیدمان	كيدمان
کینیدی	كينيدي
کەئیستا	كيستا
کەرستێن	كرستن
کەوتبێت	كوتبت
یابانی	ياباني
یەعقووب	يعقوب
یەنایەر	يناير
یەکبوون	يكبون
یەکەمدا	يكمدا
یەکەمین	يكمين
ڕاهێنان	راهنان
ڕووحانی	روحاني
ڕووسیاو	روسياو
ڕۆمانەی	روماني
ڕێکەوتنە	ركوتن
ڕەمەزانێ	رمضان
ڕەمەزانە	رمضان
کارەمان	كارمان
کارەیان	كاريان
کەئافرەت	كافرت
کەرواتی	كرواتي
کەرکەدەن	كركدن
کەنعانی	كنعاني
یاسەمین	ياسمين
یەرموکی	يرموكي
یەکترین	يكترين
ڕاهێنانێ	راهنان
ڕومانیا	رومانيا
ڕوناڵدۆ	رونالدو
ڕۆمانسی	رومانسي
ڕۆمانیا	رومانيا
ڕۆنالدۆ	رونالدو
ڕۆناڵدۆ	رونالدو
کاتیوشا	كاتيوشا
کاتیۆشا	كاتيوشا
کاسۆلیک	كاثوليك
کامیرون	كاميرون
کامیرۆن	كاميرون
کردستان	كردستان
کرواتیا	كرواتيا
کلاسیکی	كلاسيكي
کلینتۆن	كلينتون
کلینیکی	كلينيكي
کۆلۆمبی	كولومبي
کۆڵۆمبی	كولومبي
کیمیاوی	كيمياوي
یونیسکۆ	يونيسكو
یۆنیسکۆ	يونيسكو
یەمەنیان	يمنيان
یەکەممان	يكممان
کارئینان	كارينان
کورسیەکی	كورسيكي
کیلومەتر	كيلومتر
کەرواتیا	كرواتيا
کەمبۆدیا	كمبوديا
کارۆلینا	كارولينا
کازخستان	كازخستان
کولومبیا	كولومبيا
یۆڕانیۆم	يورانيوم