باتری	باتری
باج	باج
بادام	بادام
بار	بار
بارە	بار
باران	باران
بارانی	بارانی
بارەبەر	باربر
باربەندی	باربندی
باردار	باردار
بارش	بارش
باروتی	باروتی
بارکێش	بارکش
باری	باری
باریک	باریک
باریکی	باریکی
باز	باز
بازار	بازار
بازارگەرمی	بازارگرمی
بازاری	بازاری
بازرگان	بازرگان
بازرگانی	بازرگانی
بازو	بازو
بازوبەند	بازوبند
بازی	بازی
بازیچە	بازیچە
باسلق	باسلق
باغ	باغ
بافت	بافت
باقی	باقی
بال	بال
بامیە	بامیە
بانو	بانو
بانک	بانک
باک	باک
بت	بت
بوت	بت
بتخانە	بتخانە
بت پەرست	بت پرست
بەجا	بجا
بوخار	بخار
بوخاری	بخاری
بەختیار	بختیار
بەد	بد
بەدبەخت	بدبخت
بەدبین	بدبین
بەدخو	بدخو
بەدقەول	بدقول
بەدمەست	بدمست
بەدمەستی	بدمستی
بەدنام	بدنام
بەدکار	بدکار
بەدکردار	بدکردار
بەرابەر	برابر
بەرباد	برباد
برج	برج
بورج	برج
بەرخوردار	برخوردار
بردن	بردن
برشتە	برشتە
بەرف	برف
برنج	برنج
بەرگ	برگ
بز	بز
بزە	بز
بەزەرەک	بزرک
بەس	بس
بەست	بست
بەستەنی	بستنی
بەستەگی	بستگی
بۆشکە	بشکە
بلبل	بلبل
بلور	بلور
بەلی	بلی
بۆمباران	بمباران
بنە	بن
بەنایی	بنایی
بەندەر	بندر
بەنگ	بنگ
بەنگی	بنگی
بەهار	بهار
بوهار	بهار
بەهاران	بهاران
بەهاری	بهاری
بەهەشت	بهشت
بێهمان	بهمان
بەواسیر	بواسیر
بیابان	بیابان
بیست	بیست
بیستەم	بیستم
بیم	بیم
بیمار	بیمار
بیمارستان	بیمارستان
بیماری	بیماری
بینا	بینا
بینایی	بینایی
تابان	تابان
تابین	تابین
تاج	تاج
تاخیر	تاخیر
تار	تار
تارومار	تارومار
تاریخ	تاریخ
تاریک	تاریک
تاریک کردن	تاریک کردن
تاریکی	تاریکی
تازە	تازە
تازیانە	تازیانە
تازەکار	تازەکار
تالار	تالار
توان	تان
تاوان	تاوان
تەب	تب
تەبر	تبر
تەبەرزین	تبرزین
تەخت	تخت
توخم	تخم
تەراز	تراز
ترازو	ترازو
تەرخون	ترخون
ترس	ترس
ترساندن	ترساندن
ترسناک	ترسناک
ترس و لەرز	ترس و لرز
ترش	ترش
تورش	ترش
ترشاندن	ترشاندن
تەرەقی	ترقی
ترنج	ترنج
ترەک	ترک
تەرک	ترک
تریاک	تریاک
تریاکی	تریاکی
تەسلیم	تسلیم
تەشت	تشت
تەشەر	تشر
تف	تف
تفەنگ	تفنگ
تفەنگساز	تفنگساز
تفو	تفو
تەلاش	تلاش
تەلسک	تلسک
تەلەف	تلف
تەلهە	تله
تماشا	تماشا
تەماشا	تماشا
تمام	تمام
تەمتەراق	تمتراق
تەمەنا	تمنا
تەمیز	تمیز
تەن	تن
توند	تند
توندی	تندی
تەنها	تنها
تەنور	تنور
تەنک	تنک
تەنگ	تنگ
تونگ	تنگ
تەنگدەست	تنگدست
تەنگی	تنگی
توان	توان
توانا	توانا
توانایی	توانایی
توانستن	توانستن
توت	توت
توتیا	توتیا
تەکان	تکان
تەکمیل	تکمیل
تیر	تیر
تیرباران	تیرباران
تیردان	تیردان
تیغ	تیغ
جادوگەر	جادوگر
جادوگەری	جادوگری
جاسوس	جاسوس
جان	جان
جانماز	جانماز
جانەوەر	جانور
جدا	جدا
جودا	جدا
جەلاد	جلاد
جن	جن
جەناب	جناب
جەنجال	جنجال
جەنگ	جنگ
جەنگاوەر	جنگاور
جەو	جو
جواب	جواب
جوال	جوال
جوان	جوان
جەوان	جوان
جوانی	جوانی
جواهێر	جواهر
جەوهەر	جوهر
جەک	جک
جگەر	جگر
جەگەر	جگر
جەگەن	جگن
جیوە	جیوە
حاجی	حاجی
حاشیە	حاشیە
حاملە	حاملە
حەج	حج
حەجاج	حجاج
حەراج	حراج
حەرام	حرام
حەرەکەت	حرکت
حەریر	حریر
حەساب	حساب
حەشەری	حشری
حەشیشە	حشیش
حەلاج	حلاج
حەلوا	حلوا
حەمام	حمام
حومام	حمام
حەنەفی	حنفی
حوکم	حکم
حەیا	حیا
حەیات	حیات
حەیران	حیران
حەیزەران	حیزران
حیلە	حیلە
حەیوان	حیوان
خاتون	خاتون
خار	خار
خاردار	خاردار
خارش	خارش
خال	خال
خام	خام
خان	خان
خانم	خانم
خانە	خانە
خانەزاد	خانەزاد
خاور	خاور
خاوەر	خاور
خاک	خاک
خاکسار	خاکسار
خاکەساری	خاکساری
خاکشیر	خاکشیر
خاکە	خاکە
خەبەر	خبر
خودا	خدا
خەر	خر
خرامان	خرامان
خەرامان	خرامان
خەرج	خرج
خەردەل	خردل
خرس	خرس
خەرف	خرف
خەرەف	خرف
خورما	خرما
خەروار	خروار
خەز	خز
خەسیس	خسیس
خەشخاش	خشخاش
خشم	خشم
خفتان	خفتان
خول	خل
خەم	خم
خوم	خم
خومار	خمار
خوماری	خماری
خەمیر	خمیر
خەنازیر	خنازیر
خنجەر	خنجر
خنجێر	خنجر
خەنجەربازی	خنجربازی
خەندەق	خندق
خواست	خواست
خواستن	خواستن
خواستەنی	خواستنی
خواهش	خواهش
خود	خود
خودبینی	خودبینی
خودسەری	خودسری
خودپەسند	خودپسند
خورد	خورد
خوێن	خون
خەیار	خیار
خەیانەت	خیانت
خەیر	خیر
خیگ	خیگ
دادپەروەر	دادپرور
دادگەر	دادگر
داربەست	داربست
داروغە	دارغە
دارچین	دارچین
داس	داس
داستان	داستان
داغ	داغ
داغان	داغان
دام	دام
دامەن	دامن
دامێن	دامن
دانا	دانا
دانە	دانە
دایەن	داین
دایە	دایە
دەباغ	دباغ
دەربار	دربار
دەربان	دربان
دەربەست	دربست
دەربەستە	دربست
درەخت	درخت
درەخشان	درخشان
دەردمەند	دردمند
درز	درز
دەرس	درس
دروست	درست
دورست	درست
درشت	درشت
درەنگ	درنگ
دەرهەم	درهم
درەو	درو
دەریا	دریا
دریچە	دریچە
دەست	دست
دەشت	دشت
دشمن	دشمن
دوشمن	دشمن
دشمنی	دشمنی
دوشمنی	دشمنی
دشنە	دشنە
دشوار	دشوار
دوعا	دعا
دەعوا	دعوا
دەعوەت	دعوت
دەف	دف
دەفە	دف
دەفتەر	دفتر
دەفتەردار	دفتردار
دەفن	دفن
دل	دل
دلاوەر	دلاور
دلشاد	دلشاد
دەلیل	دلیل
دەمبل	دمبل
دومل	دمل
دەم کردن	دم کردن
دندان	دندان
دوونی	دنی
دنیا	دنیا
دێهات	دهات
دێهاتی	دهاتی
دهۆل	دهل
دەهەم	دهم
دەرەگە	دەرەگە
دەست بزێو	دەست بزێو
دەوات	دوات
دوازدەهەم	دوازدهم
دوازدە	دوازدە
دەوام	دوام
دواکەوتن	دواکەوتن
دوبارە	دوبارە
دود	دود
دودە	دودە
دودکێش	دودکش
دەوری	دوری
دوشاخە	دوشاخە
دولولە	دولول
دوم	دوم
دونیمە	دونیمە
دوچەندان	دوچندان
دوچەندانە	دوچندان
دوک	دوک
دوچار	دچار
دکان	دکان
دوکان	دکان
دوکاندار	دکاندار
دیو	دی
دیوجامە	دیجامە
دیدار	دیدار
دیدەنی	دیدنی
دەیلەم	دیلم
دین	دین
دیوار	دیوار
رازدار	رازدار
راست	راست
راستە	راست
راستە بازار	راستە بازار
راست کردن	راست کردن
رام	رام
ران	ران
راندن	راندن
رواندن	راندن
راه	راه
راوی	راوی
راپۆرت	راپرت
رب	رب
روب	رب
رەخت	رخت
رەسنە	رسن
رسوا	رسوا
رەعیەت	رعیت
رف	رف
رفە	رف
رەفە	رف
رەفتار	رفتار
رەفتەنی	رفتنی
رەفیق	رفیق
رەم	رم
رەنج	رنج
رێنج	رنج
رەنجبەر	رنجبر
رەنگ	رنگ
رەنگین	رنگین
رەها	رها
رەها کردن	رها کردن
رەهبەر	رهبر
رەواج	رواج
روانە	روانە
روح	روح
رەوش	روش
رەوشەن	روشن
رەگ	رگ
ریا	ریا
ریحان	ریحان
ریز	ریز
ریش	ریش
ریشە	ریشە
زاج	زاج
زانویم	زانیم
زبان	زبان
زبر	زبر
زەبەر	زبر
زەخم	زخم
زرنگ	زرنگ
زرنگی	زرنگی
زرە	زرە
زشت	زشت
زەعفەران	زعفران
زەعفەرانی	زعفرانی
زلف	زلف
زەمان	زمان
زمستان	زمستان
زمستانی	زمستانی
زەمین	زمین
زەمینگیر	زمینگیر
زەنبیل	زنبیل
زەنجەفیل	زنجفیل
زنجیر	زنجیر
زەنجیر	زنجیر
زەند	زند
زەهرەمار	زهرمار
زیاد	زیاد
زیارەت	زیارت
زیان	زیان
زیبا	زیبا
زیرە	زیرە
زین	زین
ساج	ساج
ساخت	ساخت
ساختمان	ساختمان
ساختومان	ساختمان
سازگار	سازگار
سال	سال
سالار	سالار
ساچمە	ساچمە
سایە	سای
سایەبان	سایبان
سایە	سایە
سەبەب	سبب
سەبز	سبز
سەبەل	سبل
سبیل	سبیل
ستارە	ستارە
ستەم	ستم
ستەمگەر	ستمگر
سەحەر	سحر
سەخت	سخت
سوخرە	سخرە
سۆخرە	سخرە
سەد	سد
سەر	سر
سەران	سران
سەراپا	سراپا
سورب	سرب
سەرباز	سرباز
سەربازگیری	سربازگیری
سەربازی	سربازی
سەرتراش	سرتراش
سەرەخەر	سرخر
سەرد	سرد
سەردار	سردار
سەرسەخت	سرسخت
سوروشت	سرشت
سەرشیر	سرشیر
سەرفراز	سرفراز
سەرەفراز	سرفراز
سەرما	سرما
سەرمەست	سرمست
سەرمەستی	سرمستی
سەرمەشق	سرمشق
سورمە	سرمە
سەرەند	سرند
سرنگ	سرنگ
سەرهەنگ	سرهنگ
سرود	سرود
سەروەر	سرور
سەروەری	سروری
سەروسیما	سروسیما
سەروکار	سروکار
سەرپایی	سرپایی
سەرپەرست	سرپرست
سەرکەش	سرکش
سەرکەشی	سرکشی
سرکە	سرکە
سەرگەردان	سرگردان
سەرگین	سرگین
سورین	سرین
سست	سست
سستی	سستی
سفتە	سفتە
سەفەر	سفر
سفرە	سفرە
سفلیس	سفلیس
سەقا	سقا
سلاح	سلاح
سەلاخ	سلاخ
سەلەم	سلم
سەم	سم
سماق	سماق
سەماوەر	سماور
سەمت	سمت
سمتراش	سمتراش
سمتەراش	سمتراش
سمدار	سمدار
سمسار	سمسار
سن	سن
سنبل	سنبل
سەنەد	سند
سەنگ	سنگ
سەنگباران	سنگباران
سەنگتراش	سنگتراش
سەنگتەراش	سنگتراش
سەنگەر	سنگر
سەنگەربەندی	سنگربندی
سەنگەسار	سنگسار
سەنگین	سنگین
سەنگینی	سنگینی
سەهو	سهو
سەوا	سوا
سەواد	سواد
سوار	سوار
سوارە	سوار
سواری	سواری
سوخت	سوخت
سوێسن	سوسن
سپاس	سپاس
سوپاس	سپاس
سپەر	سپر
سپێر	سپر
سپوردە	سپردە
سکەنجەبین	سکنجبین
سکە	سکە
سەگ	سگ
سەگ دەست	سگ دست
سەیاحەت	سیاحت
سیاحەت	سیاحت
سیاهە	سیاهە
سیخ	سیخ
سەید	سید
سیم	سیم
سیما	سیما
سیم بەند	سیم بند
سیمرغ	سیمرغ
سیمورغ	سیمرغ
سیمکێش	سیمکش
سینەما	سینما
سینە	سینە
سینی	سینی
سینەباز	سینەباز
سیورسات	سیورسات
سیگار	سیگار
شاخە	شاخ
شاخ	شاخ
شاخدار	شاخدار
شاخە	شاخە
شاد	شاد
شادمان	شادمان
شادومان	شادمان
شادمانی	شادمانی
شاش	شاش
شاقول	شاقول
شانزدە	شانزدە
شانس	شانس
شانە	شانە
شاه	شاه
شاگرد	شاگرد
شایان	شایان
شایەد	شاید
شایستە	شایستە
شەبدەر	شبدر
شەبستان	شبستان
وشتر	شتر
شحنە	شحنە
شەربەت	شربت
شەربەت ساز	شربت ساز
شەرع	شرع
شەرەف	شرف
شەرم	شرم
شەرمسار	شرمسار
شەرمەسار	شرمسار
شەرمساری	شرمساری
شەرمەساری	شرمساری
شەریف	شریف
شریک	شریک
شەریک	شریک
شەست	شست
شەشەم	ششم
شێعر	شعر
شفا	شفا
شەفتالو	شفتالو
شفرە	شفرە
شەل	شل
شەلە	شل
شەلاق	شلاق
شەلوار	شلوار
شمار	شمار
شمارە	شمارە
شەمەد	شمد
شمشیر	شمشیر
شەمع	شمع
شەمعدان	شمعدان
شناو	شنا
شوناس	شناس
شناسایی	شناسایی
شناسنامە	شناسنامە
شنەوا	شنوا
شەهر	شهر
شەهید	شهید
شەپنی	شەپنی
شوم	شوم
شک	شک
شکار	شکار
شەکر	شکر
شەکەر	شکر
شەکرپەنیر	شکرپنیر
شەکەرپەنیر	شکرپنیر
شکەست	شکست
شکەستن	شکستن
شیراز	شیراز
شیربرنج	شیربرنج
شیربەها	شیربها
شیرخشت	شیرخشت
شیرینکار	شیرینکار
شیشە	شیشە
شیشەک	شیشک
شیعە	شیعە
شیون	شین
شیون کردن	شین کردن
شیوەن	شیون
عاج	عاج
عاجی	عاجی
عادەت	عادت
عادەت کردن	عادت کردن
عادی	عادی
عار	عار
عاشق	عاشق
عالم	عالم
عالەمەن	عالەمەن
عەبا	عبا
عەبد	عبد
عەداوەت	عداوت
عورف	عرف
عەزیز	عزیز
عشایر	عشایر
عەشایەر	عشایر
عەلامەت	علامت
عەمارەت	عمارت
عەمر	عمر
عومر	عمر
عەن	عن
عەنبەر	عنبر
عەبد	عەبد
عەورەت	عورت
عەیار	عیار
عید	عید
عەید	عید
عەینەک	عینک
غار	غار
غازە	غازە
غەریب	غریب
غز	غز
غەم	غم
غەمناک	غمناک
غەمگین	غمگین
غونچە	غنچە
غەدر	غەدر
غەز	غەز
غەزا	غەزا
غەیب	غیب
غەیبەت	غیبت
غەیر	غیر
فارس	فارس
فاش	فاش
فال	فال
فانی	فانی
فەتق	فتق
فتنە	فتنە
فتوا	فتوا
فتیلە	فتیلە
فدا	فدا
فدایی	فدایی
فرار	فرار
فەراهەم	فراهم
فێرز	فرز
فرزەند	فرزند
فەرزین	فرزین
فرستادە	فرستادە
فرسەخ	فرسخ
فرشتە	فرشتە
فەرق	فرق
فرمان	فرمان
فەرمان	فرمان
فەرمانبەردار	فرمانبردار
فەرمایش	فرمایش
فریب	فریب
فریزوو	فریز
فشفشە	فشفشە
فەقیر	فقیر
فلان	فلان
فەلەج	فلج
فلفل	فلفل
فنجان	فنجان
فندق	فندق
فەندەک	فندک
فەنەر	فنر
فەهم	فهم
فوارە	فوارە
فوون	فوون
فکر	فکر
فیس	فیس
فیل	فیل
قاب	قاب
قاتمە	قاتمە
قارچ	قارچ
قافیە	قافیە
قاقوولە	قاقلە
قاقم	قاقم
قاقوم	قاقم
قالب	قالب
قالیچە	قالیچە
قانع	قانع
قاوەتوون	قاوەتوون
قەبر	قبر
قەدیم	قدیم
قەران	قران
قوربانی	قربانی
قرتی	قرتی
قورعە	قرعە
قرمز	قرمز
قەز	قز
قسمەت	قسمت
قەشەنگ	قشنگ
قەفەس	قفس
قوفل	قفل
قەقنەس	ققنس
قولاب	قلاب
قولە	قلە
قلیان	قلیان
قومار	قمار
قومارباز	قمارباز
قومارخانە	قمارخانە
قومار کردن	قمار کردن
قوماش	قماش
قومری	قمری
قومقومە	قمقمە
قەناری	قناری
قەند	قند
قەندان	قندان
قەسقان	قەسقان
قورت	قورت
قەپاندار	قپاندار
قەی	قی
قیر	قیر
قیمەت	قیمت
قیمە	قیمە
قەیچی	قیچی
لات	لات
لاجوەرد	لاجورد
لاجوەردی	لاجوردی
لازم	لازم
لاستیک	لاستیک
لاشە	لاش
لاشە	لاشە
لاف	لاف
لال	لال
لالایی	لالایی
لالی	لالی
لالەزار	لالەزار
لامپە	لامپ
لاک	لاک
لاکی	لاکی
لایین	لایین
لەب	لب
لباس	لباس
لەبالەب	لبالب
لەبلەبی	لبلبی
لحیم	لحیم
لەحیم	لحیم
لۆرد	لرد
لەشکر	لشکر
لوعاب	لعاب
لەعل	لعل
لەعنەت	لعنت
لەق	لق
لەقەب	لقب
لوقمە	لقمە
لەمس	لمس
لنگ	لنگ
لنگە	لنگ
لەنگ	لنگ
لەنگی	لنگی
لەقاندن	لەقاندن
لەقەم کردن	لەقەم کردن
لەنجباز	لەنجباز
لەکم	لەکم
لەیزین	لەیزین
لەوح	لوح
لوچە	لوچ
لۆپ	لپ
لچک	لچک
لەچەک	لچک
لەچک	لچک
لکە	لکە
لەگەن	لگن
لیاو	لیاو
لیز	لیز
لیست	لیست
لەیلاج	لیلاج
لیوان	لیوان
لێدان	لێدان
لەلە	لەلە
ماتەم	ماتم
ماتەمین	ماتمین
مادەر	مادر
مادەرزاد	مادرزاد
مار	مار
مارگیر	مارگیر
ماست	ماست
ماسە	ماسە
ماسک	ماسک
ماسکە	ماسک
ماعدە	ماعدە
مالامال	مالامال
ماما	ماما
مانع	مانع
مانەند	مانند
ماهی	ماهی
ماچە	ماچە
ماژ	ماژ
مبارەک	مبارک
مبالات	مبالات
مەبلەغ	مبلغ
متەحەیر	متحیر
مەتر	متر
مەترە	متر
متەهەم	متهم
مجری	مجری
مەجنون	مجنون
مەحرەم	محرم
مەحەک	محک
مەحکەم	محکم
مەحکوم	محکوم
مخالف	مخالف
مدارا	مدارا
مدەت	مدت
مەدەدکار	مددکار
مدیر	مدیر
مودیر	مدیر
مراد	مراد
مرەبا	مربا
مەرجان	مرجان
مەرحەبا	مرحبا
مەرحەمەت	مرحمت
مردار	مردار
موردار	مردار
مردار کردن	مردار کردن
مەردم	مردم
مێردم	مردم
مردن	مردن
مەردەن	مردن
مێردی	مردی
مەرز	مرز
مرمەکی	مرمکی
مەرهەم	مرهم
مەرەکەب	مرکب
مەرگ	مرگ
مرید	مرید
مریەم	مریم
مەزار	مزار
مزد	مزد
مزەور	مزور
مسافر	مسافر
مسافەرەت	مسافرت
مەست	مست
مستەحەق	مستحق
مەستەر	مستر
مەست کردن	مست کردن
مەستی	مستی
مسوار	مسوار
مسگەر	مسگر
مسین	مسین
مشایخ	مشایخ
مشایەخ	مشایخ
مشت	مشت
مشتاق	مشتاق
مشتە	مشتە
مەشق	مشق
مشک	مشک
مەشک	مشک
مەعاف	معاف
مەعدەن	معدن
مغازە	مغازە
مەغز	مغز
مفت	مفت
مفتێ	مفت
موفتی	مفتی
مقەوا	مقوا
ملاقات	ملاقات
مولاقات	ملاقات
ملایم	ملایم
ملەت	ملت
مەلەس	ملس
مەلمەل	ململ
مەلەوانی	ملوانی
مەملەکەت	مملکت
ممکون	ممکن
من	من
مناجات	مناجات
منارە	منارە
مناسب	مناسب
منافق	منافق
منەت	منت
مەنجەنیق	منجنیق
مەنجوق	منجوق
مەنزەل	منزل
مەنفەعەت	منفعت
منم	منم
مەنی	منی
مەهار	مهار
مەهارەت	مهارت
مەهار کردن	مهار کردن
موهر	مهر
مەیل	مەیل
مەیوە	مەیوە
مو	مو
مێو	مو
مەوجود	موجود
موێش	موش
موەفەق	موفق
مووخل	مووخل
موود	موود
مووچ	مچ
مژدە	مژدە
موژدە	مژدە
مژە	مژە
مژەو	مژە
مەگەر	مگر
مەگەس	مگس
مەی	می
میان	میان
مەیان	میان
میانە	میانە
میانی	میانی
مەیدان	میدان
میرزا	میرزا
میز	میز
مەیسەر	میسر
میل	میل
میوە	میوە
میوەجات	میوەجات
ناباب	ناباب
ناتەوان	ناتوان
ناحیە	ناحیە
ناخودا	ناخدا
ناخون	ناخن
نارنج	نارنج
نارنجەک	نارنجک
نارنجۆک	نارنجک
نارنگی	نارنگی
ناز	ناز
نازەنین	نازنین
نازونیمناز	نازونیمناز
نازک	نازک
ناز کردن	ناز کردن
نازکەش	نازکش
نازکەی	نازکی
ناس	ناس
ناسازگار	ناسازگار
ناشایستە	ناشایست
ناشایستە	ناشایستە
ناشتا	ناشتا
ناشی	ناشی
نافەرمان	نافرمان
نام	نام
نامەحرەم	نامحرم
نامەدار	نامدار
نامەرد	نامرد
نامردی	نامردی
نامی	نامی
نامە	نامە
نان	نان
نانە	نان
نان بەیات	نان بیات
نان ساجی	نان ساجی
نانەوا	نانوا
نانەوایی	نانوایی
ناهەموار	ناهموار
ناهەنجار	ناهنجار
ناوکە	ناوکە
ناپەسند	ناپسند
ناپەسەند	ناپسند
ناکام	ناکام
ناکەس	ناکس
ناگەهان	ناگهان
نایاب	نایاب
نەبات	نبات
نەباتی	نباتی
نەبی	نبی
نەترس	نترس
نەجات	نجات
نەجیب	نجیب
نەدیدە	ندید
نرخ	نرخ
نەرخ	نرخ
نەرد	نرد
نەرم	نرم
نەرمی	نرمی
نەرگس	نرگس
نێرگس	نرگس
نزدیک	نزدیک
نەزدیک	نزدیک
نزدیکی	نزدیکی
نەسل	نسل
نۆشادر	نشادر
نشاستە	نشاستە
نشتێر	نشتر
نەعل	نعل
نەفت	نفت
نەفتالین	نفتالین
نەفەر	نفر
نەفەرات	نفرات
نفرین	نفرین
نەفرین	نفرین
نەفس	نفس
نەفەس	نفس
نەقەب	نقب
نەقش	نقش
نم	نم
نەم	نم
نما	نما
نماز	نماز
نمایش	نمایش
نمەد	نمد
نمدار	نمدار
نم نم	نم نم
نمەک	نمک
نمەکدان	نمکدان
نمەک گیر	نمک گیر
نەنگ	ننگ
نەنگین	ننگین
نەهەم	نهم
نەهەمین	نهمین
نەهەنگ	نهنگ
نەهی	نهی
نەو	نە
نو	نو
نەو	نو
نەوا	نوا
نەوار	نوار
نەوجوان	نوجوان
نەوەد	نود
نەوزاد	نوزاد
نەوش	نوش
نەوع	نوع
نەژاد	نژاد
نۆک	نک
نگین	نگین
نەی	نی
نیان	نیان
نیست	نیست
نەیشەکر	نیشکر
نەیشەکەر	نیشکر
نیل	نیل
نیمچە	نیمچە
هار	هار
هاون	هاون
هەجو	هجو
هەدەر	هدر
هەدەف	هدف
هەر	هر
هۆر	هر
هەراسە	هراس
هۆراسان	هراسان
هەردەم	هردم
هۆردو	هردو
هێرە	هرە
هەرکەس	هرکس
هەریەک	هریک
هزار	هزار
هەزار	هزار
هەزاران	هزاران
هەزارپا	هزارپا
هەست و نیست	هست و نیست
هەستی	هستی
هەشتم	هشتم
هەشتەم	هشتم
هشتن	هشتن
هێشتن	هشتن
هوشیار	هشیار
هۆشیار	هشیار
هوشیاری	هشیاری
هۆشیاری	هشیاری
هەفت	هفت
هەلاهەل	هلاهل
هوما	هما
هەمان	همان
هەمدەرد	همدرد
هەمدەم	همدم
هەمسەر	همسر
هەم پەیمان	هم پیمان
هندی	هندی
هنر	هنر
هنەر	هنر
هەنەر	هنر
هنەرمەند	هنرمند
هەوەس	هوس
هەیبەت	هیبت
هیس	هیس
هەیهات	هیهات
هوویچ	هیچ
هیچ	هیچ
هیچکارە	هیچکارە
هەیکەل	هیکل
واجب	واجب
واجبی	واجبی
وادار	وادار
وادار کردن	وادار کردن
واز	واز
واشەر	واشر
والی	والی
وام	وام
وامداری	وامداری
واژە	واژە
واکس	واکس
واکسی	واکسی
واگۆن	واگن
وای	وای
وجدان	وجدان
ورد	ورد
وەرشکست	ورشکست
وەرشکستە	ورشکست
وەرەم	ورم
وز	وز
وەزارەت	وزارت
وزەوز	وزوز
وەزیر	وزیر
وسمە	وسمە
وسواس	وسواس
وەفا	وفا
وەفات	وفات
وەفادار	وفادار
وەقت	وقت
وەقف	وقف
ول	ول
وەل	ول
وەکیل	وکیل
وەیلان	ویلان
پا	پا
پاداش	پاداش
پارتی	پارتی
پارسەنگ	پارسنگ
پاس	پاس
پاسەبان	پاسبان
پاسوخ	پاسخ
پالان	پالان
پاکار	پاکار
پاکەت	پاکت
پاکی	پاکی
پایان	پایان
پایتەخت	پایتخت
پایەدار	پایدار
پایەداری	پایداری
پایین	پایین
پەتو	پتو
پەخش	پخش
پەرست	پرست
پەرستار	پرستار
پەروا	پروا
پەرواری	پرواری
پەرواز	پرواز
پەروەردگار	پروردگار
پەرچ	پرچ
پەری	پری
پەست	پست
پەستو	پستو
پۆست کردن	پست کردن
پەستی	پستی
پەسند کردن	پسند کردن
پشت	پشت
پەشم	پشم
پەشمەک	پشمک
پەشیمان	پشیمان
پف	پف
پوف	پف
پل	پل
پەلەشتی	پلشتی
پەلەنگ	پلنگ
پۆلیس	پلیس
پەنج	پنج
پێنج	پنج
پەنجاهەمین	پنجاهمین
پەنهان	پنهان
پەنهانی	پنهانی
پەنیر	پنیر
پەکەر	پکر
پەی	پی
پیاز	پیاز
پیواز	پیاز
پەیام	پیام
پەیامبەر	پیامبر
پەیاپەی	پیاپی
پەی بردن	پی بردن
پەیدا	پیدا
پەیدا کردن	پیدا کردن
پیر	پیر
پیری	پیری
پەیغام	پیغام
پەیغەمبەر	پیغمبر
پیل	پیل
پەیمان	پیمان
پەیمان بەستن	پیمان بستن
پەیوەست	پیوست
پیپ	پیپ
پەیک	پیک
پەیکار	پیکار
پەیکەر	پیکر
پەی کردن	پی کردن
چابک	چابک
چابوک	چابک
چادر	چادر
چادرنشین	چادرنشین
چارک	چارک
چارۆک	چارک
چاشت	چاشت
چاشنی	چاشنی
چاق	چاق
چالاک	چالاک
چاودار	چاودار
چاپ	چاپ
چاک	چاک
چای	چای
چەتر	چتر
چەترباز	چترباز
چۆرت	چرت
چەرخ	چرخ
چەرم	چرم
چرک	چرک
چوست	چست
چوستی	چستی
چێشتە	چشتە
چەفت	چفت
چلە	چلە
چەمەدان	چمدان
چەمەن	چمن
چەموش	چموش
چنار	چنار
چەند	چند
چەنگ	چنگ
چەپ	چپ
چەک	چک
چیت	چیت
چیرە	چیر
چیغ	چیغ
چیمەن	چیمن
چین	چین
چینە	چینە
چینی	چینی
کاخ	کاخ
کار	کار
کارت	کارت
کارخانە	کارخانە
کارد	کارد
کارنامە	کارنامە
کاروان	کاروان
کاروانسەرا	کاروانسرا
کاروانی	کاروانی
کاروبار	کاروبار
کار کردن	کار کردن
کارگەر	کارگر
کارگوزار	کارگزار
کاری	کاری
کارە	کارە
کاسە	کاس
کاس	کاس
کاسب	کاسب
کاسنی	کاسنی
کاسە	کاسە
کاشکی	کاشکی
کاشی	کاشی
کافر	کافر
کال	کال
کامێران	کامران
کاهو	کاهو
کاک	کاک
کاکول	کاکل
کەباب	کباب
کەبابچی	کبابچی
کبریت	کبریت
کۆت	کت
کتری	کتری
کەتری	کتری
کەج	کج
کدو	کدو
کەرامات	کرامات
کەربەلا	کربلا
کەرخ	کرخ
کوردستان	کردستان
کوردستانی	کردستانی
کردم	کردم
کردن	کردن
کورسی	کرسی
کرم	کرم
کەرم	کرم
کورم	کرم
کورک	کرک
کەرگەدەن	کرگدن
کەس	کس
کێس	کس
کەسب	کسب
کش	کش
کەشان کەشان	کشان کشان
کەشاکەش	کشاکش
کشت	کشت
کوشتار	کشتار
کوشتن	کشتن
کەشتی	کشتی
کێشدار	کشدار
کەشمەکەش	کشمکش
کوشندە	کشندە
کەش و فش	کش و فش
کەشک	کشک
کەشیش	کشیش
کەف	کف
کوفار	کفار
کەفتار	کفتار
کفر	کفر
کوفر	کفر
کەفش	کفش
کفن	کفن
کەفەن	کفن
کفک	کفک
کوفک	کفک
کەفگیر	کفگیر
کول	کل
کەلات	کلات
کلۆفت	کلفت
کەلەم	کلم
کلید	کلید
کلیسا	کلیسا
کەما	کما
کەمان	کمان
کەمانگەر	کمانگر
کەمەر	کمر
کەمەربەند	کمربند
کەمەرکەش	کمرکش
کەمەند	کمند
کەمی	کمی
کێمی	کمی
کەمین	کمین
کەنار	کنار
کونج	کنج
کەندن	کندن
کنشت	کنشت
کەنشتە	کنشت
کنگر	کنگر
کەنگر	کنگر
کۆنگرە	کنگرە
کەهر	کهر
کەهەر	کهر
کەهرەبا	کهربا
کەهریز	کهریز
کەنداڵ	کەنداڵ
کەودەن	کودن
کوێر	کور
کوێرانە	کورانە
کوێرکوێرانە	کورکورانە
کوێری	کوری
کوزە	کوز
کوفتە	کوفت
کەولی	کولی
کوه	کوه
کوچک	کوچک
کەپر	کپر
کەپەر	کپر
کەچەلەی	کچلی
کوچک	کچک
کەک	کک
کۆز	کۆز
کیر	کیر
کیسە	کیسە
کیمیا	کیمیا
کیمیاگەر	کیمیاگر
کینە	کین
کینە	کینە
کەیک	کیک
کێلکی کوڕ	کێلکی کوڕ
کەچی	کەچی
گاودانە	گادانە
گاورس	گارس
گاری	گاری
گاریە	گاری
گاز	گاز
گازر	گازر
گام	گام
گامە	گام
گاو	گاو
گاودانە	گاودانە
گەبر	گبر
گەدا	گدا
گەدایی	گدایی
گرانبەها	گرانبها
گرانجان	گرانجان
گەردش	گردش
گەردن	گردن
گەردەن	گردن
گەردنبەند	گردنبند
گورز	گرز
گرفتار	گرفتار
گەرم	گرم
گەرما	گرما
گێرما	گرما
گەرم کردن	گرم کردن
گەرمی	گرمی
گورگ	گرگ
گریاندن	گریاندن
گریە	گریە
گریوە	گریە
گوستاخ	گستاخ
گوشاد	گشاد
گفتار	گفتار
گولزار	گلزار
گلە	گلە
گلیم	گلیم
گم	گم
گوم	گم
گومان	گمان
گۆمان	گمان
گم کردن	گم کردن
گمی	گمی
گومی	گمی
گوناه	گناه
گوناهکار	گناهکار
گەنج	گنج
گەندم	گندم
گەندمی	گندمی
گۆنگ	گنگ
گوارا	گوارا
گەواه	گواه
گەواهی	گواهی
گەوەزن	گوزن
گوەش	گوش
گەون	گون
گەوەن	گون
گوێنی	گونی
گونیا	گونیا
گەچ	گچ
گێچ	گچ
گێچکار	گچکار
گەچکاری	گچکاری
گێچکاری	گچکاری
گیج	گیج
گیرەم	گیرم
گیرودار	گیرودار
گیروگرفت	گیروگرفت
گیسو	گیس
گیوە	گیوە
یا	یا
یاجوج	یاجوج
یاد	یاد
یادگاری	یادگاری
یاور	یار
یارا	یارا
یارد	یارد
یاردە	یارد
یازدەهەم	یازدهم
یازدەهەمین	یازدهمین
یازدە	یازدە
یاس	یاس
یاسەمین	یاسمین
یاغی	یاغی
یال	یال
یالدار	یالدار
یاوەر	یاور
یەتیم	یتیم
یەخبەندان	یخبندان
یەخنی	یخنی
یەخ کردن	یخ کردن
یەرەقان	یرقان
یەزدانی	یزدانی
یوسر	یسر
یەشم	یشم
یەعنی	یعنی
یەلدا	یلدا
یەلەک	یلک
یەواش	یواش
یەواشکی	یواشکی
یەک	یک
یەکان	یکان
یەکتاپەرست	یکتاپرست
یەکتاپەرستی	یکتاپرستی
یەکسان	یکسان
یەکپا	یکپا