گز	گز
گپ	گپ
آیا	آیا
ابی	ابی
اشک	اشک
بزا	بزا
بوز	بوز
بکت	بکت
تَه	ته
تِه	ته
تیز	تیز
جفت	جفت
حقه	حقه
خشن	خشن
خطا	خطا
خطی	خطی
خلج	خلج
خوک	خوک
خوی	خوی
دون	دون
ذره	ذره
راز	راز
راش	راش
رخت	رخت
زند	زند
ستم	ستم
سرک	سرک
سله	سله
سیب	سیب
شمه	شمه
شنا	شنا
صبر	صبر
صفت	صفت
ضعف	ضعف
طاق	طاق
طعم	طعم
عمق	عمق
غضب	غضب
فدا	فدا
قرق	قرق
قشم	قشم
لام	لام
لپه	لپه
لکه	لکه
موز	موز
نبی	نبی
نجم	نجم
ننه	ننه
وهن	وهن
ویر	ویر
پرد	پرد
پشم	پشم
پیت	پیت
چرم	چرم
چول	چول
کام	کام
کری	کری
کِه	که
گذر	گذر
گرگ	گرگ
آریا	آریا
آسان	آسان
اخته	اخته
اهدا	اهدا
اوره	اوره
باشی	باشی
بندی	بندی
بنفش	بنفش
بینی	بینی
تحمل	تحمل
تحول	تحول
ترقی	ترقی
تشنج	تشنج
توقف	توقف
تکاب	تکاب
ثریا	ثریا
جاسم	جاسم
جمعی	جمعی
جناح	جناح
جوار	جوار
حاوی	حاوی
حسنه	حسنه
حصیر	حصیر
حیاط	حیاط
خاکه	خاکه
خرما	خرما
خسته	خسته
خمین	خمین
خوان	خوان
خوزه	خوزه
خویش	خویش
خیار	خیار
دارن	دارن
دانا	دانا
دقیق	دقیق
دهان	دهان
دوار	دوار
دوزی	دوزی
دیدن	دیدن
رسما	رسما
روان	روان
رکاب	رکاب
ریزه	ریزه
زاکه	زاکه
زخمی	زخمی
زنان	زنان
سرنا	سرنا
سرور	سرور
سرپا	سرپا
سلیم	سلیم
سنقر	سنقر
سپری	سپری
شاخص	شاخص
شادی	شادی
شبان	شبان
شراب	شراب
شربت	شربت
شعبه	شعبه
شفیع	شفیع
شهدی	شهدی
شگون	شگون
صوفی	صوفی
عشاق	عشاق
عنصر	عنصر
غالب	غالب
غمزه	غمزه
فاتح	فاتح
فرات	فرات
فردا	فردا
فرید	فرید
فسفر	فسفر
فیات	فیات
قالی	قالی
قانع	قانع
قران	قران
قطره	قطره
لالا	لالا
لانه	لانه
لیلا	لیلا
مثله	مثله
مخفف	مخفف
مرقد	مرقد
مزار	مزار
مشرق	مشرق
معاش	معاش
معرب	معرب
مغان	مغان
ملال	ملال
منبت	منبت
منطق	منطق
منفی	منفی
مهری	مهری
موجب	موجب
موظف	موظف
مینا	مینا
نجات	نجات
نصرت	نصرت
نفیس	نفیس
نقده	نقده
نمود	نمود
نهاد	نهاد
نوبت	نوبت
نویس	نویس
هجده	هجده
هرچه	هرچه
واره	واره
واله	واله
پاشا	پاشا
پاچه	پاچه
پسند	پسند
پهنه	پهنه
پوره	پوره
چوکا	چوکا
کافه	کافه
کرون	کرون
کشیش	کشیش
کلات	کلات
کوثر	کوثر
گفته	گفته
گفتی	گفتی
گلیم	گلیم
گمرک	گمرک
گنبد	گنبد
گوید	گوید
یواش	یواش
آخرسر	آخرسر
آشفته	آشفته
آلوچه	آلوچه
آنجلس	آنجلس
ابتلا	ابتلا
ابعاد	ابعاد
احوال	احوال
اخبار	اخبار
ارجاع	ارجاع
ارنست	ارنست
اسرار	اسرار
اشعار	اشعار
اشکال	اشکال
المان	المان
امواج	امواج
امینی	امینی
انجیر	انجیر
اواسط	اواسط
ایلیا	ایلیا
باشند	باشند
بحران	بحران
بحساب	بحساب
بروجن	بروجن
بلوار	بلوار
بنالم	بنالم
بوکان	بوکان
بیمار	بیمار
تابوت	تابوت
تاراج	تاراج
تاریک	تاریک
ترکیه	ترکیه
تصاحب	تصاحب
تصویر	تصویر
تفسیر	تفسیر
تقاضا	تقاضا
تقدیر	تقدیر
توافق	توافق
توتون	توتون
توران	توران
توزیع	توزیع
تکثیر	تکثیر
جنجال	جنجال
جوانه	جوانه
حاکمه	حاکمه
حقوقی	حقوقی
حماسه	حماسه
حمیدی	حمیدی
داشته	داشته
درختی	درختی
درگاه	درگاه
دزفول	دزفول
دنبال	دنبال
دندان	دندان
دهنده	دهنده
دوشاب	دوشاب
ذخیره	ذخیره
رجایی	رجایی
رسماً	رسماً
زنانه	زنانه
زیارت	زیارت
سرویس	سرویس
سفارت	سفارت
سلماس	سلماس
سلوکی	سلوکی
سنگلج	سنگلج
سپهبد	سپهبد
سیبری	سیبری
شهرام	شهرام
عضویت	عضویت
عقیلی	عقیلی
عمران	عمران
غزاله	غزاله
فاجعه	فاجعه
فاخته	فاخته
فامیل	فامیل
فرانک	فرانک
فریاد	فریاد
قرائت	قرائت
متخلص	متخلص
مجتبی	مجتبی
مجلات	مجلات
محتوا	محتوا
محروم	محروم
مخمصه	مخمصه
مدارک	مدارک
مراحل	مراحل
مستقر	مستقر
مشاغل	مشاغل
مصالح	مصالح
معارف	معارف
ملایر	ملایر
منتهی	منتهی
منظره	منظره
مولوی	مولوی
میناب	میناب
نتایج	نتایج
نگاری	نگاری
هرمزد	هرمزد
هرکسی	هرکسی
همکار	همکار
واقعا	واقعا
وظایف	وظایف
پسران	پسران
پولیس	پولیس
پیشتر	پیشتر
پیمان	پیمان
چندان	چندان
چوپان	چوپان
کناره	کناره
کودنِ	کودن
کوچکی	کوچکی
کویری	کویری
کیایی	کیایی
گلشهر	گلشهر
گودی	گودی
یاران	یاران
یونان	یونان
ییلاق	ییلاق
آباد	آباد
آذرشهر	آذرشهر
آسیایی	آسیایی
اجباری	اجباری
ارجمند	ارجمند
اردکان	اردکان
اعتراف	اعتراف
اعتصاب	اعتصاب
اقتدار	اقتدار
انگیزه	انگیزه
باسواد	باسواد
بانوان	بانوان
بخواند	بخواند
برجسته	برجسته
بردسکن	بردسکن
بردگان	بردگان
بروجرد	بروجرد
بیابان	بیابان
تفکرات	تفکرات
تلگراف	تلگراف
جاندار	جاندار
حبوبات	حبوبات
خرمشهر	خرمشهر
خوانده	خوانده
خودکار	خودکار
خودکشی	خودکشی
دارکوب	دارکوب
دانستن	دانستن
دهلران	دهلران
دوشنبه	دوشنبه
راننده	راننده
رسوایی	رسوایی
رسیدگی	رسیدگی
زیرنظر	زیرنظر
سبزوار	سبزوار
سرشناس	سرشناس
سوسیال	سوسیال
شانزده	شانزده
شاهرود	شاهرود
شایسته	شایسته
شمشیری	شمشیری
شناختن	شناختن
شهروند	شهروند
شهرکرد	شهرکرد
شیرازی	شیرازی
عثمانی	عثمانی
فلسطین	فلسطین
لنکران	لنکران
لواسان	لواسان
لویزان	لویزان
لیبرال	لیبرال
محافظه	محافظه
مخصوصا	مخصوصا
معاونت	معاونت
مقامات	مقامات
مقدونی	مقدونی
ناخالص	ناخالص
نامیده	نامیده
هشت	هشت
ته	ته
هماهنگ	هماهنگ
واگذار	واگذار
وحیدیه	وحیدیه
پامنار	پامنار
پامچال	پامچال
پاناما	پاناما
پاینده	پاینده
پروانه	پروانه
پریشان	پریشان
پهلوان	پهلوان
پوشیده	پوشیده
پیرنیا	پیرنیا
پیشروی	پیشروی
پیچیده	پیچیده
چابهار	چابهار
کارانه	کارانه
کاربرد	کاربرد
کارمند	کارمند
کارگاه	کارگاه
کازرون	کازرون
کره	کره
کوهسار	کوهسار
کیبورد	کیبورد
گوسفند	گوسفند
یارانه	یارانه
یعقوبی	یعقوبی
یکشنبه	یکشنبه
آغداشلو	آغداشلو
استثمار	استثمار
ایکس	ایکس
ایستگاه	ایستگاه
باغستان	باغستان
برگزیده	برگزیده
بیابانی	بیابانی
بیشترین	بیشترین
تجهیزات	تجهیزات
تزئینات	تزئینات
تقریباً	تقریباً
ثروتمند	ثروتمند
جواهرات	جواهرات
دستاورد	دستاورد
دموکرات	دموکرات
رادیکال	رادیکال
رفسنجان	رفسنجان
شهرسازی	شهرسازی
شهروندی	شهروندی
عربستان	عربستان
علاقمند	علاقمند
فستیوال	فستیوال
مسئولین	مسئولین
مطالعات	مطالعات
وایکینگ	وایکینگ
پذیرفته	پذیرفته
پردیسان	پردیسان
پرندگان	پرندگان
چالدران	چالدران
کاراکتر	کاراکتر
کلانشهر	کلانشهر
گورستان	گورستان
اختیارات	اختیارات
ارتفاعات	ارتفاعات
امیرکبیر	امیرکبیر
ایرانیان	ایرانیان
بارسلونا	بارسلونا
بازیکنان	بازیکنان
بلافاصله	بلافاصله
گاه	گاه
ترانه	ترانه
تکنولوژی	تکنولوژی
خرابکاری	خرابکاری
خرم	خرم
دانشجویی	دانشجویی
دوره	دوره
رسانه	رسانه
غیردولتی	غیردولتی
من	من
واشینگتن	واشینگتن
پستاندار	پستاندار
استراسبرگ	استراسبرگ
اسپانیایی	اسپانیایی
برده	برده
داری	داری
حسین	حسین
دانشجویان	دانشجویان
دموکراتیک	دموکراتیک
روانشناسی	روانشناسی
شریعتمدار	شریعتمدار
صالح	صالح
عضدالدوله	عضدالدوله
فرانسیسکو	فرانسیسکو
مرکزگرایی	مرکزگرایی
نویسندگان	نویسندگان
هخامنشیان	هخامنشیان
نامه	نامه
کاروانسرا	کاروانسرا
تماشاخانه	تماشاخانه
صاحبقرانیه	صاحبقرانیه
غیرانتفاعی	غیرانتفاعی
قدیمی	قدیمی
ویکی	ویکی
بم	بم
تب	تب
خر	خر
مک	مک
نر	نر
ول	ول
چک	چک
کف	کف
گچ	گچ
آمد	آمد
ابا	ابا
ادب	ادب
بدر	بدر
برف	برف
بچه	بچه
بکر	بکر
بگو	بگو
بیل	بیل
تلخ	تلخ
تیغ	تیغ
حسب	حسب
خام	خام
خرج	خرج
خنک	خنک
داغ	داغ
دال	دال
دود	دود
دِه	ده
ذوق	ذوق
راب	راب
ربط	ربط
رفت	رفت
زین	زین
سرو	سرو
سنا	سنا
سپر	سپر
سیم	سیم
شاق	شاق
شمع	شمع
شکم	شکم
صاف	صاف
صدر	صدر
طبس	طبس
ظلم	ظلم
عذر	عذر
عزل	عزل
قوه	قوه
لار	لار
لته	لته
مگر	مگر
ناو	ناو
نزد	نزد
نوک	نوک
نگه	نگه
واج	واج
وال	وال
وتو	وتو
ولز	ولز
پُر	پر
پکن	پکن
چرخ	چرخ
ژنو	ژنو
کال	کال
کدو	کدو
کفش	کفش
گفت	گفت
آران	آران
اتاق	اتاق
اصول	اصول
باری	باری
باغی	باغی
باقر	باقر
بانه	بانه
ببست	ببست
برمن	برمن
بشار	بشار
بعثت	بعثت
بلوط	بلوط
بمرد	بمرد
بورس	بورس
تارم	تارم
تختی	تختی
تعلق	تعلق
جمعا	جمعا
حامد	حامد
حتما	حتما
حسنی	حسنی
حلاج	حلاج
حکیم	حکیم
خاکی	خاکی
خصوص	خصوص
خواص	خواص
خیال	خیال
درزی	درزی
درست	درست
دوام	دوام
رباط	رباط
رسوم	رسوم
رشوه	رشوه
رفاه	رفاه
رومی	رومی
رژیم	رژیم
زبون	زبون
زنگی	زنگی
سلاح	سلاح
سپید	سپید
سکنه	سکنه
سینی	سینی
صدها	صدها
صغیر	صغیر
صلاح	صلاح
عارف	عارف
عاشق	عاشق
عامه	عامه
غلات	غلات
غلتک	غلتک
فایل	فایل
فریب	فریب
فلفل	فلفل
فلوت	فلوت
قائم	قائم
قایم	قایم
قبلی	قبلی
قرون	قرون
قروه	قروه
قطار	قطار
قفسه	قفسه
لرزه	لرزه
ماکو	ماکو
محبت	محبت
محور	محور
مخدر	مخدر
مصلی	مصلی
معبد	معبد
معرض	معرض
معطر	معطر
مقطع	مقطع
ملاط	ملاط
ملحق	ملحق
منشا	منشا
میهن	میهن
نایب	نایب
نجدی	نجدی
نرگس	نرگس
نصفه	نصفه
نعمت	نعمت
نواز	نواز
نورس	نورس
نژند	نژند
نیست	نیست
هراز	هراز
هرجا	هرجا
هیئت	هیئت
والی	والی
وحدت	وحدت
وکیل	وکیل
ویسی	ویسی
ویلن	ویلن
پنجه	پنجه
پیکر	پیکر
چاره	چاره
چیان	چیان
ژانر	ژانر
کاشف	کاشف
کردن	کردن
کنجد	کنجد
کنیم	کنیم
کوله	کوله
کیان	کیان
گولی	گولی
گوهر	گوهر
یزید	یزید
آثاری	آثاری
آشکار	آشکار
ابداع	ابداع
ابراز	ابراز
اتصال	اتصال
اتهام	اتهام
احداث	احداث
ارتقا	ارتقا
اسکان	اسکان
افکار	افکار
اقسام	اقسام
اقلیت	اقلیت
الحاق	الحاق
اکثرا	اکثرا
اکنون	اکنون
بارها	بارها
باقری	باقری
بخارا	بخارا
بدلیل	بدلیل
براری	براری
برطرف	برطرف
برنجی	برنجی
برگرد	برگرد
بستگی	بستگی
بشمار	بشمار
بعداز	بعداز
بقایا	بقایا
بنگاه	بنگاه
بنیاد	بنیاد
بهنام	بهنام
بوئین	بوئین
بودجه	بودجه
بودند	بودند
تأسیس	تأسیس
تجدید	تجدید
تخریب	تخریب
تخلیه	تخلیه
ترکمن	ترکمن
تشییع	تشییع
تعلیم	تعلیم
تماشا	تماشا
تمرکز	تمرکز
تهدید	تهدید
توحید	توحید
توسکا	توسکا
توماس	توماس
جانور	جانور
جزایر	جزایر
جعفری	جعفری
جیرفت	جیرفت
حماسی	حماسی
خاستن	خاستن
خربزه	خربزه
خواهر	خواهر
دارید	دارید
دربند	دربند
دریدی	دریدی
دستان	دستان
دعائی	دعائی
دیدار	دیدار
دیگری	دیگری
رویان	رویان
زمزمه	زمزمه
ستوان	ستوان
سرتیپ	سرتیپ
سرجمع	سرجمع
سفارش	سفارش
سلامت	سلامت
سمیرم	سمیرم
سوفال	سوفال
سپرده	سپرده
شاعری	شاعری
شبانه	شبانه
شروان	شروان
شعبان	شعبان
شهادت	شهادت
طاعون	طاعون
طلایی	طلایی
عظیمی	عظیمی
فتوحی	فتوحی
فدایی	فدایی
فیزیک	فیزیک
قاسمی	قاسمی
قبلاً	قبلاً
قشلاق	قشلاق
قهقهه	قهقهه
لاتین	لاتین
ماهان	ماهان
مبارک	مبارک
مجانی	مجانی
محتشم	محتشم
مخصوص	مخصوص
مدیره	مدیره
مراتب	مراتب
مرجان	مرجان
مرطوب	مرطوب
مشاور	مشاور
مصوبه	مصوبه
مطیعی	مطیعی
معادل	معادل
مقدمه	مقدمه
ملارد	ملارد
نابود	نابود
نامجو	نامجو
نساجی	نساجی
نسترن	نسترن
نظرات	نظرات
همچون	همچون
هنگام	هنگام
واسطه	واسطه
پراید	پراید
پروین	پروین
پنجره	پنجره
پیانو	پیانو
پیوند	پیوند
تا	تا
چپگرا	چپگرا
چکاوک	چکاوک
چیتگر	چیتگر
کاشمر	کاشمر
کانال	کانال
کتیبه	کتیبه
کشیده	کشیده
کودتا	کودتا
کودکی	کودکی
گرفته	گرفته
گرگان	گرگان
گسترش	گسترش
گیرید	گیرید
یخچال	یخچال
ائتلاف	ائتلاف
اجتماع	اجتماع
اختصاص	اختصاص
استعفا	استعفا
اشرفیه	اشرفیه
اعتبار	اعتبار
افزایش	افزایش
امریکا	امریکا
انتقام	انتقام
انشایی	انشایی
انصاری	انصاری
اکبریه	اکبریه
برخورد	برخورد
برعهده	برعهده
بنه	بنه
بر	بر
بهبهان	بهبهان
خاستید	خاستید
خاوران	خاوران
درمانی	درمانی
دیپلمه	دیپلمه
رایگان	رایگان
سراسری	سراسری
سرنوشت	سرنوشت
سلجوقی	سلجوقی
شریعتی	شریعتی
شهیدان	شهیدان
قاضیان	قاضیان
لهستان	لهستان
مادرید	مادرید
مسافرت	مسافرت
مشاوره	مشاوره
مصنوعی	مصنوعی
مقابله	مقابله
مهرنوش	مهرنوش
نابودی	نابودی
ناشناس	ناشناس
نوروزی	نوروزی
هاوانا	هاوانا
همچنان	همچنان
هوادار	هوادار
ولیعصر	ولیعصر
پادگان	پادگان
چناران	چناران
کاملاً	کاملاً
کراوات	کراوات
کریسمس	کریسمس
گسترده	گسترده
آزادشهر	آزادشهر
آماردان	آماردان
آپادانا	آپادانا
اسدالله	اسدالله
اقدامات	اقدامات
اقیانوس	اقیانوس
جایگزین	جایگزین
جلگه	جلگه
حاصلخیز	حاصلخیز
دارستان	دارستان
سینمایی	سینمایی
عاشقانه	عاشقانه
فرزندان	فرزندان
قبرستان	قبرستان
محرمانه	محرمانه
مستعمره	مستعمره
مکانیکی	مکانیکی
نوجوانی	نوجوانی
هنرستان	هنرستان
والیبال	والیبال
تر	تر
چهارراه	چهارراه
کارنامه	کارنامه
کمونیست	کمونیست
آمریکایی	آمریکایی
استراتژی	استراتژی
بازیگران	بازیگران
دموکراسی	دموکراسی
رمضانعلی	رمضانعلی
ساسانیان	ساسانیان
فایرفاکس	فایرفاکس
فرماندهی	فرماندهی
فیروزکوه	فیروزکوه
فیلمنامه	فیلمنامه
ماهیگیری	ماهیگیری
مسلمانان	مسلمانان
مه	مه
آفرید	آفرید
نمایشگاه	نمایشگاه
نمایندگی	نمایندگی
نوجوانان	نوجوانان
مرد	مرد
انتخاباتی	انتخاباتی
جغرافیایی	جغرافیایی
عبدالوهاب	عبدالوهاب
فرانسویان	فرانسویان
بین	بین
سوسیالیستی	سوسیالیستی
رخ	رخ
سگ	سگ
قد	قد
آبا	آبا
اخذ	اخذ
تست	تست
تفت	تفت
توس	توس
جوش	جوش
دنا	دنا
راس	راس
روم	روم
ریز	ریز
زار	زار
زنگ	زنگ
سِد	سد
شاد	شاد
شدن	شدن
صفا	صفا
ظهر	ظهر
عدم	عدم
عطر	عطر
عین	عین
غزل	غزل
غنی	غنی
فاز	فاز
فشم	فشم
فیش	فیش
قله	قله
قند	قند
لغت	لغت
مگس	مگس
ناز	ناز
نما	نما
هضم	هضم
وجه	وجه
وطن	وطن
ولد	ولد
چاه	چاه
چفت	چفت
چمن	چمن
کرم	کرم
کرک	کرک
کمی	کمی
کند	کند
گره	گره
یار	یار
آزار	آزار
آمون	آمون
آنچه	آنچه
آگاه	آگاه
ابهر	ابهر
اسدی	اسدی
اشیا	اشیا
اندی	اندی
ایده	ایده
بستَ	بست
بلند	بلند
بلکه	بلکه
بنده	بنده
بورد	بورد
تراب	تراب
تربت	تربت
تزار	تزار
تلفن	تلفن
تنوع	تنوع
توره	توره
تکیه	تکیه
تیمَ	تیم
جبال	جبال
جدول	جدول
جلسه	جلسه
جلوه	جلوه
جهرم	جهرم
جیمز	جیمز
حمزه	حمزه
حمید	حمید
حیات	حیات
خاست	خاست
خواب	خواب
دلار	دلار
دنده	دنده
دیسک	دیسک
راضی	راضی
رفیع	رفیع
روده	روده
ریزی	ریزی
سالم	سالم
سرشت	سرشت
سفال	سفال
سلطه	سلطه
سوار	سوار
سیصد	سیصد
سینا	سینا
شاهد	شاهد
شدید	شدید
شمار	شمار
شهاب	شهاب
عرصه	عرصه
عشرت	عشرت
عقاب	عقاب
عموم	عموم
فعلی	فعلی
فلاح	فلاح
فَدا	فدا
قائل	قائل
قادر	قادر
قاطر	قاطر
قبیل	قبیل
قرچک	قرچک
قندی	قندی
لحظه	لحظه
مارچ	مارچ
مبدأ	مبدأ
متمم	متمم
محرم	محرم
مدال	مدال
مدیر	مدیر
مربا	مربا
مسکن	مسکن
مطلب	مطلب
مفید	مفید
منشأ	منشأ
میله	میله
نگاه	نگاه
پراگ	پراگ
پرچم	پرچم
پزشک	پزشک
پسته	پسته
چادر	چادر
چاقو	چاقو
کارل	کارل
کاست	کاست
کالا	کالا
کاهش	کاهش
کشمش	کشمش
کلام	کلام
کلان	کلان
کلاه	کلاه
گرزه	گرزه
ابوذر	ابوذر
اخوان	اخوان
اسباب	اسباب
اسناد	اسناد
اعیان	اعیان
اموال	اموال
انبوه	انبوه
انگور	انگور
بابِل	بابل
باقلا	باقلا
بنفشه	بنفشه
بهشتی	بهشتی
تأثیر	تأثیر
تجاوز	تجاوز
تشخیص	تشخیص
تقلید	تقلید
تهاجم	تهاجم
توکلی	توکلی
جریان	جریان
جنایت	جنایت
جنگجو	جنگجو
جولای	جولای
خاصیت	خاصیت
خانگی	خانگی
خواهد	خواهد
دهانه	دهانه
دهکده	دهکده
رسانی	رسانی
رضایی	رضایی
ساعته	ساعته
سهامی	سهامی
سواحل	سواحل
شاهان	شاهان
شیطان	شیطان
ضمیمه	ضمیمه
طالبی	طالبی
ظرفیت	ظرفیت
عقیده	عقیده
غذایی	غذایی
فیروز	فیروز
قربان	قربان
قطعات	قطعات
لازمه	لازمه
متحرک	متحرک
متعصب	متعصب
متعلق	متعلق
مجتهد	مجتهد
محصول	محصول
محکوم	محکوم
مراکز	مراکز
مسئله	مسئله
مسئول	مسئول
مشابه	مشابه
مطالب	مطالب
مملکت	مملکت
ممنوع	ممنوع
مناره	مناره
منحصر	منحصر
موارد	موارد
موسوی	موسوی
موسیو	موسیو
ناگاه	ناگاه
ندارد	ندارد
نشینی	نشینی
نظریه	نظریه
نوزاد	نوزاد
نویسی	نویسی
هستند	هستند
پارچه	پارچه
چمران	چمران
کلاله	کلاله
کمبود	کمبود
کیوان	کیوان
گرایش	گرایش
گرگین	گرگین
آتشکده	آتشکده
آسفالت	آسفالت
آشنایی	آشنایی
آناناس	آناناس
اجرایی	اجرایی
ادوارد	ادوارد
استیشن	استیشن
بازدید	بازدید
بره	بره
سر	سر
جویبار	جویبار
خودشان	خودشان
دَشتی	دشتی
رایانه	رایانه
رضاشاه	رضاشاه
رمضانی	رمضانی
روزانه	روزانه
سامانه	سامانه
ساکنین	ساکنین
سرچشمه	سرچشمه
سپاهان	سپاهان
سپهدار	سپهدار
شادمهر	شادمهر
شیروان	شیروان
علویان	علویان
فارسان	فارسان
فوریهٔ	فوریه
قربانی	قربانی
مالیات	مالیات
ماهدشت	ماهدشت
ماهشهر	ماهشهر
محمدیه	محمدیه
مستوفی	مستوفی
مشخصات	مشخصات
مصادره	مصادره
مهندسی	مهندسی
موبایل	موبایل
ناراحت	ناراحت
هنرمند	هنرمند
هنگامه	هنگامه
پرداخت	پرداخت
کهریزک	کهریزک
ابوموسی	ابوموسی
اردشیری	اردشیری
افراشته	افراشته
بسکتبال	بسکتبال
تاریخچه	تاریخچه
تحقیقات	تحقیقات
تظاهرات	تظاهرات
جلوگیری	جلوگیری
شاهزاده	شاهزاده
فریدونی	فریدونی
قاره	قاره
محبوبیت	محبوبیت
محله	محله
مسئولیت	مسئولیت
ویتامین	ویتامین
آموزشگاه	آموزشگاه
خانوادگی	خانوادگی
دومینیکن	دومینیکن
ساوجبلاغ	ساوجبلاغ
نوازندگی	نوازندگی
نگارستان	نگارستان
چریک	چریک
سرا	سرا
نوازندگان	نوازندگان
فرمانروایان	فرمانروایان
باستانشناسان	باستانشناسان
بس	بس
ابر	ابر
اره	اره
ارگ	ارگ
اهر	اهر
بزن	بزن
بمو	بمو
بوم	بوم
بِه	به
بپا	بپا
جسم	جسم
خدا	خدا
خرف	خرف
درم	درم
دری	دری
دقت	دقت
دید	دید
دیر	دیر
ذهن	ذهن
رزن	رزن
رفع	رفع
رنج	رنج
زاد	زاد
زره	زره
سقف	سقف
سوی	سوی
سپه	سپه
شال	شال
شام	شام
شوش	شوش
صفر	صفر
غاز	غاز
فرش	فرش
فرق	فرق
قدر	قدر
قدم	قدم
قسم	قسم
قطع	قطع
قفس	قفس
لذت	لذت
میل	میل
نجف	نجف
نیا	نیا
پنگ	پنگ
کور	کور
کیس	کیس
گرا	گرا
آدام	آدام
آنها	آنها
اسکو	اسکو
اسیر	اسیر
ایام	ایام
بخار	بخار
بخشی	بخشی
تاجر	تاجر
جانب	جانب
جنگی	جنگی
خاتم	خاتم
خرید	خرید
خیام	خیام
دارم	دارم
دایی	دایی
ردیف	ردیف
رسول	رسول
رسید	رسید
روزی	روزی
روند	روند
رکود	رکود
سارا	سارا
ساعی	ساعی
ستون	ستون
سریر	سریر
سعدی	سعدی
سلام	سلام
سکته	سکته
شیعه	شیعه
صحبت	صحبت
صحرا	صحرا
ضربه	ضربه
طالش	طالش
عبور	عبور
لاکو	لاکو
لنگر	لنگر
مجید	مجید
مردی	مردی
مرند	مرند
ملقب	ملقب
مژده	مژده
وزنه	وزنه
پاکت	پاکت
پرست	پرست
پهلو	پهلو
پیست	پیست
چربی	چربی
چندی	چندی
چوله	چوله
کارت	کارت
کاشی	کاشی
کوره	کوره
گوته	گوته
گوشه	گوشه
گوشی	گوشی
آگوست	آگوست
اسحاق	اسحاق
اسکات	اسکات
اشیاء	اشیاء
اعمال	اعمال
اهواز	اهواز
برعکس	برعکس
بیانی	بیانی
تحویل	تحویل
ترتیب	ترتیب
تعزیه	تعزیه
تعطیل	تعطیل
تنظیم	تنظیم
تیلور	تیلور
حسینی	حسینی
حفاظت	حفاظت
خارجه	خارجه
دعایی	دعایی
دهه	دهه
رمضان	رمضان
ریواس	ریواس
سارتر	سارتر
ساسان	ساسان
سردشت	سردشت
سرکوب	سرکوب
سهراب	سهراب
شاهرخ	شاهرخ
شبستر	شبستر
صندلی	صندلی
طاهری	طاهری
عقاید	عقاید
علامه	علامه
عوامل	عوامل
غلامی	غلامی
فاطمی	فاطمی
فهیمه	فهیمه
محبوب	محبوب
محراب	محراب
مرداب	مرداب
مزارع	مزارع
مسافر	مسافر
مصادف	مصادف
ملکان	ملکان
موافق	موافق
موتور	موتور
نوشته	نوشته
نژادی	نژادی
واقعه	واقعه
پیشوا	پیشوا
گذاری	گذاری
گردنه	گردنه
احترام	احترام
اختراع	اختراع
اشتباه	اشتباه
افتخار	افتخار
افسانه	افسانه
انسانی	انسانی
این	این
که	که
برداشت	برداشت
بسیاری	بسیاری
پس	پس
بیرونی	بیرونی
جایگاه	جایگاه
خواندی	خواندی
درگذشت	درگذشت
دسترسی	دسترسی
دستگیر	دستگیر
دلیجان	دلیجان
زاهدان	زاهدان
سردبیر	سردبیر
شیکاگو	شیکاگو
مجاورت	مجاورت
مخالفت	مخالفت
مستقیم	مستقیم
مهربان	مهربان
ناخوشی	ناخوشی
نخستین	نخستین
همراهی	همراهی
چمخاله	چمخاله
ابوطالب	ابوطالب
احتمالا	احتمالا
اردبیلی	اردبیلی
استبداد	استبداد
استعمار	استعمار
بازیگری	بازیگری
بالاخره	بالاخره
تقسیمات	تقسیمات
تماشاگه	تماشاگه
سفیدرود	سفیدرود
سپیدرود	سپیدرود
عادل	عادل
ماندگار	ماندگار
مخابرات	مخابرات
مسئولان	مسئولان
منتقدان	منتقدان
نیاوران	نیاوران
کوهپایه	کوهپایه
آرژانتین	آرژانتین
امپراتور	امپراتور
راهنمایی	راهنمایی
سامانیان	سامانیان
پادشاهان	پادشاهان
چهارشنبه	چهارشنبه
چه	چه
گوارا	گوارا
عبدالرزاق	عبدالرزاق
عبدالفتاح	عبدالفتاح
کارگردانی	کارگردانی
تل	تل
دم	دم
رز	رز
لب	لب
لر	لر
لم	لم
نا	نا
اتو	اتو
ارم	ارم
الی	الی
اوج	اوج
بجا	بجا
بیا	بیا
تور	تور
جدی	جدی
خور	خور
دهد	دهد
رضی	رضی
روس	روس
زخم	زخم
طلب	طلب
ظرف	ظرف
عوض	عوض
قدس	قدس
قطر	قطر
قول	قول
لاک	لاک
موش	موش
نبو	نبو
نسب	نسب
نصر	نصر
نوه	نوه
نَی	نی
نیر	نیر
نیک	نیک
پاک	پاک
چیز	چیز
کتی	کتی
کنه	کنه
گری	گری
گَه	گه
آغوز	آغوز
آنجا	آنجا
اصیل	اصیل
اعظم	اعظم
افرا	افرا
امان	امان
بافت	بافت
بالغ	بالغ
برون	برون
بناب	بناب
تابع	تابع
تخته	تخته
جلال	جلال
جنبش	جنبش
جواد	جواد
حبیب	حبیب
خواه	خواه
خورد	خورد
داده	داده
دشمن	دشمن
رشتِ	رشت
زنید	زنید
زهرا	زهرا
سراب	سراب
سریع	سریع
سقوط	سقوط
سویا	سویا
شهرت	شهرت
شویی	شویی
غلاف	غلاف
فاعل	فاعل
ماسک	ماسک
مالک	مالک
مراد	مراد
مرمت	مرمت
مریم	مریم
مصدر	مصدر
منجر	منجر
میری	میری
نجفی	نجفی
نسخه	نسخه
نشتی	نشتی
هریس	هریس
وانت	وانت
وعده	وعده
ژاپن	ژاپن
ژوئن	ژوئن
کاشت	کاشت
کسری	کسری
کَله	کله
گفتن	گفتن
یحیی	یحیی
یورو	یورو
آسیاب	آسیاب
آینده	آینده
ارباب	ارباب
اشراف	اشراف
اصرار	اصرار
اطاعت	اطاعت
اعزام	اعزام
الهدی	الهدی
اورال	اورال
ایوان	ایوان
بداری	بداری
بلندی	بلندی
تجریش	تجریش
تحلیل	تحلیل
تخمین	تخمین
تعمیر	تعمیر
تعیین	تعیین
توسعه	توسعه
توفیق	توفیق
تومان	تومان
تیمور	تیمور
حاشیه	حاشیه
حسابی	حسابی
حوادث	حوادث
حیدری	حیدری
خشونت	خشونت
خلافت	خلافت
زیاده	زیاده
ساواک	ساواک
سریال	سریال
سکونت	سکونت
شخصیت	شخصیت
شناخت	شناخت
شواهد	شواهد
عدالت	عدالت
فاضله	فاضله
فرشته	فرشته
لوازم	لوازم
لوشان	لوشان
متحده	متحده
متعدد	متعدد
متوجه	متوجه
محمدی	محمدی
مراغه	مراغه
مرعشی	مرعشی
مشکین	مشکین
مطابق	مطابق
مظفری	مظفری
معتبر	معتبر
مهارت	مهارت
نوشهر	نوشهر
هجدهم	هجدهم
پسوند	پسوند
پیاده	پیاده
کاشان	کاشان
کننده	کننده
کیهان	کیهان
یکسان	یکسان
آبکنار	آبکنار
آنلاین	آنلاین
ارومیه	ارومیه
اشتراک	اشتراک
انتظار	انتظار
برابری	برابری
برخلاف	برخلاف
برداری	برداری
بهداشت	بهداشت
خواستی	خواستی
خورشید	خورشید
دامغان	دامغان
داوطلب	داوطلب
درواقع	درواقع
دیگران	دیگران
شیرینی	شیرینی
فارابی	فارابی
لیسانس	لیسانس
ماسوله	ماسوله
مالکیت	مالکیت
محافظت	محافظت
محاکمه	محاکمه
مقاومت	مقاومت
هشترود	هشترود
همسایه	همسایه
یادگار	یادگار
اوستایی	اوستایی
ایتالیا	ایتالیا
جهانشاه	جهانشاه
سفرنامه	سفرنامه
شاگردان	شاگردان
مربیگری	مربیگری
هابرماس	هابرماس
پروفسور	پروفسور
کریستین	کریستین
اختلافات	اختلافات
ایرانشهر	ایرانشهر
رحیم	رحیم
ویرجینیا	ویرجینیا
پیرانشهر	پیرانشهر
کارولینا	کارولینا
کتابخانه	کتابخانه
ابوالقاسم	ابوالقاسم
افغانستان	افغانستان
فرمانداری	فرمانداری
مازندرانی	مازندرانی
کامپیوتری	کامپیوتری
دار	دار
جک	جک
حس	حس
خب	خب
فی	فی
یخ	یخ
آسم	آسم
آنا	آنا
بیت	بیت
بیک	بیک
جسد	جسد
حبس	حبس
حوض	حوض
دام	دام
زال	زال
شکر	شکر
عجب	عجب
عمو	عمو
فرخ	فرخ
قلم	قلم
متن	متن
مرا	مرا
همت	همت
وضع	وضع
ویل	ویل
پای	پای
پله	پله
کشی	کشی
کهن	کهن
گنج	گنج
آخری	آخری
اردک	اردک
اشرف	اشرف
اغلب	اغلب
ببرد	ببرد
بعدا	بعدا
بیژن	بیژن
بیگی	بیگی
تسلط	تسلط
تفکر	تفکر
تلفظ	تلفظ
تماس	تماس
جبهه	جبهه
جلفا	جلفا
جنتی	جنتی
حشره	حشره
خلیل	خلیل
دههٔ	دهه
دواب	دواب
دچار	دچار
رادی	رادی
زارع	زارع
سامی	سامی
سبزی	سبزی
سنجد	سنجد
شاید	شاید
شبیه	شبیه
طغرل	طغرل
طوری	طوری
فرخی	فرخی
قیمت	قیمت
لوله	لوله
ماله	ماله
مانع	مانع
ماهه	ماهه
مرجع	مرجع
مسلح	مسلح
مصدق	مصدق
معنا	معنا
مکمل	مکمل
نقطه	نقطه
نیرو	نیرو
هانس	هانس
هرگز	هرگز
پوشش	پوشش
پیاز	پیاز
چرخه	چرخه
چنار	چنار
کبیر	کبیر
کریم	کریم
گران	گران
گرمی	گرمی
گرچه	گرچه
گلشن	گلشن
ادغام	ادغام
اسلحه	اسلحه
اعصاب	اعصاب
افشار	افشار
امروز	امروز
ایشان	ایشان
بوشهر	بوشهر
تبلیغ	تبلیغ
تحریک	تحریک
تقویت	تقویت
تی	تی
خاتون	خاتون
خاوری	خاوری
خصوصی	خصوصی
خواجه	خواجه
داوود	داوود
درازی	درازی
درویش	درویش
دیوار	دیوار
سرایی	سرایی
سنندج	سنندج
سومین	سومین
فرهاد	فرهاد
قلمرو	قلمرو
مثلاً	مثلاً
مرتبط	مرتبط
مرداک	مرداک
مسیحی	مسیحی
مطهری	مطهری
معاون	معاون
مهران	مهران
ناصری	ناصری
نسبتا	نسبتا
نشانه	نشانه
نعناع	نعناع
نهایت	نهایت
نوازی	نوازی
پارسی	پارسی
پزشکی	پزشکی
کاربر	کاربر
کاملا	کاملا
کانون	کانون
گزارش	گزارش
یازده	یازده
اختصار	اختصار
امتیاز	امتیاز
امروزه	امروزه
بولوار	بولوار
تحولات	تحولات
جمعیتی	جمعیتی
خواهان	خواهان
درگیری	درگیری
روحانی	روحانی
ساسانی	ساسانی
ساکنان	ساکنان
سرمایه	سرمایه
سرپرست	سرپرست
سرکرده	سرکرده
طولانی	طولانی
قوانین	قوانین
مسابقه	مسابقه
مسکونی	مسکونی
مشکلات	مشکلات
موقعیت	موقعیت
نواختن	نواختن
هزاران	هزاران
همزمان	همزمان
پرتقال	پرتقال
کیومرث	کیومرث
آلاباما	آلاباما
تغییرات	تغییرات
جرگه	جرگه
حرفه	حرفه
درخواست	درخواست
سعدآباد	سعدآباد
شورشیان	شورشیان
فرانسوی	فرانسوی
قایقران	قایقران
قهرمانی	قهرمانی
مسابقات	مسابقات
مسلحانه	مسلحانه
نگهداری	نگهداری
گوناگون	گوناگون
وا	وا
آرکانزاس	آرکانزاس
آفریقایی	آفریقایی
الکتریکی	الکتریکی
بازرگانی	بازرگانی
سپهسالار	سپهسالار
هندوستان	هندوستان
هواداران	هواداران
گواتمالا	گواتمالا
تله	تله
کابین	کابین
عباس	عباس
کالیفرنیا	کالیفرنیا
آی	آی
جم	جم
رج	رج
رپ	رپ
نم	نم
آرش	آرش
آفت	آفت
بام	بام
برگ	برگ
بسر	بسر
به	به
تنگ	تنگ
حمل	حمل
داد	داد
دهن	دهن
دیم	دیم
زنی	زنی
سان	سان
سهم	سهم
سکه	سکه
شوی	شوی
فقر	فقر
مرس	مرس
موس	موس
میم	میم
نان	نان
نمی	نمی
هدا	هدا
پهن	پهن
کما	کما
گبه	گبه
اخیر	اخیر
ارشد	ارشد
امور	امور
ایرج	ایرج
بستی	بستی
حزین	حزین
دبیر	دبیر
دیده	دیده
رازی	رازی
راهی	راهی
روسی	روسی
سختی	سختی
سوسن	سوسن
شرمن	شرمن
شیشه	شیشه
طریق	طریق
ظروف	ظروف
قبلا	قبلا
قرآن	قرآن
قصاب	قصاب
لباس	لباس
مادر	مادر
ماری	ماری
متهم	متهم
مجوز	مجوز
محقق	محقق
مشکل	مشکل
مظفر	مظفر
مقصد	مقصد
منزل	منزل
مودت	مودت
نشین	نشین
نیما	نیما
هاشم	هاشم
پنبه	پنبه
گردش	گردش
آبگرم	آبگرم
امانی	امانی
اوضاع	اوضاع
برنده	برنده
تامین	تامین
ترجمه	ترجمه
حیوان	حیوان
خزانه	خزانه
خلاصه	خلاصه
دامنه	دامنه
رساله	رساله
روبرو	روبرو
سنگین	سنگین
سوریه	سوریه
شازند	شازند
طایفه	طایفه
عروسی	عروسی
فهرست	فهرست
فوریه	فوریه
فولاد	فولاد
قوامی	قوامی
قیامه	قیامه
مارکس	مارکس
مایکل	مایکل
متنوع	متنوع
مدارس	مدارس
مردان	مردان
معمار	معمار
ناچار	ناچار
وسیله	وسیله
وظیفه	وظیفه
پاریس	پاریس
چالوس	چالوس
کارگر	کارگر
آبادان	آبادان
اردشیر	اردشیر
افتتاح	افتتاح
انتقال	انتقال
بابلسر	بابلسر
درخشان	درخشان
دستگاه	دستگاه
سیاهکل	سیاهکل
عملکرد	عملکرد
مرکبات	مرکبات
نهاوند	نهاوند
شر	شر
ویلیام	ویلیام
پرشکوه	پرشکوه
یونانی	یونانی
ریچموند	ریچموند
غلامرضا	غلامرضا
قاجاریه	قاجاریه
مطبوعات	مطبوعات
کارگران	کارگران
خوانندگی	خوانندگی
غلامحسین	غلامحسین
استاندارد	استاندارد
رحمت	رحمت
محمودآباد	محمودآباد
نمایشنامه	نمایشنامه
شماری	شماری
ایران	ایران
خودرو	خودرو
حل	حل
کن	کن
باب	باب
بحث	بحث
توت	توت
رکن	رکن
شخص	شخص
شما	شما
صبح	صبح
عده	عده
عسل	عسل
عهد	عهد
عکس	عکس
لله	لله
نفس	نفس
هدی	هدی
ژان	ژان
کان	کان
آینه	آینه
اراک	اراک
اکثر	اکثر
بیان	بیان
حافظ	حافظ
حلقه	حلقه
خلاف	خلاف
خنده	خنده
درام	درام
دهنه	دهنه
دینی	دینی
شاهی	شاهی
شتاب	شتاب
طالب	طالب
عروس	عروس
فرار	فرار
قالب	قالب
قشنگ	قشنگ
نامی	نامی
هویت	هویت
ورزش	ورزش
پیام	پیام
چایی	چایی
کارا	کارا
کمال	کمال
کنید	کنید
گرجی	گرجی
گینه	گینه
یاری	یاری
آرامش	آرامش
احسان	احسان
افراد	افراد
امکان	امکان
باغچه	باغچه
بخاطر	بخاطر
بهانه	بهانه
تحقیق	تحقیق
ترکیب	ترکیب
جابجا	جابجا
جنازه	جنازه
حافظه	حافظه
حقیقت	حقیقت
خاستی	خاستی
خدمات	خدمات
دلایل	دلایل
زمینی	زمینی
سالار	سالار
سایپا	سایپا
سرسبز	سرسبز
شباهت	شباهت
شکنجه	شکنجه
متوقف	متوقف
مشهور	مشهور
معدنی	معدنی
هرچند	هرچند
هزینه	هزینه
ورودی	ورودی
پانصد	پانصد
پردیس	پردیس
پرواز	پرواز
کنسرت	کنسرت
گذشته	گذشته
آریایی	آریایی
اسفناج	اسفناج
امارات	امارات
ایالات	ایالات
دبستان	دبستان
طرفدار	طرفدار
علیرضا	علیرضا
عملیات	عملیات
قانونی	قانونی
محدوده	محدوده
مهاباد	مهاباد
مهاجرت	مهاجرت
هشتگرد	هشتگرد
همدیگر	همدیگر
وفادار	وفادار
پانزده	پانزده
کابینه	کابینه
کشاورز	کشاورز
کلاسیک	کلاسیک
کودکان	کودکان
گیاهان	گیاهان
اشتهارد	اشتهارد
افتخاری	افتخاری
سرپرستی	سرپرستی
سوادکوه	سوادکوه
برخوردار	برخوردار
بریتانیا	بریتانیا
دانشنامه	دانشنامه
سیاره	سیاره
هنرمندان	هنرمندان
سک	سک
غم	غم
قه	قه
مس	مس
بدی	بدی
بشو	بشو
ترس	ترس
جلب	جلب
ذکر	ذکر
رسم	رسم
ریه	ریه
زود	زود
سری	سری
سقز	سقز
شدت	شدت
ضرب	ضرب
ضمن	ضمن
عدس	عدس
عرب	عرب
قطب	قطب
نره	نره
نسق	نسق
نوا	نوا
پاپ	پاپ
کمر	کمر
کیش	کیش
آمفی	آمفی
ادعا	ادعا
امضا	امضا
امید	امید
باند	باند
برنز	برنز
ثروت	ثروت
جوان	جوان
حصار	حصار
حیدر	حیدر
خاصه	خاصه
خوشه	خوشه
داعی	داعی
راجع	راجع
سایه	سایه
سفره	سفره
سینه	سینه
شریف	شریف
عزیز	عزیز
متحد	متحد
مرمر	مرمر
معدن	معدن
معده	معده
مقدس	مقدس
ملکه	ملکه
نقاط	نقاط
نقره	نقره
نوار	نوار
هسته	هسته
ویژه	ویژه
پرده	پرده
چراغ	چراغ
کاغذ	کاغذ
کومه	کومه
گوشت	گوشت
آندره	آندره
ابتدا	ابتدا
الهام	الهام
بررسی	بررسی
بهزاد	بهزاد
تجربه	تجربه
جوانی	جوانی
درازا	درازا
سراسر	سراسر
شاگرد	شاگرد
شمشیر	شمشیر
فلزات	فلزات
مؤسسه	مؤسسه
مستند	مستند
مشترک	مشترک
معلوم	معلوم
منظور	منظور
موسسه	موسسه
نتیجه	نتیجه
نشریه	نشریه
نواحی	نواحی
هوایی	هوایی
هکتار	هکتار
وسایل	وسایل
پیروز	پیروز
چلنگر	چلنگر
گروهی	گروهی
اعتراض	اعتراض
جانشین	جانشین
خواندن	خواندن
دماوند	دماوند
زیبایی	زیبایی
صادرات	صادرات
محاصره	محاصره
معمولی	معمولی
موفقیت	موفقیت
هیجدهم	هیجدهم
انگلیسی	انگلیسی
بازداشت	بازداشت
جرگهٰ	جرگه
دانشمند	دانشمند
محصولات	محصولات
میانگین	میانگین
پورهادی	پورهادی
انتشارات	انتشارات
بازنشسته	بازنشسته
بویراحمد	بویراحمد
فروزانفر	فروزانفر
دانشمندان	دانشمندان
حد	حد
رد	رد
بان	بان
تنه	تنه
جلو	جلو
درک	درک
سنت	سنت
سیر	سیر
شصت	شصت
شور	شور
عدد	عدد
عقب	عقب
فوق	فوق
ملل	ملل
نصف	نصف
کنف	کنف
گاو	گاو
گول	گول
ارزش	ارزش
برپا	برپا
بوته	بوته
بکار	بکار
تبار	تبار
تفرش	تفرش
دارا	دارا
درید	درید
دوده	دوده
دوست	دوست
رایج	رایج
ساخت	ساخت
سیما	سیما
شنبه	شنبه
صادر	صادر
صیقل	صیقل
طارم	طارم
عالم	عالم
عمده	عمده
قبول	قبول
لازم	لازم
مایل	مایل
مدرس	مدرس
مطرح	مطرح
نروژ	نروژ
ورزا	ورزا
وسطی	وسطی
پناه	پناه
گرما	گرما
گوزن	گوزن
آوریل	آوریل
احمدی	احمدی
اشغال	اشغال
اصلاح	اصلاح
انرژی	انرژی
اکران	اکران
باتلر	باتلر
بستان	بستان
بهشهر	بهشهر
تدریس	تدریس
تربیت	تربیت
تلفات	تلفات
حادثه	حادثه
خوردن	خوردن
داراب	داراب
رعایت	رعایت
روایت	روایت
ریاضی	ریاضی
شیراز	شیراز
صفویه	صفویه
منتقل	منتقل
میراث	میراث
نظارت	نظارت
نگاره	نگاره
همیشه	همیشه
وضعیت	وضعیت
چندتا	چندتا
گیتار	گیتار
ابتهاج	ابتهاج
اختیار	اختیار
اعتماد	اعتماد
اندیشه	اندیشه
رضاخان	رضاخان
فرامرز	فرامرز
قهرمان	قهرمان
مراجعه	مراجعه
مرغانه	مرغانه
مکزیکو	مکزیکو
ژانویه	ژانویه
آزادگان	آزادگان
آهنگساز	آهنگساز
اروپایی	اروپایی
رودخانه	رودخانه
شاهنامه	شاهنامه
محمدرضا	محمدرضا
پانزدهم	پانزدهم
پاکستان	پاکستان
چهاردهم	چهاردهم
کاتولیک	کاتولیک
گردشگری	گردشگری
یخبندان	یخبندان
سانتیمتر	سانتیمتر
چهارمحال	چهارمحال
کوهستانی	کوهستانی
خوانندگان	خوانندگان
ترش	ترش
حجم	حجم
خاش	خاش
خزر	خزر
خشت	خشت
سبب	سبب
سده	سده
سند	سند
سپس	سپس
عزت	عزت
مرغ	مرغ
ملا	ملا
نکا	نکا
وصل	وصل
چشم	چشم
گرد	گرد
اهلی	اهلی
جعفر	جعفر
جمعه	جمعه
روشن	روشن
سالِ	سال
شناس	شناس
شیون	شیون
فندق	فندق
قاضی	قاضی
قرمز	قرمز
مسیح	مسیح
معاف	معاف
ممکن	ممکن
میَن	مین
نخست	نخست
نماز	نماز
همان	همان
کشتی	کشتی
گندم	گندم
گویش	گویش
گیری	گیری
اطلاع	اطلاع
البرز	البرز
امنیت	امنیت
باران	باران
برگان	برگان
تجاری	تجاری
ثانیه	ثانیه
دامان	دامان
سعادت	سعادت
صابری	صابری
فاطمه	فاطمه
فدرال	فدرال
فراهم	فراهم
فرزند	فرزند
ماجرا	ماجرا
مجتمع	مجتمع
محسوب	محسوب
معتدل	معتدل
مقبره	مقبره
نوکیا	نوکیا
وادار	وادار
ویولن	ویولن
کریمی	کریمی
انتشار	انتشار
تقریبا	تقریبا
دادگاه	دادگاه
دانشجو	دانشجو
دریافت	دریافت
دوازده	دوازده
سیاهان	سیاهان
سیستان	سیستان
ملاقات	ملاقات
نوامبر	نوامبر
وابسته	وابسته
پیش	پیش
صفوی	صفوی
نوازنده	نوازنده
نویسنده	نویسنده
پارلمان	پارلمان
کوهستان	کوهستان
اسپهبدان	اسپهبدان
اسکاتلند	اسکاتلند
انگلستان	انگلستان
فرماندار	فرماندار
نمایندگان	نمایندگان
طب	طب
گر	گر
آیت	آیت
تجن	تجن
جنس	جنس
دله	دله
دین	دین
شاخ	شاخ
فرح	فرح
نظم	نظم
کول	کول
اونِ	اون
بابا	بابا
باقی	باقی
بهشت	بهشت
ترور	ترور
تنبک	تنبک
توان	توان
جمال	جمال
رتبه	رتبه
روغن	روغن
سرعت	سرعت
غارت	غارت
غریب	غریب
فانی	فانی
فرصت	فرصت
فساد	فساد
مدرن	مدرن
مدرک	مدرک
نادر	نادر
همین	همین
وسعت	وسعت
چوبی	چوبی
کرده	کرده
شهر	شهر
آبادی	آبادی
اداری	اداری
اسفار	اسفار
انبار	انبار
ایشون	ایشون
تشویق	تشویق
تعریف	تعریف
تفاوت	تفاوت
خورده	خورده
رقابت	رقابت
ساخته	ساخته
سواره	سواره
سوخته	سوخته
متوسط	متوسط
معرفی	معرفی
مقابل	مقابل
مواجه	مواجه
هفتاد	هفتاد
هفدهم	هفدهم
کوروش	کوروش
اسکندر	اسکندر
اصطلاح	اصطلاح
اِشکور	اشکور
بدارید	بدارید
برگزار	برگزار
تنکابن	تنکابن
سیزدهم	سیزدهم
شهریار	شهریار
فردوسی	فردوسی
لاهیجی	لاهیجی
مارلیک	مارلیک
مبارزه	مبارزه
مدرسهٔ	مدرسه
مشاهیر	مشاهیر
امکانات	امکانات
اینترنت	اینترنت
دامداری	دامداری
سرشماری	سرشماری
فولکلور	فولکلور
بلوچستان	بلوچستان
زیباکنار	زیباکنار
سامورایی	سامورایی
پرسپولیس	پرسپولیس
شخ	شخ
چو	چو
برد	برد
بیش	بیش
جمع	جمع
رده	رده
ضلع	ضلع
فعل	فعل
فوت	فوت
قتل	قتل
لفظ	لفظ
پیل	پیل
چاک	چاک
کمک	کمک
کود	کود
گله	گله
ادبی	ادبی
انار	انار
اوّل	اول
بافی	بافی
حوزه	حوزه
ساوه	ساوه
سواد	سواد
نفوذ	نفوذ
پایه	پایه
انگیز	انگیز
خاتمه	خاتمه
خلخال	خلخال
درمان	درمان
زمانی	زمانی
ستاره	ستاره
عمومی	عمومی
فاراب	فاراب
مرتضی	مرتضی
معاصر	معاصر
ناحیه	ناحیه
وبلاگ	وبلاگ
کسانی	کسانی
کشوری	کشوری
کوهان	کوهان
آفریقا	آفریقا
آلاسکا	آلاسکا
ارتفاع	ارتفاع
مطالعه	مطالعه
کسمایی	کسمایی
گوستاو	گوستاو
استعداد	استعداد
طالقانی	طالقانی
فرمانده	فرمانده
مترمربع	مترمربع
هواخواه	هواخواه
کردستان	کردستان
بهارستان	بهارستان
آمل	آمل
اهل	اهل
جزء	جزء
جزو	جزو
راد	راد
فرم	فرم
مغز	مغز
نشر	نشر
نصب	نصب
وسط	وسط
چهل	چهل
کیا	کیا
اصغر	اصغر
بدید	بدید
بقیه	بقیه
حاصل	حاصل
حضرت	حضرت
دَره	دره
راست	راست
سازه	سازه
سایر	سایر
سرما	سرما
قطعه	قطعه
مدار	مدار
موقع	موقع
مکان	مکان
نهضت	نهضت
پاره	پاره
پوست	پوست
گیاه	گیاه
آسمان	آسمان
احساس	احساس
افزار	افزار
اقوام	اقوام
تاسیس	تاسیس
خلیفه	خلیفه
درآمد	درآمد
رامسر	رامسر
روانه	روانه
سیزده	سیزده
شاهین	شاهین
صومعه	صومعه
متولد	متولد
محلات	محلات
مرحوم	مرحوم
معتقد	معتقد
مناسب	مناسب
نقاشی	نقاشی
هاشمی	هاشمی
هشتاد	هشتاد
پنجاه	پنجاه
آلمانی	آلمانی
اندازه	اندازه
بالتیک	بالتیک
معمولا	معمولا
پادشاه	پادشاه
پردازش	پردازش
یازدهم	یازدهم
سرانجام	سرانجام
لنگرودی	لنگرودی
پیشنهاد	پیشنهاد
ابوالحسن	ابوالحسن
پورداوود	پورداوود
ناصرالدین	ناصرالدین
اسکاندیناوی	اسکاندیناوی
چپ	چپ
اسم	اسم
تار	تار
درد	درد
راک	راک
زاک	زاک
شرح	شرح
غیر	غیر
فلز	فلز
قلب	قلب
لغو	لغو
ماد	ماد
مصر	مصر
نرم	نرم
نمک	نمک
کوی	کوی
گیر	گیر
بابک	بابک
باور	باور
جالب	جالب
حالت	حالت
داعش	داعش
دستی	دستی
زاهد	زاهد
فارغ	فارغ
مثال	مثال
همسر	همسر
آفتاب	آفتاب
آوازه	آوازه
ابزار	ابزار
اولیه	اولیه
ایجاد	ایجاد
بغداد	بغداد
جاذبه	جاذبه
خمینی	خمینی
دخالت	دخالت
دیدنی	دیدنی
دیوان	دیوان
رابطه	رابطه
سرباز	سرباز
سمیعی	سمیعی
مسائل	مسائل
نارنج	نارنج
نقاره	نقاره
نمونه	نمونه
هدایت	هدایت
ارکستر	ارکستر
اعتقاد	اعتقاد
انتخاب	انتخاب
انتقاد	انتقاد
بهترین	بهترین
خاطرات	خاطرات
زادگاه	زادگاه
پشتکوه	پشتکوه
آرامگاه	آرامگاه
بختیاری	بختیاری
پادشاهی	پادشاهی
دژ	دژ
دهم	دهم
زور	زور
طنز	طنز
قوت	قوت
مهم	مهم
وزن	وزن
گوش	گوش
بابل	بابل
باید	باید
خارج	خارج
خانم	خانم
راحت	راحت
رونق	رونق
ساقه	ساقه
سعید	سعید
عرضه	عرضه
مکتب	مکتب
نبرد	نبرد
ولی	ولی
پارس	پارس
کهنه	کهنه
استخر	استخر
اعراب	اعراب
اکتبر	اکتبر
بادام	بادام
بصورت	بصورت
بهرام	بهرام
تونی	تونی
جمشید	جمشید
دولاب	دولاب
رهبری	رهبری
مجبور	مجبور
مرحله	مرحله
مقدار	مقدار
مهندس	مهندس
پایان	پایان
کوتاه	کوتاه
دریایی	دریایی
متفاوت	متفاوت
محجوبی	محجوبی
مدیریت	مدیریت
مسیحیت	مسیحیت
ورامین	ورامین
پیروزی	پیروزی
کلاچای	کلاچای
علیزاده	علیزاده
فراوانی	فراوانی
بد	بد
گت	گت
حتا	حتا
دان	دان
روح	روح
شبه	شبه
فضا	فضا
قصد	قصد
ملت	ملت
نفت	نفت
پژو	پژو
چله	چله
امین	امین
بانی	بانی
بدنه	بدنه
بهره	بهره
بومی	بومی
تیره	تیره
خسرو	خسرو
خوبی	خوبی
شاخه	شاخه
ماده	ماده
مثبت	مثبت
مثلا	مثلا
مقام	مقام
منبع	منبع
نقشه	نقشه
پلنگ	پلنگ
چاله	چاله
کاظم	کاظم
کلاس	کلاس
انجمن	انجمن
بیستم	بیستم
دقیقه	دقیقه
دهخدا	دهخدا
دومین	دومین
دیپلم	دیپلم
رفتار	رفتار
سادات	سادات
شیرین	شیرین
عبارت	عبارت
قفقاز	قفقاز
ماشین	ماشین
محوطه	محوطه
ابریشم	ابریشم
برقرار	برقرار
بیماری	بیماری
سالانه	سالانه
طالقان	طالقان
منوچهر	منوچهر
دوازدهم	دوازدهم
تلویزیون	تلویزیون
سد	سد
تاج	تاج
جهت	جهت
خشک	خشک
عشق	عشق
فرد	فرد
نقد	نقد
نود	نود
بانو	بانو
بانک	بانک
بردن	بردن
سازی	سازی
صادق	صادق
صفحه	صفحه
فلات	فلات
مانه	مانه
متصل	متصل
موسی	موسی
تسلیم	تسلیم
تقسیم	تقسیم
سیروس	سیروس
شاپور	شاپور
طراحی	طراحی
عباسی	عباسی
فردوس	فردوس
لوبیا	لوبیا
میانه	میانه
ویژگی	ویژگی
چندین	چندین
کنترل	کنترل
جمهوری	جمهوری
دریاچه	دریاچه
دوباره	دوباره
لرستان	لرستان
کانادا	کانادا
کمانچه	کمانچه
اسپانیا	اسپانیا
اصلاحات	اصلاحات
هرمزگان	هرمزگان
کارشناسی	کارشناسی
خان	خان
احمدخان	احمدخان
جز	جز
دفن	دفن
غار	غار
قوی	قوی
مقر	مقر
کوچ	کوچ
یزد	یزد
آدمی	آدمی
بدون	بدون
تهیه	تهیه
ثابت	ثابت
صاحب	صاحب
صحنه	صحنه
فعال	فعال
مسیر	مسیر
معین	معین
ارائه	ارائه
اضافه	اضافه
ایلام	ایلام
فریضه	فریضه
موجود	موجود
احتمال	احتمال
دروازه	دروازه
همه	همه
پیشرفت	پیشرفت
سربازان	سربازان
شانزدهم	شانزدهم
بل	بل
شو	شو
بشر	بشر
طلا	طلا
عمل	عمل
قصر	قصر
قصه	قصه
قمر	قمر
پست	پست
آرام	آرام
حساب	حساب
دفتر	دفتر
رهبر	رهبر
شخصی	شخصی
ظاهر	ظاهر
عربی	عربی
لاله	لاله
واژه	واژه
وقتی	وقتی
ارشاد	ارشاد
دیلمی	دیلمی
سرطان	سرطان
فراوان	فراوان
ورزشگاه	ورزشگاه
شش	شش
قم	قم
بست	بست
زرد	زرد
سرخ	سرخ
صمد	صمد
عمر	عمر
هیچ	هیچ
کشف	کشف
آدرس	آدرس
بقعه	بقعه
حاضر	حاضر
زرین	زرین
ساکن	ساکن
شهره	شهره
عهده	عهده
فروش	فروش
لندن	لندن
مارس	مارس
مالی	مالی
متال	متال
مهسا	مهسا
کاسه	کاسه
کالج	کالج
گرده	گرده
یافت	یافت
یوسف	یوسف
آماده	آماده
اتفاق	اتفاق
اجازه	اجازه
بیرون	بیرون
تبریز	تبریز
تجارت	تجارت
تحصیل	تحصیل
داشتن	داشتن
طبیعت	طبیعت
ماکان	ماکان
مصطفی	مصطفی
مقاله	مقاله
چارلز	چارلز
ازدواج	ازدواج
بازیگر	بازیگر
طهماسب	طهماسب
متوسطه	متوسطه
نزدیکی	نزدیکی
کوهدشت	کوهدشت
تابستان	تابستان
چاپارخانه	چاپارخانه
لا	لا
تقی	تقی
جذب	جذب
جنت	جنت
شغل	شغل
لیگ	لیگ
موج	موج
نیز	نیز
هنر	هنر
چای	چای
تولد	تولد
خاطر	خاطر
روزه	روزه
ریشه	ریشه
ساحل	ساحل
عالی	عالی
لشکر	لشکر
محسن	محسن
مردن	مردن
مشخص	مشخص
مشهد	مشهد
نفره	نفره
نیاز	نیاز
آخرین	آخرین
اینکه	اینکه
دربار	دربار
زلزله	زلزله
شرایط	شرایط
شماره	شماره
یک	یک
داریوش	داریوش
نوزدهم	نوزدهم
همچنین	همچنین
آبراهام	آبراهام
تحصیلات	تحصیلات
قرارداد	قرارداد
تک	تک
طی	طی
کش	کش
حرف	حرف
سخت	سخت
شود	شود
عصر	عصر
قبر	قبر
امّا	امّا
برتر	برتر
بیشه	بیشه
جامع	جامع
جدید	جدید
خانی	خانی
دختر	دختر
سبزه	سبزه
سرده	سرده
قاسم	قاسم
میوه	میوه
اطراف	اطراف
حمایت	حمایت
حیران	حیران
زمینه	زمینه
سنتور	سنتور
محدود	محدود
مسعود	مسعود
هوشنگ	هوشنگ
شاعران	شاعران
مشروطه	مشروطه
گلوگاه	گلوگاه
استخدام	استخدام
امپراتوری	امپراتوری
باد	باد
دما	دما
سره	سره
صبا	صبا
علت	علت
فضل	فضل
هسه	هسه
پیر	پیر
چوب	چوب
کرد	کرد
گاز	گاز
دیلم	دیلم
زیست	زیست
فشار	فشار
لحاظ	لحاظ
لنگه	لنگه
پگاه	پگاه
چینی	چینی
کولی	کولی
اسفند	اسفند
اوایل	اوایل
جایزه	جایزه
زندان	زندان
سمنان	سمنان
مختلف	مختلف
منابع	منابع
گواراٰ	گوارا
عبدالله	عبدالله
نماینده	نماینده
آتش	آتش
اله	اله
حشر	حشر
حفظ	حفظ
خبر	خبر
سرد	سرد
نقل	نقل
هتل	هتل
کته	کته
حشمت	حشمت
دراز	دراز
سابق	سابق
نوری	نوری
هنری	هنری
اروپا	اروپا
اواخر	اواخر
تالار	تالار
خارجی	خارجی
مربوط	مربوط
منتشر	منتشر
درباره	درباره
زمستان	زمستان
سرزمین	سرزمین
مازیار	مازیار
چهارده	چهارده
خوزستان	خوزستان
روستایی	روستایی
فنلاندی	فنلاندی
لاهیجان	لاهیجان
پر	پر
چم	چم
اسب	اسب
روش	روش
ضبط	ضبط
لقب	لقب
پخش	پخش
دو	دو
بدست	بدست
بعضی	بعضی
تمدن	تمدن
خالی	خالی
داخل	داخل
درخت	درخت
شیمی	شیمی
قابل	قابل
قدرت	قدرت
کوچه	کوچه
یاور	یاور
آبشار	آبشار
سلطان	سلطان
سلطنت	سلطنت
مذهبی	مذهبی
نزدیک	نزدیک
ساختار	ساختار
دانشکده	دانشکده
روزنامه	روزنامه
سپتامبر	سپتامبر
کرمانشاه	کرمانشاه
بیمارستان	بیمارستان
شد	شد
ردا	ردا
ششم	ششم
طرح	طرح
مدل	مدل
پره	پره
کسی	کسی
کشت	کشت
اعضا	اعضا
ساده	ساده
علیه	علیه
لهجه	لهجه
محیط	محیط
نوده	نوده
نیمه	نیمه
اهالی	اهالی
ریاست	ریاست
زنجان	زنجان
منصور	منصور
کنگره	کنگره
دسامبر	دسامبر
کیاشهر	کیاشهر
کارخانه	کارخانه
کارگردان	کارگردان
رستم	رستم
صد	صد
مو	مو
ترک	ترک
صفی	صفی
مال	مال
نسل	نسل
یکم	یکم
باره	باره
تبری	تبری
جمله	جمله
درون	درون
علوم	علوم
موفق	موفق
نماد	نماد
وزیر	وزیر
تصویب	تصویب
روابط	روابط
عمارت	عمارت
فرمان	فرمان
مستقل	مستقل
مشغول	مشغول
چهارم	چهارم
کبیسه	کبیسه
گیلانه	گیلانه
اسماعیل	اسماعیل
دبیرستان	دبیرستان
فرهنگسرا	فرهنگسرا
اصل	اصل
امی	امی
خلق	خلق
طبق	طبق
قره	قره
نیم	نیم
وقت	وقت
ارتش	ارتش
حرکت	حرکت
خدمت	خدمت
خطبه	خطبه
هنوز	هنوز
خوراک	خوراک
شوراب	شوراب
دانمارک	دانمارک
کامپیوتر	کامپیوتر
بشه	بشه
جلد	جلد
خوب	خوب
دور	دور
رجه	رجه
پول	پول
کرج	کرج
تنگه	تنگه
خلیج	خلیج
دانش	دانش
دنیا	دنیا
دیگه	دیگه
سایت	سایت
شورش	شورش
عادی	عادی
علمی	علمی
هادی	هادی
هشتم	هشتم
اشاره	اشاره
مانند	مانند
کلیسا	کلیسا
جوانان	جوانان
مانستن	مانستن
آل	آل
اگه	اگه
هند	هند
کلی	کلی
بهار	بهار
حقوق	حقوق
دعوت	دعوت
رشتی	رشتی
شریر	شریر
عامل	عامل
رابرت	رابرت
طبیعی	طبیعی
نامزد	نامزد
ایرانی	ایرانی
جانسون	جانسون
راکتور	راکتور
کاسپین	کاسپین
طبرستان	طبرستان
انتخابات	انتخابات
پل	پل
ابن	ابن
برج	برج
خون	خون
خیل	خیل
فکر	فکر
نور	نور
یکی	یکی
بسته	بسته
دسته	دسته
مواد	مواد
پنجم	پنجم
همراه	همراه
پایتخت	پایتخت
تام	تام
سعی	سعی
شیر	شیر
شین	شین
طور	طور
رواج	رواج
زیبا	زیبا
صنعت	صنعت
ماهی	ماهی
راسته	راسته
سینما	سینما
شوروی	شوروی
صنایع	صنایع
نمایش	نمایش
وزارت	وزارت
کرمان	کرمان
اقتصاد	اقتصاد
ابراهیم	ابراهیم
بازسازی	بازسازی
جشنواره	جشنواره
ثبت	ثبت
صلح	صلح
غذا	غذا
قوم	قوم
نهم	نهم
کسب	کسب
حمام	حمام
دارد	دارد
دلیل	دلیل
رضوی	رضوی
شکار	شکار
گردن	گردن
بیجار	بیجار
فومنی	فومنی
استقبال	استقبال
تن	تن
ضد	ضد
وی	وی
آیه	آیه
بال	بال
حال	حال
رها	رها
شمس	شمس
ملک	ملک
کسما	کسما
اسالم	اسالم
اهمیت	اهمیت
سالگی	سالگی
میلاد	میلاد
بعنوان	بعنوان
سلیمان	سلیمان
شناخته	شناخته
مسعودی	مسعودی
میاندورود	میاندورود
خاص	خاص
خطر	خطر
مدت	مدت
تلاش	تلاش
حمله	حمله
حومه	حومه
نظام	نظام
هفتم	هفتم
گیره	گیره
استاد	استاد
بسیار	بسیار
تبدیل	تبدیل
بدن	بدن
زیر	زیر
علم	علم
هدف	هدف
پشت	پشت
امرا	امرا
زبان	زبان
مجله	مجله
مذهب	مذهب
تاثیر	تاثیر
جزیره	جزیره
سیستم	سیستم
سن	سن
دکتر	دکتر
زارم	زارم
گالش	گالش
اعدام	اعدام
سامان	سامان
شناسی	شناسی
نظامی	نظامی
باستان	باستان
جو	جو
برق	برق
جام	جام
حضور	حضور
اتحاد	اتحاد
سیاست	سیاست
پهلوی	پهلوی
بوستان	بوستان
شی	شی
رای	رای
فصل	فصل
چال	چال
چین	چین
آسیا	آسیا
شهرک	شهرک
داماش	داماش
همدان	همدان
ارتباط	ارتباط
فوتبال	فوتبال
میلیون	میلیون
جیر	جیر
گشت	گشت
آواز	آواز
الان	الان
دفاع	دفاع
عراق	عراق
کاری	کاری
آزادی	آزادی
قزوین	قزوین
ادبیات	ادبیات
سل	سل
تره	تره
خوش	خوش
بطور	بطور
شکست	شکست
معنی	معنی
کمتر	کمتر
روسیه	روسیه
فلسفه	فلسفه
قانون	قانون
ملوان	ملوان
میانرود	میانرود
آخر	آخر
آقا	آقا
خاله	خاله
قدمت	قدمت
واحد	واحد
پشته	پشته
گونه	گونه
بوجود	بوجود
دستور	دستور
محمود	محمود
خاندان	خاندان
فرهنگی	فرهنگی
آهن	آهن
تحت	تحت
تپه	تپه
شده	شده
تصرف	تصرف
داشت	داشت
دیمه	دیمه
شهید	شهید
پیکان	پیکان
گلستان	گلستان
اثر	اثر
خاک	خاک
مرز	مرز
اکبر	اکبر
زنده	زنده
طاهر	طاهر
فریم	فریم
مصرف	مصرف
ورود	ورود
اختلاف	اختلاف
اردبیل	اردبیل
داستان	داستان
شب	شب
جشن	جشن
مرگ	مرگ
برنج	برنج
سفید	سفید
کلمه	کلمه
سلسله	سلسله
علاقه	علاقه
مراسم	مراسم
آریزونا	آریزونا
کیلومتر	کیلومتر
دل	دل
زن	زن
لی	لی
بزه	بزه
قمری	قمری
معلم	معلم
نشان	نشان
تعداد	تعداد
تولید	تولید
تگزاس	تگزاس
صنعتی	صنعتی
استقلال	استقلال
پی	پی
رشد	رشد
سبک	سبک
پسر	پسر
باشد	باشد
بستن	بستن
بودن	بودن
زاده	زاده
محلی	محلی
جامعه	جامعه
بالاتجن	بالاتجن
امامزاده	امامزاده
تخت	تخت
ساز	ساز
دانه	دانه
شبکه	شبکه
کودن	کودن
یعنی	یعنی
البته	البته
بیشتر	بیشتر
باستانی	باستانی
نو	نو
هفت	هفت
پرنده	پرنده
جرم	جرم
فتح	فتح
کله	کله
ناتل	ناتل
برابر	برابر
اسلامی	اسلامی
اجتماعی	اجتماعی
سطح	سطح
سفر	سفر
گلف	گلف
برخی	برخی
زیاد	زیاد
قیام	قیام
کامل	کامل
انجام	انجام
شه	شه
باز	باز
فیلم	فیلم
نژاد	نژاد
خراسان	خراسان
خواننده	خواننده
طبقه	طبقه
چنته	چنته
حکومت	حکومت
باشگاه	باشگاه
سمت	سمت
مردم	مردم
قاجار	قاجار
حزب	حزب
نوع	نوع
گود	گود
سابقه	سابقه
موضوع	موضوع
چهاردانگه	چهاردانگه
خط	خط
سوم	سوم
مثل	مثل
آزاد	آزاد
تنها	تنها
توجه	توجه
جریب	جریب
خودش	خودش
چشمه	چشمه
تصمیم	تصمیم
پرورش	پرورش
کل	کل
آشنا	آشنا
شهرداری	شهرداری
بند	بند
خود	خود
تمام	تمام
شهری	شهری
کوچی	کوچی
تغییر	تغییر
مجموعه	مجموعه
جار	جار
صدا	صدا
الله	الله
نگار	نگار
رادیو	رادیو
علاوه	علاوه
فرانسه	فرانسه
عضو	عضو
پنج	پنج
کاخ	کاخ
دیگر	دیگر
قسمت	قسمت
مورد	مورد
کاره	کاره
داشتی	داشتی
آدم	آدم
حاج	حاج
روی	روی
مار	مار
جاده	جاده
شاعر	شاعر
مایه	مایه
مجلس	مجلس
اداره	اداره
انواع	انواع
مناطق	مناطق
سبز	سبز
رئیس	رئیس
زمان	زمان
مهدی	مهدی
هفته	هفته
اگر	اگر
امام	امام
حاکم	حاکم
قدیم	قدیم
پایین	پایین
همکاری	همکاری
ساله	ساله
سپاه	سپاه
اصفهان	اصفهان
معماری	معماری
پوررضا	پوررضا
چی	چی
رنگ	رنگ
اعلام	اعلام
مساحت	مساحت
آموزش	آموزش
تو	تو
حق	حق
مربع	مربع
آلمان	آلمان
نه	نه
تیم	تیم
درس	درس
جهان	جهان
گیلانی	گیلانی
بود	بود
ناصر	ناصر
وارد	وارد
اشکور	اشکور
فریدون	فریدون
فارس	فارس
نسبت	نسبت
نوروز	نوروز
ری	ری
کس	کس
جور	جور
سنگر	سنگر
سیاه	سیاه
شروع	شروع
خیابان	خیابان
بزرگ	بزرگ
صورت	صورت
کوچک	کوچک
آذربایجان	آذربایجان
نقش	نقش
بنام	بنام
ادامه	ادامه
سوئدی	سوئدی
خال	خال
داخلی	داخلی
نسایی	نسایی
پا	پا
شرق	شرق
چهار	چهار
کشاورزی	کشاورزی
شکل	شکل
هوا	هوا
درجه	درجه
دشتی	دشتی
حتی	حتی
دولت	دولت
میدان	میدان
آغاز	آغاز
مسجد	مسجد
استان	استان
جهانی	جهانی
کوه	کوه
آستانه	آستانه
کتاب	کتاب
رضا	رضا
ساعت	ساعت
انسان	انسان
مره	مره
آهنگ	آهنگ
حاجی	حاجی
فعالیت	فعالیت
اصلی	اصلی
درصد	درصد
شمسی	شمسی
سیاسی	سیاسی
آن	آن
دوم	دوم
دوران	دوران
ژنرال	ژنرال
سی	سی
ایالت	ایالت
زیادی	زیادی
سردار	سردار
بده	بده
نشا	نشا
توسط	توسط
یاد	یاد
اسلام	اسلام
تقویم	تقویم
وب	وب
فقط	فقط
آمار	آمار
گروه	گروه
تئاتر	تئاتر
فاصله	فاصله
غرب	غرب
ساختمان	ساختمان
گرم	گرم
فرهنگ	فرهنگ
میلادی	میلادی
استفاده	استفاده
سیا	سیا
گیل	گیل
شیخ	شیخ
تشکیل	تشکیل
لیل	لیل
برنامه	برنامه
بار	بار
فارسی	فارسی
کم	کم
زمین	زمین
رضوانشهر	رضوانشهر
سید	سید
سمند	سمند
پیدا	پیدا
بی	بی
گل	گل
امیر	امیر
دست	دست
خیلی	خیلی
بوبو	بوبو
دریا	دریا
معروف	معروف
محل	محل
اجرا	اجرا
خوره	خوره
دی	دی
جان	جان
آلبوم	آلبوم
عنوان	عنوان
اردیبهشت	اردیبهشت
دشت	دشت
قبل	قبل
بازی	بازی
علیا	علیا
شهریور	شهریور
خرداد	خرداد
مرداد	مرداد
بوده	بوده
کجور	کجور
مدرسه	مدرسه
ببو	ببو
کنار	کنار
باغ	باغ
آثار	آثار
بالا	بالا
انقلاب	انقلاب
سازمان	سازمان
حدود	حدود
دارای	دارای
پارک	پارک
رو	رو
تاریخ	تاریخ
آذر	آذر
آبان	آبان
تهران	تهران
احمد	احمد
فنلاند	فنلاند
ماه	ماه
ملی	ملی
قلعه	قلعه
اولین	اولین
است	است
راه	راه
مختصات	مختصات
مهر	مهر
چاپ	چاپ
بید	بید
برای	برای
میرزا	میرزا
اطلاعات	اطلاعات
خانه	خانه
هزار	هزار
انزلی	انزلی
خانواده	خانواده
دانشگاه	دانشگاه
بندر	بندر
عرض	عرض
طرف	طرف
موسیقی	موسیقی
فروردین	فروردین
اول	اول
چون	چون
هجری	هجری
لات	لات
بهمن	بهمن
بن	بن
رشته	رشته
آمریکا	آمریکا
جنگل	جنگل
وجود	وجود
آستارا	آستارا
سو	سو
کلا	کلا
شامل	شامل
تیر	تیر
دیلمان	دیلمان
بازار	بازار
شمالی	شمالی
اما	اما
سفلی	سفلی
سنگ	سنگ
بنا	بنا
بیست	بیست
جمعیت	جمعیت
شمال	شمال
اساس	اساس
قرن	قرن
مکزیک	مکزیک
واقع	واقع
جنوبی	جنوبی
منطقه	منطقه
طول	طول
ماسال	ماسال
شهران	شهران
سه	سه
رود	رود
چند	چند
شرکت	شرکت
غربی	غربی
جنوب	جنوب
فومن	فومن
کشور	کشور
زندگی	زندگی
گیلکی	گیلکی
شاه	شاه
نظر	نظر
موزه	موزه
شعر	شعر
املش	املش
رودبار	رودبار
شرقی	شرقی
تازه	تازه
می	می
محمد	محمد
حسن	حسن
کونه	کونه
باعث	باعث
روز	روز
آب	آب
لنگرود	لنگرود
متر	متر
ده	ده
نسا	نسا
علی	علی
نی	نی
رودسر	رودسر
گرانت	گرانت
پیله	پیله
خانوار	خانوار
را	را
هر	هر
پور	پور
خورشیدی	خورشیدی
سوئد	سوئد
کار	کار
او	او
قرار	قرار
کو	کو
ما	ما
بعد	بعد
جا	جا
دره	دره
تالش	تالش
جنگ	جنگ
یا	یا
توابع	توابع
ساری	ساری
اون	اون
مرکز	مرکز
نام	نام
خو	خو
ره	ره
هم	هم
رشت	رشت
نفر	نفر
ای	ای
گه	گه
میان	میان
مرکزی	مرکزی
با	با
مازندران	مازندران
از	از
بو	بو
در	در
کی	کی
مین	مین
روستا	روستا
سال	سال
گیلان	گیلان
ایسم	ایسم
بخش	بخش
شهرستان	شهرستان
جی	جی
دهستان	دهستان
و	و