ئا	ئا
ئابووری	ئابووری
ئاخ	ئاخ
ئاخر	ئاخر
ئاخێز	ئاخێز
ئادی	ئادی
ئادێ	ئادێ
ئارام	ئارام
ئارد	ئارد
ئارۆ	ئارۆ
ئازا	ئازا
ئازاد	ئازاد
ئازادی	ئازادی
ئاسا	ئاسا
ئاسان	ئاسان
ئاسایی	ئاسایی
ئاست	ئاست
ئاسمانی	ئاسمانی
ئاسن	ئاسن
ئاسیاو	ئاسیاو
ئاشتی	ئاشتی
ئاشکرا	ئاشکرا
ئاما	ئاما
ئامادە	ئامادە
ئامان	ئامان
ئامانج	ئامانج
ئاماژە	ئاماژە
ئامای	ئامای
ئامیان	ئامیان
ئامەد	ئامەد
ئانیشا	ئانیشا
ئانە	ئانە
ئاو	ئاو
ئاوا	ئاوا
ئاوات	ئاوات
ئاورای	ئاورای
ئاوی	ئاوی
ئاوەدان	ئاوەدان
ئاوەز	ئاوەز
ئاپۆ	ئاپۆ
ئاگادار	ئاگادار
ئاگری	ئاگری
ئاگە	ئاگە
ئای	ئای
ئایا	ئایا
ئایر	ئایر
ئایندە	ئایندە
ئاینی	ئاینی
ئایین	ئایین
ئوسا	ئوسا
ئی	ئی
ئیتر	ئیتر
ئیجا	ئیجا
ئیجارە	ئیجارە
ئیرادە	ئیرادە
ئیسا	ئیسا
ئیستە	ئیستە
ئیسلام	ئیسلام
ئیمام	ئیمام
ئیمزا	ئیمزا
ئیمە	ئیمە
ئینا	ئینا
ئینسان	ئینسان
ئینە	ئینە
ئێ	ئێ
ئێر	ئێر
ئێراق	ئێراق
ئێران	ئێران
ئێستا	ئێستا
ئێش	ئێش
ئێمە	ئێمە
ئەدەب	ئەدەب
ئەدەبی	ئەدەبی
ئەدەبیات	ئەدەبیات
ئەر	ئەر
ئەرک	ئەرک
ئەرێ	ئەرێ
ئەستۆ	ئەستۆ
ئەسڵەن	ئەسڵەن
ئەفسەر	ئەفسەر
ئەلف	ئەلف
ئەم	ئەم
ئەمن	ئەمن
ئەمین	ئەمین
ئەنجام	ئەنجام
ئەنجامە	ئەنجامە
ئەندام	ئەندام
ئەنقەست	ئەنقەست
ئەو	ئەو
ئەوسا	ئەوسا
ئەوە	ئەوە
ئەوەجە	ئەوەجە
ئەوەڵ	ئەوەڵ
ئەوەی	ئەوەی
ئەژمار	ئەژمار
ئەگینا	ئەگینا
ئەگەر	ئەگەر
ئەڵماس	ئەڵماس
ئەی	ئەی
است	است
ب	ب
با	با
باب	باب
بابا	بابا
بابەت	بابەت
بادینان	بادینان
بار	بار
باران	باران
بارو	بارو
باری	باری
بارە	بارە
بارەگا	بارەگا
بازار	بازار
بازاری	بازاری
بازرگانی	بازرگانی
باس	باس
باش	باش
باشتر	باشتر
باقی	باقی
بان	بان
بانگەشە	بانگەشە
بانە	بانە
باو	باو
باوانی	باوانی
باوش	باوش
باوەڕ	باوەڕ
باڵا	باڵا
بایی	بایی
برای	برای
بریا	بریا
بریان	بریان
بریندار	بریندار
بن	بن
بنکە	بنکە
بنەما	بنەما
بنەڕەت	بنەڕەت
به	به
بوون	بوون
بڕیار	بڕیار
بڕیاش	بڕیاش
بڕیۆ	بڕیۆ
بڕیەی	بڕیەی
بڕێ	بڕێ
بڵاو	بڵاو
بۆ	بۆ
بۆردومان	بۆردومان
بۆشایی	بۆشایی
بۆنە	بۆنە
بۆچی	بۆچی
بی	بی
بینی	بینی
بینە	بینە
بیەی	بیەی
بێ	بێ
بێجگە	بێجگە
بێدار	بێدار
بێنە	بێنە
بە	بە
بەجا	بەجا
بەخشان	بەخشان
بەداخەوە	بەداخەوە
بەدی	بەدی
بەدیل	بەدیل
بەدەست	بەدەست
بەرامبەر	بەرامبەر
بەرد	بەرد
بەردەی	بەردەی
بەرز	بەرز
بەرزایی	بەرزایی
بەرزی	بەرزی
بەرزە	بەرزە
بەرنامە	بەرنامە
بەرهەم	بەرهەم
بەرو	بەرو
بەرپا	بەرپا
بەرۆ	بەرۆ
بەری	بەری
بەرە	بەرە
بەزم	بەزم
بەش	بەش
بەشدار	بەشدار
بەشوو	بەشوو
بەشە	بەشە
بەلام	بەلام
بەم	بەم
بەها	بەها
بەو	بەو
بەکار	بەکار
بەڵا	بەڵا
بەڵام	بەڵام
بەڵکو	بەڵکو
بەڵێن	بەڵێن
بەی	بەی
بەیان	بەیان
بەین	بەین
ت	ت
تا	تا
تاتە	تاتە
تارانی	تارانی
تاریخ	تاریخ
تاریخی	تاریخی
تاش	تاش
تاقی	تاقی
تاقە	تاقە
تان	تان
تاوا	تاوا
تاک	تاک
تاکو	تاکو
تاکە	تاکە
تاڵان	تاڵان
تایبەت	تایبەت
تایبەتی	تایبەتی
تر	تر
تل	تل
توانا	توانا
توانایی	توانایی
تۆ	تۆ
تۆمار	تۆمار
تێکەڵ	تێکەڵ
تەرخان	تەرخان
تەرش	تەرش
تەرو	تەرو
تەری	تەری
تەسلیم	تەسلیم
تەشک	تەشک
تەشەنە	تەشەنە
تەقە	تەقە
تەقەلا	تەقەلا
تەل	تەل
تەمەن	تەمەن
تەنانەت	تەنانەت
تەنها	تەنها
تەنیایی	تەنیایی
تەها	تەها
تەواوی	تەواوی
تەوەرە	تەوەرە
جا	جا
جار	جار
جاران	جاران
جاری	جاری
جارێ	جارێ
جای	جای
جل	جل
جوان	جوان
جوانی	جوانی
جڤاکی	جڤاکی
جۆر	جۆر
جۆش	جۆش
جیا	جیا
جیاواز	جیاواز
جیهان	جیهان
جە	جە
جەباری	جەباری
جەخت	جەخت
جەستە	جەستە
جەم	جەم
جەنگ	جەنگ
جەنگی	جەنگی
جەنگە	جەنگە
جەژنە	جەژنە
حاجی	حاجی
حاڵی	حاڵی
حەز	حەز
حەفتا	حەفتا
حەوت	حەوت
حەکیم	حەکیم
خاس	خاس
خاسی	خاسی
خاسە	خاسە
خان	خان
خانی	خانی
خاو	خاو
خاوەن	خاوەن
خاوەنداری	خاوەنداری
خاک	خاک
خاکی	خاکی
خراپ	خراپ
خراپی	خراپی
خزمەت	خزمەت
خوا	خوا
خوای	خوای
خورد	خورد
خۆ	خۆ
خۆراکی	خۆراکی
خۆسەری	خۆسەری
خۆی	خۆی
خۆیان	خۆیان
خێرا	خێرا
خێرایی	خێرایی
خەبات	خەبات
خەت	خەت
خەرج	خەرج
خەرمان	خەرمان
خەلە	خەلە
خەم	خەم
خەڵات	خەڵات
خەڵک	خەڵک
خەڵکی	خەڵکی
خەڵکینە	خەڵکینە
دا	دا
دابین	دابین
دادگا	دادگا
دادی	دادی
دار	دار
دارایی	دارایی
دارو	دارو
دارێ	دارێ
داستان	داستان
داغ	داغ
دان	دان
دانا	دانا
دانی	دانی
دانە	دانە
داوا	داوا
داگیر	داگیر
داگیرکەر	داگیرکەر
دای	دای
دایم	دایم
دایک	دایک
دروس	دروس
دروست	دروست
دریا	دریا
درێخی	درێخی
درێژ	درێژ
درێژایی	درێژایی
درێژی	درێژی
درێژە	درێژە
دزی	دزی
دلێ	دلێ
دما	دما
دماوە	دماوە
دمایی	دمایی
دمایین	دمایین
دنیا	دنیا
ده	ده
دهۆک	دهۆک
دو	دو
دوو	دوو
دوور	دوور
دوژمن	دوژمن
دوژمنی	دوژمنی
دوێ	دوێ
دوە	دوە
دژ	دژ
دژایەتی	دژایەتی
دژوار	دژوار
دژی	دژی
دژە	دژە
دڵ	دڵ
دۆغان	دۆغان
دی	دی
دیا	دیا
دیار	دیار
دیاری	دیاری
دیدار	دیدار
دیسان	دیسان
دیل	دیل
دیم	دیم
دین	دین
دینداری	دینداری
دینی	دینی
دێ	دێ
دێر	دێر
دێنێ	دێنێ
دەرباز	دەرباز
دەرس	دەرس
دەرمان	دەرمان
دەروون	دەروون
دەرە	دەرە
دەزگا	دەزگا
دەس	دەس
دەست	دەست
دەستو	دەستو
دەستگیر	دەستگیر
دەستی	دەستی
دەستە	دەستە
دەسی	دەسی
دەسە	دەسە
دەسەڵات	دەسەڵات
دەق	دەق
دەم	دەم
دەنگ	دەنگ
دەنگدار	دەنگدار
دەنگە	دەنگە
دەور	دەور
دەوڵەت	دەوڵەت
دەوڵەتی	دەوڵەتی
دەگا	دەگا
دەی	دەی
زاخۆ	زاخۆ
زادە	زادە
زار	زار
زارۆڵە	زارۆڵە
زازاکی	زازاکی
زامدار	زامدار
زانا	زانا
زانایی	زانایی
زانست	زانست
زانستی	زانستی
زانیاری	زانیاری
زاپ	زاپ
زاڵ	زاڵ
زبان	زبان
زمان	زمان
زمانی	زمانی
زمسانی	زمسانی
زنجیرە	زنجیرە
زوانە	زوانە
زوو	زوو
زۆر	زۆر
زۆرداری	زۆرداری
زۆری	زۆری
زیاد	زیاد
زیان	زیان
زیانی	زیانی
زیلان	زیلان
زینو	زینو
زینی	زینی
زەحمەت	زەحمەت
زەمین	زەمین
زەنگین	زەنگین
زەڕ	زەڕ
سات	سات
سادە	سادە
سارا	سارا
ساز	ساز
سان	سان
سانا	سانا
ساڵ	ساڵ
ساڵان	ساڵان
ساڵانە	ساڵانە
ساڵح	ساڵح
ساڵە	ساڵە
ستەم	ستەم
سروشت	سروشت
سروشتی	سروشتی
سزا	سزا
سزاو	سزاو
سلێمانی	سلێمانی
سنە	سنە
سنەی	سنەی
سود	سود
سور	سور
سوپا	سوپا
سوڵتان	سوڵتان
سپا	سپا
سپی	سپی
سڵام	سڵام
سڵامەتی	سڵامەتی
سۆران	سۆران
سۆرانی	سۆرانی
سۆز	سۆز
سی	سی
سیاو	سیاو
سیاوە	سیاوە
سیروان	سیروان
سینە	سینە
سێ	سێ
سێرت	سێرت
سەبارەت	سەبارەت
سەخت	سەخت
سەختی	سەختی
سەد	سەد
سەدان	سەدان
سەر	سەر
سەرئەنجام	سەرئەنجام
سەرباز	سەرباز
سەربازی	سەربازی
سەرجەم	سەرجەم
سەرحەد	سەرحەد
سەردار	سەردار
سەردەشت	سەردەشت
سەردەمە	سەردەمە
سەرسام	سەرسام
سەرشان	سەرشان
سەرقاڵ	سەرقاڵ
سەرنجە	سەرنجە
سەروو	سەروو
سەروەری	سەروەری
سەرکردە	سەرکردە
سەرکۆنە	سەرکۆنە
سەرکەوتە	سەرکەوتە
سەرۆ	سەرۆ
سەرۆک	سەرۆک
سەرۆکایەتی	سەرۆکایەتی
سەری	سەری
سەرین	سەرین
سەرە	سەرە
سەرەتا	سەرەتا
سەرەتایی	سەرەتایی
سەرەو	سەرەو
سەرەک	سەرەک
سەعات	سەعات
سەقز	سەقز
سەلیم	سەلیم
سەما	سەما
سەی	سەی
سەید	سەید
ش	ش
شا	شا
شاخی	شاخی
شاری	شاری
شارە	شارە
شارەوانی	شارەوانی
شاسوار	شاسوار
شان	شان
شانازی	شانازی
شانە	شانە
شاهین	شاهین
شایستە	شایستە
شش	شش
شک	شک
شکست	شکست
شکستی	شکستی
شکۆ	شکۆ
شۆن	شۆن
شۆڕش	شۆڕش
شی	شی
شیار	شیار
شیرین	شیرین
شێخ	شێخ
شێوە	شێوە
شەبەک	شەبەک
شەرمەزار	شەرمەزار
شەریک	شەریک
شەممە	شەممە
شەهید	شەهید
شەونشینی	شەونشینی
شەوچەرە	شەوچەرە
شەوێ	شەوێ
شەڕ	شەڕ
عادل	عادل
علمی	علمی
عیسا	عیسا
عەبدی	عەبدی
عەزیز	عەزیز
عەزیزی	عەزیزی
عەگید	عەگید
عەین	عەین
فارسی	فارسی
فاڕای	فاڕای
فراوان	فراوان
فراوانی	فراوانی
فرێش	فرێش
فرە	فرە
فرەیی	فرەیی
فکر	فکر
فیت	فیت
فێر	فێر
فەراهەم	فەراهەم
فەرمان	فەرمان
فەرماندە	فەرماندە
فەرهەنگ	فەرهەنگ
قادر	قادر
قازی	قازی
قوربانی	قوربانی
قورس	قورس
قورسی	قورسی
قوڵ	قوڵ
قڕ	قڕ
قۆمیان	قۆمیان
قۆناخ	قۆناخ
قەدەغە	قەدەغە
قەرار	قەرار
قەرس	قەرس
قەندیل	قەندیل
قەڵەم	قەڵەم
قەیران	قەیران
ل	ل
لا	لا
لازم	لازم
لاش	لاش
لانی	لانی
لاو	لاو
لاواز	لاواز
لاوە	لاوە
لای	لای
لایەن	لایەن
لوا	لوا
لوان	لوان
لوای	لوای
لکی	لکی
لی	لی
لێ	لێ
لە	لە
لەسەر	لەسەر
لەشکری	لەشکری
لەم	لەم
لەناو	لەناو
لەو	لەو
لەگەڵ	لەگەڵ
لەیلێ	لەیلێ
م	م
ما	ما
مارۆ	مارۆ
ماری	ماری
ماف	ماف
مافە	مافە
مام	مام
مامۆسا	مامۆسا
مامۆستا	مامۆستا
مامەڵە	مامەڵە
مانا	مانا
مانگان	مانگان
مانگی	مانگی
مانگە	مانگە
مانگەو	مانگەو
ماوا	ماوا
ماوە	ماوە
ماچۆ	ماچۆ
مای	مای
مایە	مایە
متمانە	متمانە
مدران	مدران
مدرای	مدرای
مرۆڤ	مرۆڤ
مرۆڤایەتی	مرۆڤایەتی
مزگی	مزگی
مشیۆ	مشیۆ
مل	مل
ملۆ	ملۆ
ملی	ملی
من	من
مناڵی	مناڵی
منی	منی
موزیک	موزیک
موش	موش
مووچە	مووچە
میانی	میانی
میت	میت
میرزا	میرزا
مین	مین
مێ	مێ
مێو	مێو
مێوە	مێوە
مێژوو	مێژوو
مێژوویی	مێژوویی
مە	مە
مەبۆ	مەبۆ
مەبەست	مەبەست
مەحمودی	مەحمودی
مەردە	مەردە
مەردەن	مەردەن
مەردەی	مەردەی
مەرگ	مەرگ
مەزن	مەزن
مەلا	مەلا
مەولودی	مەولودی
مەولەوی	مەولەوی
مەژگ	مەژگ
مەگەر	مەگەر
مەڵا	مەڵا
مەی	مەی
مەیا	مەیا
مەیانە	مەیانە
مەیدان	مەیدان
مەینە	مەینە
نا	نا
نادیار	نادیار
ناز	ناز
ناسک	ناسک
نام	نام
نامی	نامی
نامە	نامە
نان	نان
ناهەق	ناهەق
ناو	ناو
ناوچە	ناوچە
ناوی	ناوی
ناوەندی	ناوەندی
ناچار	ناچار
ناچاری	ناچاری
ناڕەزایی	ناڕەزایی
ناکۆکی	ناکۆکی
نزیک	نزیک
نموونە	نموونە
نه	نه
نهێنی	نهێنی
نی	نی
نیاز	نیاز
نیان	نیان
نیشانە	نیشانە
نیم	نیم
نیە	نیە
نێوان	نێوان
نە	نە
نەبی	نەبی
نەبێ	نەبێ
نەتەوە	نەتەوە
نەداری	نەداری
نەدان	نەدان
نەرم	نەرم
نەورۆز	نەورۆز
نەورۆزی	نەورۆزی
نەوە	نەوە
نەک	نەک
هام	هام
هان	هان
هانا	هانا
هانێ	هانێ
هانە	هانە
هاوار	هاوار
هاوبەش	هاوبەش
هاوکات	هاوکات
هاڵی	هاڵی
هزر	هزر
هونەر	هونەر
هونەرمەند	هونەرمەند
هونەری	هونەری
هۆر	هۆر
هۆرامان	هۆرامان
هۆش	هۆش
هیزی	هیزی
هیوا	هیوا
هیچ	هیچ
هێرش	هێرش
هێز	هێز
هێمنی	هێمنی
هەتا	هەتا
هەر	هەر
هەرس	هەرس
هەرمان	هەرمان
هەرچی	هەرچی
هەرکام	هەرکام
هەرکەس	هەرکەس
هەرگیز	هەرگیز
هەری	هەری
هەرێم	هەرێم
هەرە	هەرە
هەزار	هەزار
هەزاران	هەزاران
هەست	هەست
هەمان	هەمان
هەموو	هەموو
هەمیشە	هەمیشە
هەن	هەن
هەناسە	هەناسە
هەنگامە	هەنگامە
هەنێ	هەنێ
هەنە	هەنە
هەوا	هەوا
هەورامی	هەورامی
هەولێر	هەولێر
هەوڵ	هەوڵ
هەڕەشە	هەڕەشە
هەژار	هەژار
هەژاری	هەژاری
هەکە	هەکە
هەڵبەت	هەڵبەت
هەڵبەتە	هەڵبەتە
هەڵوێست	هەڵوێست
هەڵە	هەڵە
هەی	هەی
هەینی	هەینی
وات	وات
واتا	واتا
واتش	واتش
واتە	واتە
واتەی	واتەی
وار	وار
وارد	وارد
واردەی	واردەی
واری	واری
وارین	وارین
واز	واز
وام	وام
وان	وان
وانا	وانا
وانای	وانای
وانی	وانی
واچە	واچە
واژە	واژە
واڵە	واڵە
وت	وت
ورد	ورد
وردی	وردی
وردە	وردە
وردەکاری	وردەکاری
وریا	وریا
وزۆ	وزۆ
وست	وست
وستەی	وستەی
وشە	وشە
ون	ون
ونە	ونە
وڵات	وڵات
ویر	ویر
ویش	ویش
وینا	وینا
ویەردە	ویەردە
ویەردەی	ویەردەی
وێ	وێ
وێت	وێت
وێش	وێش
وێشان	وێشان
وێم	وێم
وێمان	وێمان
وێنە	وێنە
وە	وە
وەخت	وەخت
وەختە	وەختە
وەر	وەر
وەرم	وەرم
وەروو	وەروو
وەروە	وەروە
وەرچەم	وەرچەم
وەرۆ	وەرۆ
وەرین	وەرین
وەرێ	وەرێ
وەزی	وەزی
وەسێن	وەسێن
وەش	وەش
وەشی	وەشی
وەشە	وەشە
وەشەن	وەشەن
وەلی	وەلی
وەلێ	وەلێ
وەنە	وەنە
وەهار	وەهار
وەک	وەک
وەکو	وەکو
وەڵات	وەڵات
وەڵاتی	وەڵاتی
وەڵام	وەڵام
وەڵاو	وەڵاو
وەی	وەی
پا	پا
پارت	پارت
پارتی	پارتی
پارچە	پارچە
پارێزنای	پارێزنای
پارێزگا	پارێزگا
پاسە	پاسە
پاوە	پاوە
پاوەی	پاوەی
پاک	پاک
پاڵو	پاڵو
پاڵەوی	پاڵەوی
پایتەخت	پایتەخت
پایە	پایە
پرد	پرد
پشتیوانی	پشتیوانی
پلە	پلە
پنە	پنە
پۆ	پۆ
پۆلیس	پۆلیس
پی	پی
پیا	پیا
پیر	پیر
پیرو	پیرو
پیرۆز	پیرۆز
پیرۆزە	پیرۆزە
پیری	پیری
پیس	پیس
پیشەسازی	پیشەسازی
پیلان	پیلان
پیمانە	پیمانە
پێ	پێ
پێسە	پێسە
پێش	پێش
پێشمەرگە	پێشمەرگە
پێشوازی	پێشوازی
پێشکەش	پێشکەش
پێشەوا	پێشەوا
پێکان	پێکان
پەتا	پەتا
پەخش	پەخش
پەراوێز	پەراوێز
پەردە	پەردە
پەردەپۆش	پەردەپۆش
پەرسە	پەرسە
پەروەردە	پەروەردە
پەرە	پەرە
پەنا	پەنا
پەنج	پەنج
پەنجا	پەنجا
پەوکەی	پەوکەی
پەڕ	پەڕ
پەیام	پەیام
پەیاپەی	پەیاپەی
پەیت	پەیت
پەیتا	پەیتا
پەیجۆری	پەیجۆری
پەیدا	پەیدا
پەیمان	پەیمان
پەیوەست	پەیوەست
پەیڕەو	پەیڕەو
چ	چ
چا	چا
چارەسەر	چارەسەر
چالاکی	چالاکی
چاپ	چاپ
چاپەمەنی	چاپەمەنی
چاگە	چاگە
چاڵ	چاڵ
چن	چن
چند	چند
چنی	چنی
چنە	چنە
چوار	چوار
چوارشەممە	چوارشەممە
چون	چون
چونکە	چونکە
چوون	چوون
چۆڵ	چۆڵ
چی	چی
چین	چین
چینی	چینی
چینە	چینە
چێر	چێر
چێش	چێش
چێو	چێو
چە	چە
چەتە	چەتە
چەم	چەم
چەمان	چەمان
چەمە	چەمە
چەمەڕا	چەمەڕا
چەن	چەن
چەند	چەند
چەنی	چەنی
چەنە	چەنە
چەک	چەک
ڕا	ڕا
ڕابەر	ڕابەر
ڕاز	ڕاز
ڕازێ	ڕازێ
ڕازە	ڕازە
ڕاس	ڕاس
ڕاست	ڕاست
ڕاستی	ڕاستی
ڕاستە	ڕاستە
ڕاسی	ڕاسی
ڕانک	ڕانک
ڕاو	ڕاو
ڕاوە	ڕاوە
ڕاڤە	ڕاڤە
ڕای	ڕای
ڕزگار	ڕزگار
ڕزگاری	ڕزگاری
ڕستە	ڕستە
ڕو	ڕو
ڕوان	ڕوان
ڕوانە	ڕوانە
ڕووسیا	ڕووسیا
ڕۆ	ڕۆ
ڕۆشن	ڕۆشن
ڕۆچ	ڕۆچ
ڕۆچێ	ڕۆچێ
ڕۆژاڤا	ڕۆژاڤا
ڕۆژهەڵات	ڕۆژهەڵات
ڕۆژی	ڕۆژی
ڕێ	ڕێ
ڕێبەر	ڕێبەر
ڕێز	ڕێز
ڕێزان	ڕێزان
ڕێژەو	ڕێژەو
ڕێک	ڕێک
ڕێکانی	ڕێکانی
ڕەت	ڕەت
ڕەخنە	ڕەخنە
ڕەشۆ	ڕەشۆ
ڕەنگ	ڕەنگ
ڕەوانی	ڕەوانی
ڕەگ	ڕەگ
ژمارە	ژمارە
ژن	ژن
ژوورو	ژوورو
ژیان	ژیان
ژێر	ژێر
ژەن	ژەن
ژەنی	ژەنی
کا	کا
کات	کات
کاتە	کاتە
کار	کار
کارا	کارا
کاری	کاری
کارە	کارە
کام	کام
کامل	کامل
کامە	کامە
کانی	کانی
کاوە	کاوە
کاک	کاک
کاکە	کاکە
کاکەیی	کاکەیی
کاڵ	کاڵ
کرد	کرد
کردەوە	کردەوە
کرمانجی	کرمانجی
کرکە	کرکە
کریا	کریا
کریان	کریان
کریانەوە	کریانەوە
کرێ	کرێ
کناچێ	کناچێ
کناچە	کناچە
کورد	کورد
کوردسانی	کوردسانی
کوردستان	کوردستان
کوردستانی	کوردستانی
کوردی	کوردی
کوردەواری	کوردەواری
کوشت	کوشت
کوشتە	کوشتە
کوڕە	کوڕە
کوڵی	کوڵی
کوڵە	کوڵە
کۆ	کۆ
کۆتا	کۆتا
کۆتایی	کۆتایی
کۆما	کۆما
کۆمار	کۆمار
کۆماری	کۆماری
کۆمەڵایەتی	کۆمەڵایەتی
کۆمەڵگا	کۆمەڵگا
کۆمەڵە	کۆمەڵە
کۆنگرە	کۆنگرە
کۆنە	کۆنە
کۆچ	کۆچ
کۆچی	کۆچی
کی	کی
کیمیا	کیمیا
کیمیایی	کیمیایی
کێ	کێ
کێشە	کێشە
کێن	کێن
کە	کە
کەر	کەر
کەرا	کەرا
کەرد	کەرد
کەردە	کەردە
کەروو	کەروو
کەرۆ	کەرۆ
کەرۆن	کەرۆن
کەری	کەری
کەس	کەس
کەسا	کەسا
کەسان	کەسان
کەسایەتی	کەسایەتی
کەسی	کەسی
کەسێ	کەسێ
کەسە	کەسە
کەش	کەش
کەشە	کەشە
کەلار	کەلار
کەلک	کەلک
کەم	کەم
کەمی	کەمی
کەوت	کەوت
کەچی	کەچی
کەڵک	کەڵک
کەی	کەی
گازی	گازی
گاوانی	گاوانی
گر	گر
گرد	گرد
گردو	گردو
گردی	گردی
گردین	گردین
گرنگ	گرنگ
گرنگی	گرنگی
گرێ	گرێ
گشتی	گشتی
گفتوگۆ	گفتوگۆ
گوایا	گوایا
گوران	گوران
گورانی	گورانی
گورج	گورج
گورز	گورز
گومان	گومان
گونه	گونه
گۆران	گۆران
گۆرانی	گۆرانی
گۆش	گۆش
گۆشەگیر	گۆشەگیر
گۆشەگیری	گۆشەگیری
گۆڕ	گۆڕ
گیان	گیان
گیانی	گیانی
گیریان	گیریان
گەر	گەر
گەرم	گەرم
گەرمیانی	گەرمیانی
گەرمە	گەرمە
گەرەک	گەرەک
گەشە	گەشە
گەل	گەل
گەلوو	گەلوو
گەلی	گەلی
گەلێ	گەلێ
گەلە	گەلە
گەلەکۆمە	گەلەکۆمە
گەمارۆ	گەمارۆ
گەمە	گەمە
گەنج	گەنج
گەندەڵی	گەندەڵی
گەورێ	گەورێ
گەورە	گەورە
گەورەیی	گەورەیی
گەڤەر	گەڤەر
یا	یا
یاخود	یاخود
یاد	یاد
یاران	یاران
یاری	یاری
یاسا	یاسا
یاسایی	یاسایی
یام	یام
یان	یان
یانی	یانی
یانێ	یانێ
یانە	یانە
یاوا	یاوا
یاوان	یاوان
یاوای	یاوای
یاونای	یاونای
یاگە	یاگە
ینە	ینە
یوە	یوە
یۆ	یۆ
یە	یە
یەرێ	یەرێ
یەرە	یەرە
یەن	یەن
یەنە	یەنە
یەک	یەک
یەکتری	یەکتری
یەکجار	یەکجار
یەکجاری	یەکجاری
یەکسان	یەکسان
یەکسەر	یەکسەر
یەکێتی	یەکێتی
یەکەم	یەکەم
یەکەمین	یەکەمین