آم	آم
بہ	بہ
تا	تا
تس	تس
جو	جو
حق	حق
لو	لو
نش	نش
نل	نل
وج	وجِ
وے	وے
پب	پب
چک	چک
چہ	چہ
کس	کس
کن	کن
کے	کے
آشی	آشی
اوم	اوم
اِی	ای
ایل	ایل
باد	باد
ببر	ببر
بدر	بدر
برا	برا
بری	بری
بنت	بنت
بہل	بہل
بیس	بیس
بیل	بیل
بیک	بیک
تال	تال
تقی	تقی
تنا	تنا
تیز	تیز
ثور	ثور
جنگ	جنگ
جوش	جوش
حجر	حجر
حزم	حزم
حصل	حصل
حنا	حنا
حَج	حَج
خطر	خطر
خَر	خَر
دمن	دمن
دٕس	دس
دھر	دھر
دیا	دیا
ذکر	ذکر
ذکی	ذکی
راس	راس
ربا	ربا
رتن	رتن
رسم	رسم
رضا	رضا
رضی	رضی
رمی	رمی
رنگ	رنگ
روح	روح
رُخ	رُخ
زَر	زَر
سلم	سلم
سمن	سمن
سٖی	سی
سہل	سہل
سیے	سیے
شاد	شاد
شبہ	شبہ
شفق	شفق
شمع	شمع
شور	شور
شیب	شیب
صبا	صبا
صفر	صفر
ضبع	ضبع
طیب	طیب
عصر	عصر
عنہ	عنہ
عہد	عہد
فلک	فلک
فوج	فوج
قبل	قبل
قدر	قدر
قلم	قلم
لنچ	لنچ
لین	لین
لیو	لیو
مار	مار
متن	متن
مدن	مدن
مفت	مفت
منی	منی
مَر	مَر
مُج	مج
مہر	مہر
مہک	مہک
نظر	نظر
نقی	نقی
نند	نند
نِس	نِس
وصی	وصی
وَر	وَر
وُڈ	وُڈ
ویب	ویب
ٹاپ	ٹاپ
ٹلی	ٹلی
پاس	پاس
پتھ	پتھ
پٔر	پر
چہل	چہل
ڈیم	ڈیم
کاک	کاک
کاہ	کاہ
کُک	کُک
ککڑ	ککڑ
کیف	کیف
گَو	گَو
گُل	گُل
ہار	ہار
ہان	ہان
ہرن	ہرن
ہضم	ہضم
ہما	ہما
ہَر	ہَر
ہُر	ہر
ہُم	ہم
یَن	ین
یُک	یَک
آرتی	آرتی
آغاز	آغاز
آمنہ	آمنہ
آنچل	آنچل
آکاش	آکاش
اختر	اختر
ادَب	ادب
اسلم	اسلم
اسود	اسود
اصول	اصول
اعلا	اعلا
امجد	امجد
امنا	امنا
امِک	امک
امہٕ	امّہ
انجم	انجم
اوفی	اوفٰی
اَیس	اَیس
اگنی	اگنی
اہَم	اَہَم
ایلا	ایلا
ایلن	ایلن
ایما	ایما
بانڈ	بانڈ
بروے	بروے
بطور	بطور
بندو	بندو
بَند	بَند
بُچا	بُچا
بُہر	بَہْر
بھگت	بھگت
بیان	بیان
بیضا	بیضا
بیٹی	بیٹی
تامل	تامل
تانا	تانا
تبسم	تبسم
ترین	ترین
ترےٚ	تِرے
جابر	جابر
جانا	جانا
جایا	جایا
جہاں	جہاں
جینا	جینا
حباب	حباب
حریم	حریم
حسان	حسان
حمار	حمار
حمیر	حمیر
خدمت	خدمت
خراش	خراش
خطمی	خطمی
خطیب	خطیب
خلیل	خلیل
خُشی	خشی
دانش	دانش
داوٕ	داو
دورِ	دورِ
دولت	دولت
دِوٕ	دو
دھَر	دَھر
دیبا	دیبا
رانا	رانا
ربعی	ربعی
رحمن	رحمٰن
رونی	رونی
روٗپ	روپ
روپا	روپا
رَجب	رجب
رَوی	رَوی
رچنا	رچنا
زینت	زینت
سالم	سالم
ساہی	ساہی
سرگم	سرگم
سریش	سریش
سریع	سریع
سنڈی	سنڈی
سواد	سواد
سورہ	سورہ
سوسن	سوسن
سوہا	سوہا
سَرس	سرس
سُرخ	سُرخ
سِیر	سَیر
سہنا	سہنا
سیتا	سیتا
سیرت	سیرت
سیلی	سیلی
سیما	سیما
سیمی	سیمی
سینی	سینی
شاہِ	شاہِ
شداد	شداد
شمیم	شمیم
شومی	شومی
صراف	صراف
طفیل	طفیل
طوری	طوری
عاقل	عاقل
عشری	عشری
عیاش	عیاش
فقہٕ	فقْہ
فَنِ	فَنِ
فِنی	فنّی
فیاض	فیاض
قاضی	قاضی
قُرت	قرت
قیام	قیام
لالہ	لالہ
لانچ	لانچ
لنڈا	لنڈا
لیلی	لَیلٰی
لیلے	لیلےٰ
لیڈی	لیڈی
مالی	مالی
مانی	مانی
ماگھ	ماگھ
ماہر	ماہر
ماہی	ماہی
مترا	مترا
مجمع	مجمع
مجید	مجید
محصن	محصن
مدھر	مدھر
مدھو	مدھو
مدیر	مدیر
مردم	مردم
مرزا	مرزا
مسطح	مسطح
مسلم	مسلم
مسور	مسور
مشرق	مشرق
معبد	معبد
معمر	معمر
معین	معین
مغفل	مغفل
مقال	مقال
مقدس	مقدس
منجو	منجو
موتی	موتی
مولی	مولی
مونا	مونا
موٗد	مود
مِسر	مسر
مکتا	مکتا
مکتی	مکتی
مہام	مہام
مہتا	مہتا
مہرا	مہرا
میسی	میسی
میشا	میشا
میلا	میلا
میمی	میمی
نافع	نافع
ناول	ناول
ناوک	ناوک
نصرت	نصرت
نفیس	نفیس
نماز	نماز
نندن	نندن
نواب	نواب
نورا	نورا
نَرِ	نر
نینا	نینا
نیگی	نیگی
واعظ	واعظ
واپس	واپس
وَری	وَری
ٹرمپ	ٹرمپ
ٹِشو	ٹشو
ٹیلا	ٹیلا
ٹیلر	ٹیلر
ٹیلی	ٹیلی
پاشا	پاشا
پالا	پالا
پدما	پدما
پرنہ	پرنہ
پریت	پریت
پسند	پسند
پلہٕ	پلّہ
پلین	پلین
پورن	پورن
پورچ	پورچ
پوٚت	پوت
پَتھ	پَتھ
پٹیل	پٹیل
پیرس	پیرس
چنٛد	چند
ڈالی	ڈالی
ڈھلی	ڈھلی
کافی	کافی
کبیر	کبیر
کلچر	کلچر
کمرا	کمرا
کنیت	کنیت
کولی	کولی
کوکو	کوکو
کَٹھ	کَٹھ
کیری	کیری
کیمپ	کیمپ
گائے	گائے
گَرٕ	گر
گُلو	گلو
گُپت	گُپَت
ہاسن	ہاسن
ہاشم	ہاشم
ہوٚس	ہوس
ہَری	ہَری
ہٕند	ہند
یاسر	یاسر
یسار	یسار
آبادٖ	آباد
آسمان	آسمان
آسَان	آسان
آمِنا	آمنا
اباسی	اباسی
اثاثہ	اثاثہ
اسکیم	اسکیم
اعمال	اعمال
افغان	افغان
البتہ	البتّہ
البدن	البدن
العین	العین
الیاس	الیاس
امیٖن	امین
انجیل	انجیل
انسان	انسان
انعام	انعام
انٛدٕ	اند
اولُو	اولو
اَدبی	ادبی
اَنور	انور
اِسرا	اسرا
اپرنا	اپرنا
ایجاز	ایجاز
ایشیا	ایشیا
ایلیا	ایلیا
اینٹی	اینٹی
بندیا	بندیا
بَجہٕ	بجّہ
بَچاو	بَچاو
بِہار	بَہار
بٕرجی	برجی
بٕہٕر	بَہْر
بھوجن	بھوجن
بھومی	بھومی
بینِش	بینش
تارُک	تارَک
تاپسی	تاپسی
ترٛےٚ	تِرے
تقلید	تقلید
تَبیر	تبیر
تھیٹر	تھیٹر
جابِر	جابِر
جاریہ	جاریہ
جمالی	جمالی
جَنگل	جنْگل
جَہان	جَہان
جُگَن	جَگَن
جھلکا	جھلکا
جیوتی	جیوتی
حسینی	حسینی
حنیٖف	حنیف
حویلی	حویلی
حُریت	حرّیت
حُکَم	حُکم
حکومت	حکومت
حیدری	حیدری
حیٖدر	حَیدَر
خالِد	خالِد
خلافت	خلافت
خواجہ	خواجہ
خوشبو	خوشبو
دستور	دستور
دیوان	دیوان
راجہٕ	راجَہ
رادھا	رادھا
راوُل	راول
راگنی	راگنی
رحمان	رحمان
رخسار	رخسار
رمانی	رمانی
رمبھا	رمبھا
روشَن	روشَن
رومَن	رومَن
زرینہ	زرینہ
زمیٖن	زمین
زَمان	زَمان
زَنان	زَنان
زیادِ	زِیاد
زیٖبا	زیبا
ستارہ	ستارہ
سردار	سردار
سرکار	سرکار
سفینہ	سفینہ
سلونی	سلونی
سمرتی	سمرتی
سمیرا	سمیرا
سنایا	سنایا
سواتی	سواتی
سوٗدی	سودی
سَجاد	سَجاد
سَروٕ	سرو
سِیٖد	سَیَد
سٕندِ	سند
سپریم	سپریم
سکندر	سکندر
سکوٹر	سکوٹر
سیٹھی	سیٹھی
شاہِد	شاہِد
شبانہ	شبانہ
شِکرا	شَکْرا
شیطان	شیطان
عاشُر	عاشر
عالمہ	عالمہ
علیہم	علیہم
عمارہ	عمارہ
عَلیم	علیم
عُمان	عُمان
عیسوی	عیسوی
فرزند	فرزند
فرنٛٹ	فرنْٹ
فوٹوٗ	فوٹو
فَیاض	فَیاض
فیروز	فیروز
قاطُر	قاطر
قدرتی	قدرتی
قَیوم	قَیُوم
لارنس	لارنس
لقمان	لقمان
لُغَت	لُغَت
لہجہٕ	لَہْجَہ
لیاقت	لیاقت
لینٖن	لِینَن
ماریہ	ماریہ
محفوظ	محفوظ
محمدؐ	محمد
مخصوص	مخصوص
مدینہ	مدینہ
مرچنٹ	مرچنٹ
مریَم	مرْیم
مسلمہ	مسلمہ
معراج	معراج
معروف	معروف
معنیٰ	معنٰی
مغربی	مغربی
ممتاز	ممتاز
منتخب	منتخب
منجری	منجری
مندرا	مندرا
مندِر	مندر
موجود	موجود
موسیٰ	موسیٰ
موندی	موندی
مَروا	مروا
مَشال	مَشال
مَلِک	مَلِک
مَٹَر	مَٹَر
مَہام	مَہام
مُحمد	محمد
مُسرت	مسرت
مُفُت	مفت
مُنیر	منیر
مٕلٕک	ملَک
مہاجر	مہاجر
مہجور	مہجور
مہوِش	مہوش
میرِی	مِیری
مینڈی	مینڈی
میٖرا	مِیرا
میگھا	میگھا
نادِر	نادِر
نادیہ	نادیہ
ناساز	ناساز
نالہِ	نالَہ
نامہٕ	نامَہ
نظریہ	نظریہ
نفیسہ	نفیسہ
نوشین	نوشین
نَرٛک	نرک
نَسلی	نسلی
نَفَر	نَفَر
نَواز	نَواز
نِرما	نرما
نِگہت	نَگْہَت
واعِظ	واعِظ
والدہ	والدہ
ولایت	ولایت
وَسطی	وسطٰی
ٹھاکر	ٹھاکر
ٹیکسی	ٹیکسی
پادَر	پادر
پاولی	پاولی
پاکھی	پاکھی
پدمنی	پدمنی
پرنہٕ	پرنہ
پرویز	پرویز
پریال	پریال
پَسند	پسند
پَلہٕ	پلّہ
پَلیٹ	پَلیٹ
پَنَس	پنس
پَیِک	پَیک
پُٹِن	پَٹَن
پھٕرٕ	پُھر
پیشہٕ	پیشَہ
چندرا	چندرا
چَہار	چَہار
چھایا	چھایا
کامنا	کامنا
کبوتر	کبوتر
کرشمہ	کرشمہ
کروٗم	کروم
کرٕٛم	کرم
کلپنا	کلپنا
کلیان	کلیان
کماری	کماری
کَمَر	کَمَر
کُرسی	کرسی
کُنٛز	کنز
کِرَن	کِرَن
کِرکٹ	کرْکٹ
کھَرِ	کُھر
کیمرا	کیمرا
کیُٛس	کَیِس
گرَٛد	گرد
گلزار	گلزار
گَردن	گردن
گُلاب	گُلاب
گیٖری	گِیری
ہلالی	ہلالی
ہمیشہ	ہمیشہ
ہوائی	ہوائی
ہَزار	ہَزار
اسمبلی	اسمبلی
اعدادِ	اعداد
الامین	الامین
الثانی	الثانی
المظفر	المظفر
امریکی	امریکی
اَنوشی	انوشی
اَکرَم	اَکْرَم
اُجاگر	اُجاگر
اِلزام	الزام
اٗردوٗ	اردو
اپاسنا	اپاسنا
برصغیر	برصغیر
بَستہٕ	بستہ
بھاونا	بھاونا
تبریزی	تبریزی
تحصیٖل	تحصیل
تقریبا	تقریبا
تنظیٖم	تنظیم
تھیٹَر	تھیٹَر
تیزٕآب	تیزآب
ثانِیا	ثانِیاً
جانشین	جانشین
جماعتِ	جماعت
حَملہٕ	حملہ
حُریِت	حرّیت
خَرگوش	خَرگوش
داستان	داستان
دَفتَر	دفتر
دِلارا	دلارا
رحمانی	رحمانی
رَسوُل	رسول
رِیٖشی	رِیشی
رہنُما	رہنُما
ریاستی	ریاستی
سنجیدہ	سنجیدہ
سَوارِ	سوار
سَویرا	سَویرا
سٕندِس	سندس
سیٖنُک	سَینْک
شاہانہ	شاہانہ
شرمیلا	شرمیلا
شَبنَم	شبنم
شَمشاد	شمشاد
شَہباز	شَہباز
شُعبہٕ	شعبہ
شہادَت	شَہادَت
شیٖنہٕ	شِینَہ
عَثمان	عثمان
عُمران	عمران
فردوسی	فردوسی
فِرقہٕ	فرقہ
مَحمود	محمود
مَسرَت	مسرت
مَعنٰی	معنٰی
مَلِکا	مَلِکا
مَمتاز	ممتاز
مِلیَن	ملین
میٖڈیا	مِیڈِیا
ناراین	ناراین
نَرگِس	نرْگس
نَسرین	نسرین
نیٖلَم	نِیلَم
پرنسپل	پرنسپل
پریزاد	پریزاد
پھاگُن	پھاگن
پیغمبر	پیغمبر
چاکلیٹ	چاکلیٹ
چودھری	چودھری
چٔھتٕر	چَھتَر
ڈاکٹَر	ڈاکْٹر
کارکُن	کارْکن
کشمیرا	کشمیرا
کَنگنا	کنْگْنا
گانٛٹھ	گانْٹھ
گُجرات	گُجرات
ہِندوُ	ہندو
یاسمین	یاسمین
یاسیٖن	یاسِین
یٰسِین	یٰسِین
اسماعیل	اسماعیل
اندرانی	اندرانی
اَحَمَد	احمد
اَپریٖل	اَپْرَیل
ایڈیسَن	ایڈیسن
بَشِیٖر	بشیر
بَنٛگال	بنْگال
بَنٛگلہ	بنْگلہ
تَحصیٖل	تحصیل
تَصَوُر	تَصَوُر
تِجارَت	تِجارَت
حَضْرَت	حَضْرَت
حَوالہٕ	حوالہ
رِیٖڈَر	رِیڈَر
فلکِیات	فلکیات
فِہرسَت	فَہرِسْتِ
لیلاوتی	لیلاوتی
منداکنی	منداکنی
مَحاورٕ	محاور
مَخصوٗص	مخصوص
مُحمَّد	محمد
مٗوجٗود	موجود
ٹرٛیکٹر	ٹریکْٹر
پروفیسر	پروفیسر
چھَتیٖس	چَھتِّیس
کَمپَنی	کمْپنی
گرٛینٛڈ	گرینْڈ
آفرٛیٖدی	آفریدی
ارجُمَند	ارجمند
اَداکارٰ	اداکار
اِسلامُک	اسلامک
اِنٛدِرا	اندرا
خٔلیٖفہٕ	خلیفہ
سَتَمبَر	ستمبر
سِلسِلہٕ	سلسلہ
طبَیعیات	طبیعیات
طٔریٖقہٕ	طریقہ
نَباتیات	نباتیات
نَفسِیات	نفسیات
پُرتَگال	پرتگال
پیٖرزادہ	پِیرزادَہ
حَیاتِیات	حَیاتِیات
ذیابیٖطٔس	ذِیابَیطِسِ
راجَستھان	راجستھان
پرٛوگرٛام	پروگرام
بَرِاعَظٕم	براعظم
دارالحکومت	دارالحکومت
ماحوٗلِیات	ماحولیات
فوٹوٗگرٛافی	فوٹوگرافی
انسائیکلوپیڈیا	انسائیکلوپیڈیا
ا	ا
ن	ن
چ	چ
اس	اس
بے	بے
تٔ	ت
در	در
سر	سر
ما	ما
کہ	کہ
اثر	اثر
اسم	اسم
الی	الی
بار	بار
بَب	بب
بُک	بُک
جنت	جنت
جَل	جَل
حزب	حزب
حصہ	حصہ
خدا	خدا
خوش	خوش
دعا	دعا
دون	دون
دَل	دَل
زور	زور
ساز	ساز
شمس	شمس
عرب	عرب
غزل	غزل
غیر	غیر
فلم	فلم
قسم	قسم
لون	لون
مدد	مدد
ناؤ	ناؤ
ناب	ناب
نات	نات
نام	نام
نَب	نَب
نَس	نَس
وزن	وزن
پیر	پیر
ڈار	ڈار
کرم	کرم
کلو	کلو
کَپ	کَپ
گاو	گاو
گرے	گرے
گُر	گُر
گٔر	گر
گڑھ	گڑھ
آخری	آخری
آصِف	آصف
اونی	اونی
اَثر	اثر
بانو	بانو
ترکی	ترکی
تِمن	تمن
جمعہ	جمعہ
جوان	جوان
حریت	حریت
حصہٕ	حصّہ
حکیم	حکیم
خطاب	خطاب
دینا	دینا
راضی	راضی
روشن	روشن
روٗس	روس
زہرہ	زہرہ
سسٹم	سسٹم
سُپر	سُپَر
سٔتی	ستی
شاعر	شاعر
شامل	شامل
طبیب	طبیب
ظالم	ظالم
عالم	عالم
عظیم	عظیم
غزلہ	غزلہ
قدیم	قدیم
لَگن	لَگَن
محبت	محبت
مشرب	مشرب
مظفر	مظفر
نظام	نظام
نوٗن	نون
نگار	نگار
واجب	واجب
ٹرنک	ٹرنک
ٹونی	ٹونی
پران	پران
پوٗر	پور
کاشت	کاشت
کریم	کریم
کلام	کلام
کوشش	کوشش
کھیر	کھیر
کیٹس	کیٹس
ہائی	ہائی
ادارہ	ادارہ
اشعری	اشعری
اعلان	اعلان
اقوام	اقوام
انجام	انجام
انوپم	انوپم
اَلہٕ	الٰہ
اَمِس	امس
اَننت	اننت
ایجنٹ	ایجنٹ
ایوان	ایوان
بنیاد	بنیاد
بَطَخ	بَطَخ
بَہرا	بَہْرا
بِلہٕ	بلہ
تاکِہ	تاکِہ
تعالی	تعالٰی
تلوار	تلوار
تیٖزی	تیزی
ثقلین	ثقلین
جاوید	جاوید
جماعت	جماعت
جُمعہ	جمعہ
خاتون	خاتون
خَلاف	خلاف
دسمبر	دسمبر
دعائے	دعائے
رایَت	رایَت
رولَٹ	رولٹ
رُکُن	رُکَن
ریٖشی	رِیشی
زَکات	زکات
سلمان	سلمان
سمندر	سمندر
سِندھ	سندھ
سِیاہ	سِیاہ
سیریل	سیریل
شاہین	شاہین
شریٖف	شرِیف
شُروع	شروع
شہادت	شہادت
صَدرِ	صدر
عبادت	عبادت
علامہ	علامہ
عٔلمِ	علم
غَزٕل	غزل
فروری	فروری
قَلَم	قَلَم
قُرآن	قُرآن
ماحول	ماحول
متحدہ	متحدہ
متعلق	متعلق
مذہبی	مذہبی
مراجع	مراجع
معیار	معیار
مَرٕد	مرد
مَقصد	مقصد
مَہان	مَہان
مِثال	مِثال
مٕلِک	ملَک
نانَک	نانَک
ناوَل	ناول
نوروز	نوروز
نومبر	نومبر
نیشنل	نیشنل
وَجَہ	وَجَہ
وَژٗن	وژن
ٹھیٖک	ٹِھیک
پرتاب	پرتاب
پوشہِ	پوشَہ
پیٖکو	پیکو
گرٛان	گران
گِنٛد	گند
گٔیہِ	گیہ
گٗروُ	گرو
اخباری	اخباری
اَپریل	اَپْرَیل
اِرشاد	ارشاد
ایشِیا	ایشْیا
تھامسن	تھامسن
جانباز	جانبازِ
خانقاہ	خانقاہ
سربراہ	سربراہ
سُلطان	سُلطان
سیٖنہٕ	سِینَہ
عَلاقہ	علاقہ
لَمبَر	لمبر
لَکشمی	لَکْشْمی
ماحوٗل	ماحول
محبوٗب	محبوب
نشانہٕ	نشانہ
نٔویٖس	نویس
نیشنَل	نَیشْنَل
پنجابی	پنجابی
پھٕلَے	پَھلے
گاندھی	گاندھی
ہٕنٛدِ	ہند
ابراہیم	ابراہیم
اِتِفاق	اِتِفاق
اِسلاَم	اسلام
بھارَتی	بھارتی
بیروٗنی	بَیرُونی
تَبدیٖل	تبدیل
رَمَضان	رَمَضان
سالانہٕ	سالانَہ
سَتَمبر	ستمبر
سہروردی	سہروردی
سیکورٹی	سیکورٹی
فِلاسفی	فلاسفی
مُتعلِق	متعلق
مُسلمان	مسلمان
اِنتِظام	انتظام
دٕریافَت	درْیافْت
مُقابلہٕ	مقابلہ
ڈِکشَنری	ڈِکْشْنَری
فرانسیٖسی	فرانسیسی
مَعلوٗمات	معلومات
اَنٖگرَیزی	انْگریزی
بَرِصَغیٖر	برصغیر
امیرالمومنین	امیرالمومنین
فوٹوٗگرٛافَر	فوٹوگرافر
آل	آل
تر	تر
دے	دے
رے	رے
زہ	زہ
کی	کی
آرٹ	آرٹ
آسن	آسن
ایچ	ایچ
بول	بول
بَل	بَل
ترے	تِرے
شال	شال
شکل	شکل
صدر	صدر
فیس	فیس
قوم	قوم
لفظ	لفظ
لکھ	لکھ
ماہ	ماہ
نفر	نفر
نون	نون
نٔر	نر
وجہ	وجہ
وری	وری
چوک	چوک
کال	کال
کِہ	کِہ
کہَ	کِہ
کیش	کیش
آبہٕ	آبَہ
آواز	آواز
اکبر	اکبر
بابا	بابا
باتھ	باتھ
بلبل	بلبل
بیگم	بیگم
تارک	تارک
جادۂ	جادۂ
جعفر	جعفر
حسام	حسام
زوٗن	زون
زیرِ	زیرِ
سُنی	سُنی
شیٖن	شَین
طالب	طالب
عزیز	عزیز
عَلی	عَلی
فاضل	فاضل
فرید	فرید
قرآن	قرآن
لیڈر	لیڈر
مارچ	مارچ
محرم	محرم
مزید	مزید
مسجد	مسجد
معنی	معنی
مقام	مقام
موسی	موسی
میٖل	مَیل
ناوٕ	ناو
نجات	نجات
نواز	نواز
پریس	پریس
پَتا	پَتا
پیٖر	پَیر
کرنی	کرنی
کلیش	کلیش
کَلس	کلس
ہُند	ہند
ہِند	ہِند
اوزار	اوزار
اولاد	اولاد
بلاول	بلاول
بَطُخ	بطخ
تاریخ	تاریخ
تقسیم	تقسیم
تنظیم	تنظیم
تَحَت	تحت
جَلال	جَلال
حَسَن	حَسَن
رمضان	رمضان
روٗسی	روسی
رَنٛگ	رنْگ
رہنما	رہنما
ریلوے	ریلوے
زیادہ	زیادہ
صُوفی	صُوفی
علاوہ	علاوہ
فَواد	فواد
فِلمی	فلمی
مقبرہ	مقبرہ
مقبول	مقبول
منازل	منازل
وَزَن	وزن
ٹَنَل	ٹَنَل
پوٗرٕ	پور
پَٹیل	پُٹیل
چارٕج	چارج
کردار	کردار
کَرَن	کَرَن
ہدایت	ہدایت
انقلاب	انقلاب
اَعٔظم	اعظم
اَنٛدٕ	اند
اِنصاف	انصاف
تعمیٖر	تعمیر
سَلمان	سلمان
مخدوٗم	مخدوم
مَرکَز	مرْکز
نِگیٖن	نَگِین
گَردِش	گردش
الدّیٖن	الدَین
تَنظیٖم	تنظیم
جغرافیہ	جغرافیہ
خانٚقاہ	خانقاہ
زَبانہٕ	زبانہ
مَرکَزی	مرْکزی
مَہاتما	مَہاتْما
مَہجوٗر	مَہْجُور
مُحَمَد	مُحَمَد
پرَٛسَو	پرسو
پَنٛجال	پنجال
کیٖمِیا	کِیمِیا
دَسَمبَر	دسمبر
سَلطَنَت	سلطنت
مُنسَلِق	منسلق
اِستِعمال	استعمال
ڈ	ڈ
بٹ	بٹ
شر	شر
فٹ	فٹ
پر	پر
کر	کر
امہ	امہ
انو	انو
اور	اور
این	این
بَٹ	بَٹ
بٔڈ	بُڈ
بین	بین
تَر	تَر
تَل	تَل
تُل	تُل
جبر	جبر
جھا	جھا
خَط	خَط
رام	رام
رتی	رتی
ریا	ریا
زہر	زہر
سعت	سعتِ
معن	معن
موج	موج
مود	مود
مگر	مگر
نار	نار
ناز	ناز
نبی	نبی
نکی	نکی
ٹیا	ٹیا
چھؙ	چَھ
چھٕ	چَھ
ڈِی	ڈی
کری	کری
کنی	کنی
ہری	ہری
ہور	ہور
ہَم	ہَم
یُن	یُن
آنند	آنند
اثنا	اثنا
امیر	امیر
امین	امین
امیہ	امیہ
انیس	انیس
اوشا	اوشا
بشیر	بشیر
بلوچ	بلوچ
بیلا	بیلا
تعلق	تعلق
جبار	جبار
جناب	جناب
حبیب	حبیب
حلیم	حلیم
حمید	حمید
حنیف	حنیف
خلاف	خلاف
خیبر	خیبر
رحمت	رحمت
رحیم	رحیم
روٗد	رود
ریڈی	ریڈی
زبیر	زبیر
ستون	ستون
سلمی	سلمیٰ
سمرن	سمرن
سَبا	سَبا
سیٹھ	سیٹھ
شروع	شروع
شیلا	شیلا
صامت	صامت
صٔدی	صدی
عاصم	عاصم
عقبہ	عقبہ
عَمل	عَمل
فتوی	فتوٰی
فرات	فرات
فقیہ	فقیہ
لعین	لعین
لیلا	لیلا
لینا	لینا
مالا	مالا
مایا	مایا
مصنف	مصنف
معوذ	معوذ
مقصد	مقصد
ملِک	ملَک
ممتا	ممتا
منذر	منذر
مولہ	مولہ
موہن	موہن
میری	میری
مینا	مینا
میٹر	میٹر
ناظم	ناظم
ندیم	ندیم
نقوی	نقوی
نوٗل	نول
ٹنڈن	ٹنڈن
پوری	پوری
پِیا	پِیا
پیٹھ	پیٹھ
چیٖن	چَین
ڈولی	ڈولی
کمار	کمار
کونی	کونی
کویل	کویل
کِرن	کِرن
کیلی	کیلی
گوہر	گوہر
ہندِ	ہند
ہیرا	ہیرا
آزادی	آزادی
آفتاب	آفتاب
اتحاد	اتحاد
اصولی	اصولی
انترا	انترا
اَبرو	ابرو
اَثَر	اَثَر
اَمُک	امک
اِمان	امان
بغداد	بغداد
بَچَن	بَچَن
تحریک	تحریک
جانسن	جانسن
جانور	جانور
جلالُ	جلال
جنوری	جنوری
جُلَے	جلے
حَیات	حَیات
خارجہ	خارجہ
خٕلاف	خلاف
راکھی	راکھی
رَسمِ	رَسمِ
ریکھا	ریکھا
زینَب	زینب
ستمبر	ستمبر
سَبزی	سبزی
شروتی	شروتی
صوٗفی	صوفی
صِرِف	صرف
عٔلِم	علم
قصبہٕ	قصبہ
قٕسٕم	قسم
مبارک	مبارک
مسعود	مسعود
معلیٰ	معلیٰ
موشَن	موشَن
نویٖن	نوین
نَگَر	نَگَر
نیٖلم	نِیلَم
وَقٕت	وقت
پاٹھک	پاٹھک
پرساد	پرساد
پرکاش	پرکاش
پیٖٹھ	پِیٹھ
چودری	چودری
کرسٹل	کرسٹل
کومَل	کومَل
ہِنٛد	ہند
ہٕنٛد	ہند
اداکار	اداکار
الرحمن	الرحمن
العالم	العالم
اَباسی	اباسی
اَشرَف	اشرف
اَنجام	اَنجام
اَگَست	اَگَسْت
بھَجَن	بَھجَن
جَدیٖد	جدید
روحانی	روحانی
سرزمین	سرزمین
سِگنَل	سِگْنَل
قَصبہٕ	قصبہ
مسلمان	مسلمان
مَریَم	مرْیم
مُمتاز	ممتاز
نُنٛدٕ	نند
پاریکھ	پاریکھ
پیدائش	پیدائش
چوہدری	چوہدری
کشمیری	کشمیری
یادگار	یادگار
انگریزی	انگریزی
اَداکار	اَداکار
اِبتِدا	ابتدا
تقریباً	تقریباً
فِہرِست	فَہرِسْتِ
وکٹوریہ	وکٹوریہ
پَنٛڈِت	پنْڈت
پیرزادہ	پیرزادہ
دٕستِیاب	دستیاب
ذوالفقار	ذوالفقار
زِنٛدَگی	زندگی
ز	ز
امن	امن
اَز	اَز
ایس	ایس
بحر	بحر
بِل	بِل
تاج	تاج
تَس	تس
دیو	دیو
رَگ	رَگ
ساس	ساس
سطح	سطح
سنی	سنی
صدی	صدی
ظفر	ظفر
مون	مون
نجف	نجف
نٔو	نو
پال	پال
چھٗ	چَھ
کَل	کَل
گول	گول
یاد	یاد
آثار	آثار
آمِر	آمِر
ادبی	ادبی
اصلی	اصلی
اعظم	اعظم
امان	امان
اگست	اگست
بارہ	بارہ
بالا	بالا
بیٖم	بِیم
تشیع	تشیع
جناح	جناح
جواد	جواد
حَسن	حسن
زہرا	زہرا
سوفی	سوفی
سُند	سند
شبیر	شبّیر
شوکت	شوکت
عراق	عراق
فرقہ	فرقہ
قٕسم	قسم
مارک	مارک
مسیح	مسیح
نِدا	نِدا
کورٹ	کورٹ
گامی	گامی
گوتم	گوتم
آثارِ	آثارِ
اَدَب	اَدَب
اپریل	اپریل
تعلیم	تعلیم
تِلہٕ	تلّہ
جَنتا	جنتا
حُسین	حسین
حِساب	حِساب
درگاہ	درگاہ
دَرٕم	درم
روزَن	روزَن
سَبٕز	سبز
سَرَس	سرس
سَنٛس	سنس
عسکری	عسکری
مارٕچ	مارْچ
مشہور	مشہور
میلان	میلان
واپَس	واپَس
ولادت	ولادت
آنٛنَد	آنند
اکتوبر	اکتوبر
زٔمیٖن	زمین
عاشورہ	عاشورہ
فِلِمی	فلمی
چَنٛڈی	چنْڈی
تحریٖکِ	تحریک
تٔہذیٖب	تَہذِیب
رَہنُما	رَہْنُما
زِنٛدگی	زندگی
مَحفوٗظ	محفوظ
اَنگریزی	انْگریزی
جے	جے
سہ	سہ
لا	لا
آصف	آصف
ادا	ادا
الگ	الگ
حَق	حَق
دفن	دفن
طِب	طِب
لٔٹ	لَٹ
محی	محی
مٔی	می
نشہ	نشہ
ڈَل	ڈَل
ہند	ہند
آلہٕ	آلَہ
امہِ	امّہ
اندر	اندر
اینڈ	اینڈ
بینک	بینک
جوہر	جوہر
رسول	رسول
سعید	سعید
سِکھ	سِکھ
فیلڈ	فیلڈ
کاظم	کاظم
کھیل	کھیل
آبادی	آبادی
بَتہٕ	بتّہ
بِجلی	بِجلی
حِصَن	حصن
خلیفہ	خلیفہ
دَرٕج	درج
روزُن	روزن
روشنی	روشنی
روٗمی	رومی
شاعری	شاعری
شُمار	شُمار
صَفہٕ	صفّہ
طرفہٕ	طرفہ
عُمَر	عُمَر
معصوم	معصوم
مُقام	مُقام
پردیش	پردیش
پَنہٕ	پنہ
کلیسا	کلیسا
آکسیجن	آکسیجن
اسلامک	اسلامک
عُنصُر	عنصر
موبائل	موبائل
مَطلَب	مطلب
نِیازی	نِیازی
پرَدیش	پردیش
پنٛڈِت	پنْڈت
ہِنٛدی	ہندی
اِندِرا	اندرا
جَنٛگلی	جنْگلی
مَغرَبی	مغربی
اِستعمال	استعمال
بل	بل
امس	امس
جین	جین
رود	رود
سَب	سَب
شہر	شہر
فرح	فرح
میچ	میچ
چیز	چیز
کرن	کرن
کیٹ	کیٹ
گور	گور
ایمی	ایمی
اینی	اینی
بزرگ	بزرگ
بُدھ	بُدھ
جوہی	جوہی
حاصل	حاصل
حدیث	حدیث
حرام	حرام
خولی	خولی
دیوی	دیوی
زیبا	زیبا
سارا	سارا
سلیم	سلیم
ضحاک	ضحاک
عبید	عبید
لارا	لارا
مُلک	ملَک
نامہ	نامہ
نکول	نکول
ٹینا	ٹینا
پایل	پایل
پریا	پریا
اقبال	اقبال
اِمام	اِمام
تَمام	تَمام
تُرکی	ترْکی
سمارٹ	سمارٹ
سورُس	سورس
سیاسی	سیاسی
صَدٕر	صدر
عالیہ	عالیہ
عیسیٰ	عیسیٰ
فِلِم	فلم
مجتہد	مجتہد
مولوی	مولوی
نالہٕ	نالَہ
نعمان	نعمان
نمرتا	نمرتا
نِظام	نِظام
ٹیٖوب	ٹِیُوب
گُلہِ	گلّہ
اربعین	اربعین
اُردُو	اُردُو
جَماعت	جماعت
سَلفیٹ	سلفیٹ
سیٖنَس	سینس
عُنصَر	عنصر
مَشیٖن	مشین
آکسیجَن	آکسیجن
تٔحریٖک	تحریک
جٔنوٗبی	جنوبی
مَنصوٗب	منصوب
آکسیٖجَن	آکسیجن
مُسَلمان	مسلمان
یونیورسٹی	یونیورسٹی
پی	پی
گل	گل
آلہ	آلہ
باغ	باغ
جان	جان
جون	جون
داس	داس
دین	دین
راو	راو
فیض	فیض
لقب	لقب
مسک	مسک
پوش	پوش
کَن	کَن
گیم	گیم
اَلگ	الگ
تمام	تمام
رانی	رانی
ربیع	ربیع
مودی	مودی
وانی	وانی
کَرن	کرن
گَڑھ	گَڑھ
دوران	دوران
عثمان	عثمان
عَربی	عَربی
غُلام	غُلام
لَگان	لَگان
مَواد	مَواد
ٹینِس	ٹینِس
کَرُن	کرن
انصاری	انصاری
اَخبار	اخبار
اپریٖل	اَپْرَیل
زبانہِ	زبانہ
مشہوٗر	مشْہور
جَواہَر	جَواہَر
مَضموٗن	مضمون
پَنٛجاب	پنجاب
کمپیوٹر	کمپیوٹر
مُختَلِف	مختلف
کَمپیوٗٹَر	کمْپیوٹر
از	از
نہ	نہ
باہ	باہ
تِہ	تِہ
سان	سان
ملک	ملک
مول	مول
پور	پور
اردو	اردو
بانی	بانی
دوٗر	دور
سِری	سِری
لیٖگ	لَیگ
مَگر	مَگَر
پتہٕ	پتّہ
چِھٚ	چَھ
کالج	کالج
ہجری	ہجری
یوسف	یوسف
یِمن	یمن
بَچہِ	بَچَہ
محمود	محمود
مطابق	مطابق
کربلا	کربلا
اِقبال	اقبال
بُخاری	بُخاری
بُلبُل	بُلبُل
زَبانَ	زبان
سِنٛگھ	سنْگھ
فاطِمہ	فاطمہ
مَذہَب	مذْہب
اِسلامی	اسلامی
پرَٛدیش	پردیش
سَنَسکرٕٛت	سنسکرت
یہ	یہ
آشا	آشا
اسی	اسی
اصل	اصل
انس	انس
اہل	اہل
جیا	جیا
دتا	دتا
سند	سند
علم	علم
مور	مور
نور	نور
نگر	نگر
چَھ	چَھ
کِن	کِن
تارا	تارا
زبان	زبان
سلمہ	سلمہ
شریف	شریف
شَہر	شَہر
عتبہ	عتبہ
عٔلم	علم
غلام	غلام
لفٕظ	لفظ
لُکھ	لَکھ
مَحل	محل
نوفل	نوفل
وادی	وادی
پنڈت	پنڈت
پونم	پونم
مہرین	مہرین
کَلہٕ	کلّہ
یوسُف	یوسف
بُنیاد	بُنیاد
عٔظیٖم	عظیم
مولانا	مولانا
سِیاسَت	سِیاسَت
مُحَمَّد	محمد
نَوَمبَر	نومبر
وابَستہٕ	وابستہ
اِنجَکشَن	انجکشن
کانٛگرٛیس	کانْگْریس
جی	جی
احد	احد
بال	بال
فَن	فَن
کول	کول
کٔر	کر
حسین	حسین
نیلم	نیلم
وفات	وفات
یعنی	یعنی
زندگی	زندگی
فاطمہ	فاطمہ
پاٹھی	پاٹھی
پنجاب	پنجاب
ڈاکٹر	ڈاکٹر
کِتاب	کِتاب
طَرفہٕ	طرفہ
مِشیٖن	مشین
شمارندہ	شمارندہ
ام	ام
اے	اے
ستی	ستی
صلی	صلی
سٕہہ	سہہ
وینا	وینا
کپور	کپور
تاکہِ	تاکِہ
تِمَن	تمن
مَگَر	مَگَر
پارٹی	پارٹی
بھارتی	بھارتی
صوٗبہٕ	صوبہ
موسیٖقی	موسِیقی
مَشرِقی	مشرقی
پاکستان	پاکستان
کَشمیٖر	کشمیر
ای	ای
دور	دور
راج	راج
شیر	شیر
پاک	پاک
چھَ	چَھ
گیہ	گیہ
عربی	عربی
ناتھ	ناتھ
جَنٛگ	جنْگ
زیارت	زیارت
فاروق	فاروق
چوہان	چوہان
الدیٖن	الدَین
اگروال	اگروال
مُسلِم	مسلم
مُرَکَب	مُرَکَب
سو	سو
ڈی	ڈی
کم	کم
گو	گو
نَر	نَر
وار	وار
چَک	چَک
جوشی	جوشی
جوٗن	جون
رافع	رافع
مصطفی	مصطفٰی
نیران	نیران
ہِندی	ہندی
خاندان	خاندان
میٖٹَر	مِیٹَر
کشمیٖر	کشمیر
تَخلیٖق	تخلیق
تَکنیٖک	تَکْنِیک
گانٛدھی	گاندھی
بی	بی
زن	زن
خاص	خاص
زَن	زَن
رازٕ	راز
ٹیسٹ	ٹیسٹ
اَصٕل	اصل
مختار	مختار
ایرانی	ایرانی
آب	آب
ابن	ابن
راہ	راہ
لال	لال
مَت	مَت
یہٕ	یِہ
خالد	خالد
شہید	شہید
ظریف	ظریف
گپتا	گپتا
الدین	الدین
ترجمہ	ترجمہ
چوپڑا	چوپڑا
ہَضٕم	ہضم
اُردوٗ	اردو
عِمران	عمران
تَشخیٖص	تشخیص
تمن	تمن
دِل	دِل
زرگر	زرگر
ٹیٖم	ٹِیم
لکشمی	لکشمی
گَردَن	گردن
انٛگریٖزی	انْگریزی
سَنٛسکرِت	سنسکرت
زِ	زِ
آیت	آیت
اَس	اس
میرا	میرا
ریڈیو	ریڈیو
نَڈال	نِڈال
اَحمَد	احمد
عبداللہ	عبداللہ
مَرکٔزی	مرْکزی
سری	سری
سعد	سعد
فون	فون
قیس	قیس
میر	میر
عباس	عباس
معاذ	معاذ
زِندگی	زندگی
کَم	کَم
کُل	کُل
آباد	آباد
پوجا	پوجا
اسلامی	اسلامی
نِظامِ	نِظامِ
تِم	تم
راز	راز
سین	سین
شاخ	شاخ
نِش	نِش
وَن	وَن
آسَن	آسَن
چیٖز	چِیز
حسن	حسن
کہِ	کِہ
یزید	یزید
انَنت	اننت
اِسلام	اِسلام
جَرمَن	جرمن
علاقہٕ	علاقہ
عَلاقہٕ	علاقہ
پتہ	پتہ
آگُر	آگر
کتاب	کتاب
نہٕ	نَہ
میٖر	مَیَر
فارسی	فارسی
اِنسان	اِنسان
اہم	اہم
سٕتی	ستی
آف	آف
ثَنا	ثَنا
عالمی	عالمی
لَفظٕ	لفظ
کار	کار
شیعہ	شیعہ
تٕہ	تَہ
دار	دار
ثابت	ثابت
قسٕم	قسم
مادٕ	ماد
السلام	السلام
بَین	بَین
واقع	واقع
سُنٛد	سند
اداکارہ	اداکارہ
زَبانہِ	زبانہ
و	و
کِرٛکَٹ	کرْکٹ
مالک	مالک
اسلام	اسلام
تان	تان
چِھ	چَھ
کامَن	کامَن
کشمیر	کشمیر
اَجَنٹ	اجنْٹ
ناگ	ناگ
قومی	قومی
یمن	یمن
اَہَم	اَہَم
زٕ	ز
دان	دان
شیخ	شیخ
وُن	ون
مُلُک	ملَک
ہندی	ہندی
جانوَر	جانور
احمد	احمد
کُن	کُن
طِبی	طِبی
اَعظَم	اعظم
آزاد	آزاد
پاکِستان	پاکِستان
اَنٛگریٖزی	انْگریزی
ابو	ابو
تام	تام
سُہ	سِہ
شَہَر	شَہَر
تم	تم
لَفٕظ	لفظ
ابی	ابی
یِمَن	یمن
آر	آر
سِنگھ	سنْگھ
نَمبَر	نمبر
مَشہوٗر	مشْہور
سَر	سَر
علیہ	علیہ
پَتہٕ	پتّہ
زیٛادٕ	زِیاد
باقی	باقی
کَنٹراسٹ	کنْٹراسْٹ
طور	طور
امام	امام
حضرت	حضرت
عام	عام
عمرو	عمرو
حِصہٕ	حصّہ
کور	کور
محمد	محمد
ایم	ایم
عبد	عبد
کِس	کِس
حارث	حارث
ٹی	ٹی
ناو	ناو
شاہ	شاہ
سید	سید
چُھ	چَھ
تَصویٖر	تصویر
سی	سی
خوٗن	خون
گام	گام
اَمہِ	امّہ
تہِ	تہِ
اللہ	اللہ
آسان	آسان
علی	علی
زَبان	زَبان
خان	خان
گُلوکار	گلوکار
اَمریٖکی	امریکی
تہ	تہ
اوس	اوس
یا	یا
صُحابی	صحابی
ہُنٛد	ہند
چھ	چھ
یہِ	یِہ
بن	بن
اَداکارہ	اداکارہ
تہٕ	تَہ
چھُ	چَھ
چھِ	چَھ