ئاب	آب
ئابا	آبا
ئابێ	آب
ئاخ	آخ
ئاخر	آخر
ئاخرەت	آخرت
ئاخێ	آخ
ئاخە	آخ
ئادەم	آدم
ئارا	آرا
ئارارات	آرارات
ئاراستە	آراست
ئاراستەی	آراستی
ئاراستەیێ	آراستی
ئارام	آرام
ئارامم	آرامم
ئارامی	آرامی
ئارامیێ	آرامی
ئارامە	آرام
ئاری	آری
ئاریان	آریان
ئاریشێ	اریش
ئاریشە	اریش
ئارێشێ	آرش
ئارێشە	آرش
ئارەزو	آرزو
ئازاد	آزاد
ئازادی	آزادی
ئازادیان	آزادیان
ئازادیێ	آزادی
ئازادە	آزاد
ئازار	آزار
ئازاری	آزاری
ئازەری	آذری
ئاسان	آسان
ئاسانتر	آسانتر
ئاسانە	آسان
ئاسایش	آسایش
ئاسایشی	آسایشی
ئاسایشێ	آسایش
ئاسایی	آسایی
ئاساییە	آسایی
ئاست	است
ئاستان	آستان
ئاستێ	است
ئاستە	است
ئاسمان	آسمان
ئاسمانی	آسمانی
ئاسمانێ	آسمان
ئاسنی	اثنی
ئاسیا	آسیا
ئاسێ	آس
ئاش	آش
ئاشتی	آشتی
ئاشتیانە	آشتیان
ئاشتیێ	آشتی
ئاشنا	آشنا
ئاشوری	آشوری
ئاشووری	آشوری
ئاشێ	آش
ئاغا	آغا
ئاقل	اقل
ئال	آل
ئالا	آلا
ئالان	الآن
ئالتون	التون
ئالی	آلی
ئالیێ	آلی
ئالیەک	الیک
ئالیەکێ	الیک
ئالێ	آل
ئالێن	آلن
ئالەکێ	الک
ئاما	اما
ئامادە	آماد
ئامار	آمار
ئامارێ	آمار
ئامر	آمر
ئامراز	امراض
ئامیر	امیر
ئامیری	امیری
ئامیرێ	امیر
ئامیرەک	امیرک
ئامیرەکێ	امیرک
ئامیرەیە	امیری
ئامێدی	آمدی
ئامێدیێ	آمدی
ئامەد	آمد
ئامەدێ	آمد
ئان	آن
ئانا	آنا
ئانجین	انجین
ئاهێن	آهن
ئاهەنگ	آهنگ
ئاوا	آوا
ئاوار	آوار
ئاوارە	آوار
ئاواز	آواز
ئاوازێ	آواز
ئاوایی	آوایی
ئاوران	آوران
ئاڕاستەی	آراستی
ئاڕیشە	اریش
ئاژانسێ	آژانس
ئاڤ	او
ئاڤا	آوا
ئاڤان	اوان
ئاڤیێن	اوین
ئاڤێ	او
ئاڤە	او
ئاگر	اگر
ئاگرێ	اگر
ئاگەه	آگه
ئاڵوودەیێ	آلودی
ئایا	آیا
ئایدا	آیدا
ئایدزێ	ایدز
ئایدیۆلۆژی	ایدیولوژی
ئایفون	آیفون
ئایفۆن	آیفون
ئاین	این
ئاینان	اینان
ئایندە	آیند
ئاینێ	این
ئایین	آیین
ئایینێ	آیین
ئایە	آی
ئبن	بن
ئو	و
ئول	ول
ئولی	ولی
ئۆل	ول
ئۆلا	ولا
ئۆلی	ولی
ئیدی	یدی
ئیراق	یراق
ئیراقێ	یراق
ئیزدی	یزدی
ئیزدیان	یزدیان
ئیک	یک
ئیکێ	یک
ئێخست	خست
ئێخستن	خستن
ئێخستنە	خستن
ئێخستە	خست
ئێخیت	خیط
ئێخیتە	خیط
ئێدارا	دارا
ئێدی	دی
ئێرش	رش
ئێزدی	زدی
ئێزی	زی
ئێسکەر	سکر
ئێشم	شم
ئێشێن	شن
ئێما	ما
ئێمزا	مزا
ئێمن	من
ئێکانە	کان
ئێکانەیێ	کانی
ئێکدو	کدو
ئێکدوو	کدو
ئێکسە	کس
ئێکسەر	کسر
ئێکلا	کلا
ئێکن	کن
ئێکو	کو
ئێکی	کی
ئێکین	کین
ئێکەتی	کتی
ئێکەتیێ	کتی
ئێکەتیە	کتی
ئێکەتێ	کت
ئێکەم	کم
ئێکەما	کما
ئێکەمین	کمین
ئەبو	بو
ئەبوو	بو
ئەبۆ	بو
ئەبیەن	بین
ئەتیک	تیک
ئەحمد	حمد
ئەحمەد	حمد
ئەحمەدی	حمدی
ئەحمەدێ	حمد
ئەحمەدە	حمد
ئەختەرێ	خطر
ئەختەرە	خطر
ئەخلاق	خلاق
ئەخلاقێ	خلاق
ئەدهەم	دهم
ئەدڤار	دوار
ئەدەب	دب
ئەدەبی	دبی
ئەدەبێ	دب
ئەدەبە	دب
ئەرب	رب
ئەرتووش	رتوش
ئەرد	رد
ئەردێ	رد
ئەرزاقی	رزاقی
ئەرزاقێ	رزاق
ئەرشێ	رش
ئەرشەد	رشد
ئەرک	رک
ئەرکی	رکی
ئەرکێ	رک
ئەرکێن	رکن
ئەرکە	رک
ئەرێنێ	رن
ئەرەب	رب
ئەزم	ذم
ئەساسێ	ساس
ئەستون	ستون
ئەستەم	ستم
ئەستەمە	ستم
ئەسل	سل
ئەسوەد	سود
ئەسیل	سیل
ئەسەد	سد
ئەسەدێ	سد
ئەشیر	شیر
ئەقل	قل
ئەقلێ	قل
ئەقلە	قل
ئەقلەکێ	قلک
ئەلند	لند
ئەلیزێ	لیز
ئەلینا	لینا
ئەمانەتڤە	مانتو
ئەمجارە	مجار
ئەمجەد	مجد
ئەمن	من
ئەمنا	منا
ئەمنی	منی
ئەمپێر	مپر
ئەمپێران	مپران
ئەمپێرێ	مپر
ئەمڕۆ	مرو
ئەمڕۆی	مروی
ئەمیرا	میرا
ئەمین	مین
ئەمێن	من
ئەمەش	مش
ئەمەل	مل
ئەنبار	نبار
ئەنساری	نثاری
ئەنوەر	نور
ئەنەس	نص
ئەهل	هل
ئەهلی	هلی
ئەو	و
ئەوا	وا
ئەوان	وان
ئەون	وِن
ئەوی	وی
ئەوین	وین
ئەویێن	وین
ئەوێ	و
ئەوێن	وِن
ئەوە	و
ئەوەش	وش
ئەوەندە	وند
ئەوەی	وی
ئەوەیە	وی
ئەپل	پل
ئەڤ	و
ئەڤا	وا
ئەڤان	وان
ئەڤسالە	وصال
ئەڤی	وی
ئەڤین	وین
ئەڤینێ	وین
ئەڤێ	و
ئەڤێن	وِن
ئەڤە	و
ئەڤەنە	وِن
ئەڤەیە	وی
ئەکبەر	کبر
ئەکتەری	کتری
ئەکتەریێ	کتری
ئەکرەم	کرم
ئەگەر	گر
ئەگەرا	گرا
ئەگەران	گران
ئەگەری	گری
ئەگەرێ	گر
ئەگەرە	گر
ئەگەرەکان	گرکان
ئەیاد	یاد
ئەیمەن	یمن
ابن	ابن
ابو	ابو
احسان	احسان
افواج	افواج
الله	الله
ان	آن
انا	آنا
با	با
باب	باب
بابا	بابا
بابێ	باب
بابە	باب
بابەت	بابت
بابەتێ	بابت
بابەتە	بابت
بابەک	بابک
باتێل	باطل
باتێلێ	باطل
باج	باج
باجێ	باج
باجە	باج
بار	بار
باران	باران
باراندن	باراندن
بارانی	بارانی
بارانێ	باران
بارانەک	بارانک
باراک	باراک
باربارا	باربارا
بارزانی	بارزانی
بارزانیێ	بارزانی
بارسێلۆنا	بارسلونا
باری	باری
باریە	باری
بارێ	بار
بارە	بار
بارەکێ	بارک
بارەگەه	بارگه
بارەگەهێ	بارگه
بازار	بازار
بازاری	بازاری
بازارێ	بازار
بازاڕی	بازاری
بازاڕێ	بازار
بازرگان	بازرگان
بازرگانی	بازرگانی
بازرگانیێ	بازرگانی
بازرگانیە	بازرگانی
بازرگانێ	بازرگان
بازل	بازل
بازنەیا	بازنیا
بازی	بازی
بازێ	باز
باسکێ	باسک
باسێن	باسن
باش	باش
باشی	باشی
باشێ	باش
باشە	باش
باقر	باقر
باقری	باقری
باقی	باقی
بالا	بالا
بالادەست	بالادست
بالایی	بالایی
بالندە	بالند
بالێ	بال
بان	بان
باندێ	باند
بانک	بانک
بانکی	بانکی
بانکێ	بانک
بانگ	بانگ
بانگێ	بانگ
بانی	بانی
بانە	بان
بانەک	بانک
باوەر	باور
باوەرێ	باور
باڵا	بالا
بایدن	بایدن
بایرن	بایرن
بایکۆت	بایکوت
ببو	ببو
ببوو	ببو
ببین	ببین
ببینم	ببینم
ببینی	ببینی
ببینە	ببین
ببەین	ببین
ببەینە	ببین
بت	بت
بتنێ	بتن
بجه	بجه
بحرالعلوم	بحرالعلوم
بد	بد
بدن	بدن
بدێ	بد
بدە	بد
بدەست	بدست
بدەستێ	بدست
بدەم	بدم
بدەمێ	بدم
بدەمە	بدم
بدەن	بدن
بدەنێ	بدن
بدەنە	بدن
بدەی	بدی
بدەین	بدین
بدەینێ	بدین
بدەینە	بدین
بدەیێ	بدی
بدەیە	بدی
بر	بر
برادەر	برادر
براستی	براستی
برای	برای
برایان	برایان
برایانە	برایان
برایی	برآیی
برایێ	برای
برایێن	براین
برد	برد
برس	برس
برسی	برسی
برسێ	برس
برن	برن
برنا	برنا
برنج	برنج
برنجی	برنجی
برنجێ	برنج
برنۆ	برنو
برنە	برن
بروکسل	بروکسل
بروکسێلێ	بروکسل
برۆ	برو
برۆنۆ	برونو
بری	بری
بریتانیا	بریتانیا
برین	برین
برینێ	برین
برینە	برین
بریە	بری
برێنت	برنت
برێڤە	برو
برە	بر
برەڤن	برون
بزحمەتە	بزحمت
بزەحمەت	بزحمت
بزەحمەتە	بزحمت
بستەه	بسته
بسەر	بسر
بسەرێ	بسر
بشار	بشار
بشوو	بشو
بشۆ	بشو
بشۆی	بشوی
بلا	بلا
بلبل	بلبل
بلند	بلند
بلندا	بلندا
بلندێ	بلند
بلندە	بلند
بلووریان	بلوریان
بلۆک	بلوک
بلی	بلی
بلەز	بلز
بلەزە	بلز
بم	بم
بن	بن
بنڤیسم	بنویسم
بنڤیسە	بنویس
بنگە	بنگ
بنی	بنی
بنێ	بن
بنە	بن
بنەفش	بنفش
بنەفشی	بنفشی
بنەفشێ	بنفش
بنەما	بنما
به	به
بها	بها
بهادار	بهادار
بهار	بهار
بهارێ	بهار
بهایی	بهایی
بهاێ	بها
بهێت	بهت
بهێتە	بهت
بهێلم	بهلم
بهێلی	بهلی
بهێلە	بهل
بو	بو
بوتان	بوتان
بوری	بوری
بوریا	بوریا
بول	بول
بوم	بوم
بومە	بوم
بوو	بو
بووری	بوری
بووسە	بوس
بوول	بول
بووم	بوم
بوومە	بوم
بووکەر	بوکر
بوویمە	بویم
بوویی	بویی
بووییە	بویی
بوویەر	بویر
بوویەرا	بویرا
بووە	بو
بویەرێ	بویر
بوە	بو
بچین	بچین
بچینە	بچین
بڕاورد	برآورد
بڕوات	بروات
بڕین	برین
بڕیە	بری
بڕێ	بر
بڕێڤە	برو
بڤێ	بو
بکار	بکار
بکارێ	بکار
بکت	بکت
بکن	بکن
بکە	بک
بکەت	بکت
بکەتە	بکت
بکەن	بکن
بکەنێ	بکن
بکەنە	بکن
بگشتی	بگشتی
بگەری	بگری
بۆ	بو
بۆتان	بوتان
بۆرن	بورن
بۆری	بوری
بۆریا	بوریا
بۆزان	بوزان
بۆزانی	بوزانی
بۆش	بوش
بۆل	بول
بۆلێ	بول
بۆمە	بوم
بۆکان	بوکان
بۆیەر	بویر
بۆیەرا	بویرا
بۆیەرێ	بویر
بی	بی
بیابانێ	بیابان
بیان	بیان
بیانی	بیانی
بیانیان	بیانیان
بیانێ	بیان
بیت	بیت
بیتە	بیت
بیروت	بیروت
بیست	بیست
بیستێ	بیست
بیل	بیل
بین	بین
بینم	بینم
بینی	بینی
بینە	بین
بیژنە	بیژن
بیک	بیک
بیێ	بی
بیە	بی
بێت	بت
بێتە	بت
بێختە	بخت
بێدار	بدار
بێرین	برین
بێریێن	برین
بێرێن	برن
بێزار	بزار
بێل	بل
بێن	بن
بێنز	بنز
بێنە	بن
بێژێ	بژ
بێژە	بژ
بێکار	بکار
بێکاری	بکاری
بێکاریێ	بکاری
بێکەس	بکس
بێگەرد	بگرد
بێی	بی
بەت	بت
بەحرەین	بحرین
بەحرەینێ	بحرین
بەحس	بحث
بەحسێ	بحث
بەخت	بخت
بەختی	بختی
بەختیار	بختیار
بەختێ	بخت
بەخش	بخش
بەخشی	بخشی
بەخشیە	بخشی
بەخشە	بخش
بەد	بد
بەدر	بدر
بەدریە	بدری
بەدەست	بدست
بەدەل	بدل
بەر	بر
بەران	بران
بەراورد	برآورد
بەراوردی	برآوردی
بەرخوریێ	برخوری
بەرد	برد
بەردارێ	بردار
بەردێ	برد
بەردەم	بردم
بەردەن	بردن
بەردەی	بردی
بەرز	برز
بەرزە	برز
بەرقرار	برقرار
بەرلین	برلین
بەرهندێ	برهند
بەرهەم	برهم
بەرهەما	برهما
بەرهەمێ	برهم
بەرهەمێن	برهمن
بەرهەمە	برهم
بەرپا	برپا
بەرڤ	برو
بەرگ	برگ
بەرگان	برگان
بەرگری	برگری
بەرگریێ	برگری
بەرگێ	برگ
بەری	بری
بەریتانیا	بریتانیا
بەرین	برین
بەرێ	بر
بەرێز	برز
بەرێزە	برز
بەرێن	برن
بەرە	بر
بەرەف	برف
بەرەو	برو
بەرەڤ	برو
بەرەکێ	برک
بەرەکەت	برکت
بەرەی	بری
بەرەیێ	بری
بەرەیێن	برین
بەس	بس
بەستا	بستا
بەستن	بستن
بەستنێ	بستن
بەستی	بستی
بەسرا	بسرا
بەسرە	بسر
بەسێ	بس
بەسە	بس
بەسەر	بسر
بەش	بش
بەشار	بشار
بەشیر	بشیر
بەشێ	بش
بەشە	بش
بەشەکن	بشکن
بەعس	بعث
بەغداد	بغداد
بەلا	بلا
بەلاش	بلاش
بەلغەم	بلغم
بەلوچستان	بلوچستان
بەلوچستانێ	بلوچستان
بەلوچیان	بلوچیان
بەلی	بلی
بەلێ	بل
بەم	بم
بەن	بن
بەند	بند
بەندی	بندی
بەندێ	بند
بەندە	بند
بەندەر	بندر
بەندەرێ	بندر
بەنکێ	بنک
بەنی	بنی
بەنە	بن
بەهار	بهار
بەهارێ	بهار
بەهر	بهر
بەهرام	بهرام
بەهرە	بهر
بەهزاد	بهزاد
بەهەشتی	بهشتی
بەهەشتێ	بهشت
بەهەشتە	بهشت
بەو	بو
بەوە	بو
بەوەش	بوش
بەپرسێ	بپرس
بەڕێز	برز
بەکتاش	بکتاش
بەکر	بکر
بەکری	بکری
بەیاتی	بیاتی
بەیانێ	بیان
بەیتا	بیتا
بەیتێ	بیت
بەیتە	بیت
بەین	بین
بەینە	بین
تا	تا
تابلۆ	تابلو
تابووت	تابوت
تابووتێ	تابوت
تاجر	تاجر
تارق	طارق
تاری	تاری
تاریک	تاریک
تاریێ	تاری
تازی	تازی
تاعەت	طاعت
تاقی	تاقی
تالبیان	طالبیان
تالەبانی	طالبانی
تام	تام
تانک	تانک
تانکێ	تانک
تاها	طاها
تاهر	طاهر
تاوان	تاوان
تاوانێ	تاوان
تاوانە	تاوان
تاک	تاک
تاکی	تاکی
تاکێ	تاک
تاکە	تاک
تاڵەبانی	طالبانی
تایم	تایم
تایمز	تایمز
تایوان	تایوان
تایوانی	تایوانی
تایوانێ	تایوان
تر	تر
ترامپ	ترامپ
ترس	ترس
ترسا	ترسا
ترساندن	ترساندن
ترساندنێ	ترساندن
ترسناک	ترسناک
ترسێ	ترس
ترسە	ترس
ترم	ترم
ترن	ترن
ترک	ترک
ترەس	ترس
تشت	تشت
تشتێ	تشت
تشتە	تشت
تشتەک	تشتک
تشتەکێ	تشتک
تشتەکە	تشتک
تل	تل
تلگراف	تلگراف
تم	تم
تمام	تمام
تنی	تنی
تنێ	تن
تو	تو
توانا	توانا
توانست	توانست
تور	تور
توران	توران
توری	توری
تورێن	تورن
تورە	تور
تورەیە	توری
توفیق	توفیق
تومار	طومار
تون	تون
تونسێ	تونس
توورە	تور
تووش	توش
تووشێ	توش
توپ	توپ
توڕێن	تورن
توی	توی
تڕسا	ترسا
تڤر	تور
تکریت	تکریت
تۆ	تو
تۆران	توران
تۆرێ	تور
تۆرێن	تورن
تۆرە	تور
تۆز	توز
تۆزێ	توز
تۆش	توش
تۆل	طول
تۆلا	تولا
تۆمار	طومار
تۆماس	توماس
تۆپ	توپ
تۆڕێن	تورن
تۆڕە	تور
تی	تی
تیئێنتی	طینتی
تیم	تیم
تیمێ	تیم
تین	تین
تیو	تیو
تیوری	تیوری
تیپا	تیپا
تیۆر	طیور
تیۆری	تیوری
تیۆرێ	طیور
تیۆرە	طیور
تێر	تر
تێرا	ترا
تێست	تست
تێسلا	تسلا
تێشتێ	تشت
تێن	تن
تێنە	تن
تێک	تک
تێکەل	تکل
تەباتەبایی	طباطبایی
تەباخێ	طباخ
تەحریر	تحریر
تەحسین	تحسین
تەخت	تخت
تەختی	تختی
تەختێ	تخت
تەخمین	تخمین
تەر	تر
تەرزێ	طرز
تەرش	ترش
تەرم	ترم
تەرمێ	ترم
تەزویر	تزویر
تەسلیم	تسلیم
تەسلیمی	تسلیمی
تەسنیم	تسنیم
تەقدیرێ	تقدیر
تەقە	تق
تەلعەت	طلعت
تەلەبە	طلب
تەمام	تمام
تەماما	تماما
تەمەر	تمر
تەن	تن
تەنها	تنها
تەنگ	تنگ
تەنگی	تنگی
تەنگیێ	تنگی
تەنگە	تنگ
تەنی	تنی
تەنێ	تن
تەنەکێ	تنک
تەهران	تهران
تەهرانێ	تهران
تەوافق	توافق
تەوافێ	طواف
تەوفیق	توفیق
تەوفیقە	توفیق
تەوەر	تور
تەوەران	توران
تەوەرێ	تور
تەوەرێن	تورن
تەپ	تپ
تەپێ	تپ
تەپە	تپ
تەڕ	تر
تەڤ	تو
تەڤلی	تولی
تەڤن	تون
تەڤنێ	تون
تەڤە	تو
تەکنۆلۆژی	تکنولوژی
تەکنیک	تکنیک
تەیب	طیب
تەیبی	طیبی
تەیران	تیران
تەیف	طیف
تەیێ	تی
تەیە	تی
جا	جا
جابر	جابر
جار	جار
جاری	جاری
جارێ	جار
جارە	جار
جاسم	جاسم
جاش	جاش
جان	جان
جانگیر	جانگیر
جانێ	جان
جانەوەر	جانور
جدی	جدی
جزر	جزر
جل	جل
جلال	جلال
جمال	جمال
جمیل	جمیل
جهان	جهان
جهی	جهی
جهێت	جهت
جو	جو
جوان	جوان
جوانی	جوانی
جوانیێ	جوانی
جوانێ	جوان
جوانە	جوان
جود	جود
جودی	جودی
جور	جور
جورێ	جور
جورە	جور
جون	جون
جڤین	جوین
جڤینێ	جوین
جگەری	جگری
جگەرێ	جگر
جۆ	جو
جۆدی	جودی
جۆر	جور
جۆرج	جورج
جۆرجیا	جورجیا
جۆرنال	جورنال
جۆرێ	جور
جۆرە	جور
جۆش	جوش
جۆن	جون
جۆڕێ	جور
جی	جی
جیران	جیران
جیرانیێ	جیرانی
جیرانێ	جیران
جیم	جیم
جیێ	جی
جیە	جی
جێفری	جفری
جێنیفێر	جنیفر
جێنین	جنین
جێگر	جگر
جێگری	جگری
جێگرێ	جگر
جێی	جی
جەبار	جبار
جەباری	جباری
جەزا	جزا
جەزائیر	جزایر
جەزائیرێ	جزایر
جەستە	جست
جەستەی	جستی
جەستەیێ	جستی
جەسەد	جسد
جەسەدێ	جسد
جەعفەر	جعفر
جەعفەری	جعفری
جەلادەت	جلادت
جەلال	جلال
جەلالی	جلالی
جەلالە	جلال
جەلیل	جلیل
جەم	جم
جەمال	جمال
جەمیل	جمیل
جەمێ	جم
جەنابێ	جناب
جەنگ	جنگ
جەنگی	جنگی
جەنگێ	جنگ
جەنگە	جنگ
جەنەرال	جنرال
جەواد	جواد
جەواهری	جواهری
جەوهەر	جوهر
جەوهەرێ	جوهر
جەگەرێ	جگر
جەیش	جیش
حاتەمی	حاتمی
حاج	حاج
حاجی	حاجی
حازر	حاضر
حازری	حاضری
حاشا	حاشا
حافز	حافظ
حال	حال
حالێ	حال
حالە	حال
حالەت	حالت
حالەتێ	حالت
حالەتە	حالت
حامد	حامد
حامدی	حامدی
حاکم	حاکم
حدود	حدود
حدوود	حدود
حرف	حرف
حزب	حزب
حزبێ	حزب
حزبە	حزب
حزوری	حضوری
حساب	حساب
حسابێ	حساب
حسن	حسن
حسین	حسین
حسێن	حسن
حسێنی	حسنی
حووت	حوت
حکمەت	حکمت
حکومەت	حکومت
حکومەتێ	حکومت
حکومەتە	حکومت
حکۆمەت	حکومت
حکیم	حکیم
حیدر	حیدر
حەب	حب
حەبیب	حبیب
حەتا	حتا
حەج	حج
حەجێ	حج
حەرام	حرام
حەرامە	حرام
حەریری	حریری
حەز	حظ
حەزرەتێ	حضرت
حەزێن	حزن
حەسن	حسن
حەسەن	حسن
حەسەنی	حسنی
حەفازە	حفاظ
حەق	حق
حەقیقەت	حقیقت
حەقیقەتێ	حقیقت
حەقیێ	حقی
حەلالە	حلال
حەلەبێ	حلب
حەماس	حماس
حەمامی	حمامی
حەمدی	حمدی
حەمید	حمید
حەمیدی	حمیدی
حەمەد	حمد
حەنا	حنا
حەکیم	حکیم
حەکیمی	حکیمی
حەیدەر	حیدر
حەیدەری	حیدری
حەیران	حیران
حەیفا	حیفا
خائین	خاین
خاتر	خاطر
خاتوون	خاتون
خاتەمی	خاتمی
خار	خار
خارێ	خار
خاستن	خاستن
خال	خال
خالد	خالد
خالدی	خالدی
خالێ	خال
خالە	خال
خام	خام
خان	خان
خانم	خانم
خانمان	خانمان
خانمی	خانمی
خانمە	خانم
خانکێ	خانک
خانی	خانی
خانیان	خانیان
خانیێ	خانی
خانێ	خان
خانە	خان
خاک	خاک
خاکی	خاکی
خایەن	خاین
خراب	خراب
خرابی	خرابی
خرابیێ	خرابی
خرابە	خراب
خرەکێ	خرک
خزم	خزم
خستن	خستن
خستنە	خستن
خستە	خست
خسرۆ	خسرو
خشتێ	خشت
خشتە	خشت
خشتەیێ	خشتی
خلاس	خلاص
خلیل	خلیل
خو	خو
خوار	خوار
خواری	خواری
خواریە	خواری
خوارێ	خوار
خواست	خواست
خواستن	خواستن
خواستی	خواستی
خواستیە	خواستی
خواستێن	خواستن
خوان	خوان
خواند	خواند
خواندن	خواندن
خواندنێ	خواندن
خواندی	خواندی
خودی	خودی
خودێ	خود
خورشید	خورشید
خوریانێ	خوریان
خوش	خوش
خوشترە	خوشتر
خوشی	خوشی
خوشیێ	خوشی
خوشێ	خوش
خوشە	خوش
خوون	خون
خویێ	خوی
خویە	خوی
خوێ	خو
خوێن	خون
خوە	خو
خوەدی	خودی
خوەش	خوش
خوەشتر	خوشتر
خوەشی	خوشی
خوەشیێ	خوشی
خوەشە	خوش
خوەنە	خون
خوەیێ	خوی
خوەیە	خوی
خوەە	خو
خۆ	خو
خۆدێ	خود
خۆراک	خوراک
خۆراکی	خوراکی
خۆراکێ	خوراک
خۆرشید	خورشید
خۆش	خوش
خۆشتر	خوشتر
خۆشحال	خوشحال
خۆشحالی	خوشحالی
خۆشی	خوشی
خۆشیێ	خوشی
خۆشە	خوش
خۆنە	خون
خۆی	خوی
خۆیشی	خویشی
خۆیێ	خوی
خۆیە	خوی
خۆە	خو
خیار	خیار
خیال	خیال
خیانەت	خیانت
خیانەتکار	خیانتکار
خیانەتێ	خیانت
خیانەتە	خیانت
خێر	خر
خێرات	خراط
خێری	خری
خێرێ	خر
خێرە	خر
خێرەک	خرک
خێزان	خزان
خێزانێ	خزان
خەت	خط
خەتا	خطا
خەرج	خرج
خەرجی	خرجی
خەرجیێن	خرجین
خەزان	خزان
خەست	خست
خەسلەتێ	خصلت
خەلخالی	خلخالی
خەلق	خلق
خەلیجی	خلیجی
خەلیفەیێ	خلیفی
خەلیل	خلیل
خەلیلی	خلیلی
خەلیلێ	خلیل
خەلەت	خلط
خەلەتە	خلط
خەلەف	خلف
خەم	خم
خەمی	خمی
خەمێ	خم
خەمە	خم
خەنجەر	خنجر
خەنجەری	خنجری
خەندقی	خندقی
خەندقیە	خندقی
خەو	خو
خەون	خون
خەونێ	خون
خەونە	خون
خەوێ	خو
خەیال	خیال
خەیالێ	خیال
خەیری	خیری
دئێختە	دخت
دئێن	دن
دئێنە	دن
دئەڤ	دو
دئەڤی	دوی
داد	داد
دادوەر	دادور
دادوەری	دادوری
دادوەریێ	دادوری
دادوەرێ	دادور
دادگەری	دادگری
دادی	دادی
دادێ	داد
دار	دار
دارا	دارا
دارای	دارای
دارایی	دارایی
دارایێ	دارای
دارستان	دارستان
دارستانێ	دارستان
داری	داری
داریووش	داریوش
دارێ	دار
دارێن	دارن
داستان	داستان
داستانێ	داستان
داعش	داعش
داعشێ	داعش
داعشە	داعش
دام	دام
دامە	دام
دان	دان
دانا	دانا
دانایی	دانایی
دانم	دانم
دانی	دانی
دانیال	دانیال
دانیێلۆ	دانیلو
دانێ	دان
دانە	دان
دانەکێ	دانک
داو	داو
داود	داود
داوود	داوود
داوە	داو
داڤ	داو
داڤێن	داون
داڤە	داو
دایی	دایی
داییە	دایی
دبی	دبی
دبێ	دب
دبە	دب
ددەت	ددت
ددەتە	ددت
ددەیە	ددی
درازی	درازی
درست	درست
درستی	درستی
درۆ	درو
درۆن	درون
درین	درین
درێ	در
درێسێ	درس
درێیا	دریا
درەنگ	درنگ
درەنگە	درنگ
درەو	درو
درەوا	دروا
درەوێ	درو
درەڤن	درون
دز	دز
دزی	دزی
دزیێ	دزی
دزێ	دز
دستوری	دستوری
دستوور	دستور
دستووری	دستوری
دستوورێ	دستور
دشێت	دشت
دفن	دفن
دفنێ	دفن
دل	دل
دلتەنگ	دلتنگ
دلخوشیێ	دلخوشی
دلخوەش	دلخوش
دلخوەشیێ	دلخوشی
دلخۆش	دلخوش
دلخۆشیێ	دلخوشی
دلدار	دلدار
دلداری	دلداری
دلسوز	دلسوز
دلسۆز	دلسوز
دلسۆزی	دلسوزی
دلسۆزێ	دلسوز
دلشاد	دلشاد
دلۆ	دلو
دلێ	دل
دلە	دل
دن	دن
دنگێ	دنگ
دنیا	دنیا
دهات	دهات
دهاتە	دهات
دهشیار	دهشیار
دهی	دهی
دهێمە	دهم
دهێن	دهن
دهێنە	دهن
دهەر	دهر
دو	دو
دوئالی	دوالی
دوا	دوا
دوارێ	دوار
دوان	دوان
دوبارە	دوبار
دودل	دودل
دودلی	دودلی
دودلیێ	دودلی
دور	دور
دورتموند	دورتموند
دورو	دورو
دوست	دوست
دونالد	دونالد
دوو	دوو
دووبارە	دوبار
دوودلی	دودلی
دوودلە	دودل
دوور	دور
دوورتر	دورتر
دوورڤە	دورو
دووری	دوری
دوورە	دور
دووم	دوم
دووڤ	دوو
دووڤە	دوو
دووی	دوی
دوویێ	دوی
دووێ	دو
دووێن	دون
دووەم	دوم
دووەمین	دومین
دوڤ	دوو
دوی	دوی
دویێ	دوی
دوێ	دو
دڕندە	درند
دڕەڤن	درون
دژ	دژ
دژە	دژ
دڤان	دوان
دڤی	دوی
دڤێ	دو
دڤێن	دون
دکارت	دکارت
دڵ	دل
دڵخۆش	دلخوش
دڵەوە	دلو
دۆر	دور
دۆران	دوران
دۆست	دوست
دۆستان	دوستان
دۆستانە	دوستان
دۆستێ	دوست
دۆل	دول
دۆلا	دولا
دۆم	دوم
دۆمینیک	دومینیک
دۆنالد	دونالد
دی	دی
دیار	دیار
دیاربەکر	دیاربکر
دیاری	دیاری
دیارێ	دیار
دیارە	دیار
دیالوگ	دیالوگ
دیالوگێ	دیالوگ
دیالۆگ	دیالوگ
دیالۆگێ	دیالوگ
دیجیتال	دیجیتال
دیجیتالی	دیجیتالی
دید	دید
دیدا	دیدا
دیدار	دیدار
دیدارێ	دیدار
دیدارە	دیدار
دیدی	دیدی
دیدێ	دید
دیر	دیر
دیمەن	دیمن
دیمەنێ	دیمن
دین	دین
دینار	دینار
دیناری	دیناری
دینارێ	دینار
دینارە	دینار
دیندار	دیندار
دینۆ	دینو
دینی	دینی
دینێ	دین
دینە	دین
دیوارێ	دیوار
دیوارەک	دیوارک
دیوارەکێ	دیوارک
دیوان	دیوان
دیوانیە	دیوانی
دیوانێ	دیوان
دیوانە	دیوان
دیوو	دیو
دیڤ	دیو
دیڤید	دیوید
دیڤە	دیو
دیکتاتۆر	دیکتاتور
دیکە	دیک
دیێ	دی
دیێن	دین
دیە	دی
دێر	در
دێربیێ	دربی
دێرکێ	درک
دێرین	درین
دێرینێ	درین
دێل	دل
دێم	دم
دێمی	دمی
دێمێ	دم
دێوالی	دوالی
دەبێ	دب
دەخیل	دخیل
دەر	در
دەربارێ	دربار
دەرباز	درباز
دەربدەر	دربدر
دەربدەری	دربدری
دەربەدەر	دربدر
دەربەدەری	دربدری
دەربەندێ	دربند
دەرد	درد
دەردێ	درد
دەردە	درد
دەرز	درز
دەرزی	درزی
دەرس	درس
دەرمان	درمان
دەرمانی	درمانی
دەرمانێ	درمان
دەرمانە	درمان
دەرهەم	درهم
دەرهەمی	درهمی
دەرو	درو
دەرونی	درونی
دەرونێ	درون
دەروون	درون
دەروونی	درونی
دەروونیە	درونی
دەروونێ	درون
دەرڤە	درو
دەرڤەی	دروی
دەرڤەیێ	دروی
دەرگەه	درگه
دەرگەهی	درگهی
دەرگەهێ	درگه
دەرگەهە	درگه
دەریا	دریا
دەریایی	دریایی
دەریێن	درین
دەرێ	در
دەرەنگ	درنگ
دەرەوە	درو
دەزیێ	دزی
دەست	دست
دەستان	دستان
دەستور	دستور
دەستوری	دستوری
دەستوور	دستور
دەستووری	دستوری
دەستوورێ	دستور
دەستکاری	دستکاری
دەستکاریێ	دستکاری
دەستی	دستی
دەستیێ	دستی
دەستێ	دست
دەستە	دست
دەستەک	دستک
دەستەکێ	دستک
دەستەیێ	دستی
دەشت	دشت
دەشتی	دشتی
دەف	دف
دەقیقا	دقیقا
دەقێ	دق
دەلال	دلال
دەم	دم
دەما	دما
دەمان	دمان
دەمی	دمی
دەمێ	دم
دەمە	دم
دەن	دن
دەنگ	دنگ
دەنگێ	دنگ
دەنگە	دنگ
دەنێ	دن
دەنە	دن
دەه	ده
دەهان	دهان
دەهی	دهی
دەهێ	ده
دەهەمین	دهمین
دەوات	دوات
دەوار	دوار
دەوام	دوام
دەوامێ	دوام
دەور	دور
دەوران	دوران
دەوروبەر	دوروبر
دەوروبەرێ	دوروبر
دەولەت	دولت
دەولەتێ	دولت
دەولەتە	دولت
دەوڵەت	دولت
دەڕوا	دروا
دەڤ	دو
دەڤا	دوا
دەڤی	دوی
دەڤێ	دو
دەڤێن	دون
دەڤەر	دور
دەڤەران	دوران
دەڤەرانە	دوران
دەڤەری	دوری
دەڤەرێ	دور
دەڤەرە	دور
دەڵێ	دل
دەیلی	دیلی
دەین	دین
دەینێ	دین
دەینە	دین
دەیک	دیک
دەیکێ	دیک
دەیە	دی
را	را
رائید	راید
رابین	رابین
رادیکال	رادیکال
رادیۆ	رادیو
رادێ	راد
رادە	راد
رادەی	رادی
رادەیەک	رادیک
رادەیەکێ	رادیک
رازی	رازی
رازیێ	رازی
راست	راست
راستا	راستا
راستگو	راستگو
راستگۆ	راستگو
راستگۆیی	راستگویی
راستی	راستی
راستین	راستین
راستیێ	راستی
راستیێن	راستین
راستێ	راست
راستە	راست
راسل	راسل
رافع	رافع
راپورت	راپورت
راپۆرت	راپورت
راپۆرتێ	راپورت
راکەت	راکت
رای	رای
ردا	ردا
ردە	رد
رزقێ	رزق
رستن	رستن
رشید	رشید
رفعەت	رفعت
رفعەتێ	رفعت
رماد	رماد
رنا	رنا
ره	ره
رها	رها
رهێن	رهن
رو	رو
روبرت	روبرت
روبین	روبین
روبەرێ	روبر
روح	روح
روحا	روحا
روحی	روحی
رودریگێز	رودریگز
روسی	روسی
روشنگەری	روشنگری
رومانی	رومانی
رونالدو	رونالدو
روو	رو
رووبرووی	روبروی
رووبەرێ	روبر
رووسی	روسی
روونی	رونی
رووی	روی
روویێ	روی
روژان	روژان
روژانە	روژان
روی	روی
رویترز	رویترز
رویتەرز	رویترز
رویێ	روی
رژیمێ	رژیم
رۆتین	روتین
رۆتینێ	روتین
رۆحا	روحا
رۆحی	روحی
رۆزە	روز
رۆسۆ	روسو
رۆسی	روسی
رۆشنگەریێ	روشنگری
رۆمانی	رومانی
رۆمی	رومی
رۆنالدۆ	رونالدو
رۆنی	رونی
رۆژان	روژان
رۆژانە	روژان
رۆیتەرز	رویترز
ری	ری
ریال	ریال
ریب	ریب
ریکا	ریکا
ریێا	ریا
رێا	را
رێز	رز
رێزا	رزا
رێزێ	رز
رێزێن	رزن
رێشتن	رشتن
رێفراندۆم	رفراندوم
رێفراندۆمێ	رفراندوم
رێنجبەر	رنجبر
رێژەی	رژی
رێژەیێ	رژی
رێڤە	رو
رێڤەبەر	روبر
رێڤەبەرێ	روبر
رێک	رک
رێکێ	رک
رێکێن	رکن
رێکە	رک
رێگە	رگ
رێی	ری
رێیا	ریا
رێیێ	ری
رێیە	ری
رێیەکا	ریکا
رەئیا	ریا
رەئیسی	ریسی
رەبیع	ربیع
رەبیعە	ربیع
رەجەب	رجب
رەحمان	رحمان
رەحمێ	رحم
رەحمەتی	رحمتی
رەحیم	رحیم
رەحیمی	رحیمی
رەحیمە	رحیم
رەخ	رخ
رەخێ	رخ
رەد	رد
رەز	رز
رەزا	رزا
رەزامەندی	رضامندی
رەزایی	رضایی
رەزی	رضی
رەزێ	رز
رەزێن	رزن
رەسول	رسول
رەسوول	رسول
رەسوولی	رسولی
رەسۆل	رسول
رەسەن	رسن
رەسەنێ	رسن
رەسەنە	رسن
رەش	رش
رەشید	رشید
رەشێ	رش
رەفتار	رفتار
رەفتارێ	رفتار
رەفتارە	رفتار
رەفسەنجانی	رفسنجانی
رەقیب	رقیب
رەمزی	رمزی
رەمەزان	رمضان
رەمەزانی	رمضانی
رەمەزانێ	رمضان
رەنا	رنا
رەنج	رنج
رەنگ	رنگ
رەنگین	رنگین
رەنگێ	رنگ
رەنگە	رنگ
رەه	ره
رەها	رها
رەهایی	رهایی
رەهینە	رهین
رەهێن	رهن
رەهەند	رهند
رەوا	روا
رەوان	روان
رەوانە	روان
رەوانەی	روانی
رەوش	روش
رەوشنگەریێ	روشنگری
رەوشێ	روش
رەوشێن	روشن
رەوشە	روش
رەوشەن	روشن
رەڤا	روا
رەڤی	روی
رەڤیت	رویت
رەڤێ	رو
رەیگان	ریگان
زات	ذات
زاتی	ذاتی
زاتێ	ذات
زاد	زاد
زادە	زاد
زارێ	زار
زال	زال
زالمان	ظالمان
زالە	ذال
زان	زان
زانی	زانی
زانیە	زانی
زاهر	ظاهر
زاڵ	ذال
زاڵە	ذال
زاید	زاید
زمان	زمان
زمانی	زمانی
زمانێ	زمان
زمانە	زمان
زمزم	زمزم
زنجیرە	زنجیر
زنک	زنک
زور	زور
زورێ	زور
زوو	زو
زوور	زور
زڤر	زور
زڤڕ	زور
زکری	ذکری
زکی	ذکی
زۆر	زور
زۆرێ	زور
زۆرە	زور
زی	زی
زیاد	زیاد
زیان	زیان
زیانبەخش	زیانبخش
زیانمەند	زیانمند
زیانێ	زیان
زیانە	زیان
زیاێ	ضیا
زیبا	زیبا
زیرەک	زیرک
زیرەکی	زیرکی
زیق	ضیق
زینێ	زین
زێدە	زد
زێدەیە	زدی
زێر	ذر
زێری	زری
زێرین	زرین
زێرینە	زرین
زێرەڤان	زروان
زێرەڤانێ	زروان
زێندی	زندی
زێوێ	زو
زێوە	زو
زێڕی	زری
زێڕین	زرین
زەحمەت	زحمت
زەحمەتێ	زحمت
زەحمەتە	زحمت
زەر	ذر
زەردک	زردک
زەردی	زردی
زەرک	زرک
زەرکێ	زرک
زەری	زری
زەریف	ظریف
زەرەر	ضرر
زەفت	زفت
زەق	زق
زەلال	زلال
زەلالی	زلالی
زەلالە	زلال
زەمان	زمان
زەمانی	زمانی
زەمانێ	زمان
زەمین	زمین
زەمینی	زمینی
زەمینێ	زمین
زەمینە	زمین
زەمینەیێ	زمینی
زەمەن	زمن
زەهرا	زهرا
زەوقێ	ذوق
زەکات	زکات
زەکی	ذکی
زەکەریا	ذکریا
زەید	زید
زەینەب	زینب
سابت	ثابت
سابر	صابر
سابوونێ	صابون
سابۆنێ	صابون
ساختە	ساخت
سادق	صادق
سادە	صاد
سار	سار
سارتەر	سارتر
ساز	ساز
سازی	سازی
سازیێ	سازی
سازێ	ساز
ساسان	ساسان
ساف	ساف
سال	سال
سالار	سالار
سالارێ	سالار
سالح	صالح
سالحی	صالحی
سالم	سالم
سالن	سالن
سالێ	سال
سالێن	سالن
سالە	سال
سالەک	سالک
سالەکێ	سالک
سالەکە	سالک
سامان	سامان
سامانی	سامانی
سامانێ	سامان
سامی	سامی
سامەرا	سامرا
سان	سان
سانسۆر	سانسور
ساواکێ	ساواک
ساڕ	سار
ساڵ	سال
ساڵح	صالح
ساڵن	سالن
ساڵێ	سال
ساڵێن	سالن
ساڵێک	سالک
ساڵە	سال
ساڵەکێ	سالک
سایت	سایت
سایتێ	سایت
ساید	ساید
سایدێ	ساید
سایکس	سایکس
ستار	ستار
ستاندن	ستاندن
ستریم	ستریم
ستێر	سطر
ستێرێ	سطر
ستێرە	سطر
ستەم	ستم
ستەمکار	ستمکار
ستەمکاریێ	ستمکاری
ستەمێ	ستم
سحرا	صحرا
سدقی	صدقی
سرۆد	سرود
سزا	سزا
سست	سست
سعود	سعود
سعودی	سعودی
سعودیێ	سعودی
سعودیە	سعودی
سعودێ	سعود
سعوودی	سعودی
سعوودیێ	سعودی
سعوودیە	سعودی
سعۆدی	سعودی
سعید	سعید
سفر	سفر
سفرێ	سفر
سفرەی	صفری
سلامەت	سلامت
سلامەتی	سلامتی
سلامەتیێ	سلامتی
سلبی	سلبی
سلک	سلک
سلێمان	سلمان
سلێمانی	سلمانی
سلێمانیێ	سلمانی
سلێمانێ	سلمان
سلە	سل
سمینار	سمینار
سمینارێ	سمینار
سنج	سنج
سندانێ	سندان
سندۆقێ	صندوق
سندی	سندی
سنگێ	سنگ
سنە	سن
سواری	سواری
سواریێ	سواری
سوارێز	سوارز
سود	سود
سودان	سودان
سور	سور
سورچی	سورچی
سوریێ	سوری
سورە	سور
سورەت	صورت
سوز	سوز
سوزان	سوزان
سوزێ	سوز
سوزێن	سوزن
سوسیداد	سوسیداد
سونی	سونی
سوور	سور
سووری	سوری
سووریێ	سوری
سووریە	سوری
سووەر	سور
سوپە	سوپ
سوێدی	سودی
سوێدێ	سود
سڕ	سر
سڤک	سوک
سڤکە	سوک
سکرتێر	سکرتر
سکرتێرێ	سکرتر
سکرێ	سکر
سکسی	سکسی
سڵێمان	سلمان
سۆد	سود
سۆر	سور
سۆرن	سورن
سۆرێ	سور
سۆرێن	سورن
سۆرە	سور
سۆرەتا	صورتا
سۆز	سوز
سۆزان	سوزان
سۆزێ	سوز
سۆزێن	سوزن
سۆسیال	سوسیال
سۆفیا	سوفیا
سی	سی
سیادی	صیادی
سیادە	صیاد
سیار	سیار
سیارێ	سیار
سیاسی	سیاسی
سیاسیێ	سیاسی
سیاسیە	سیاسی
سیاسەت	سیاست
سیاسەتمەدار	سیاستمدار
سیاسەتمەداران	سیاستمداران
سیاسەتمەدارێ	سیاستمدار
سیاسەتی	سیاستی
سیاسەتێ	سیاست
سیاسەتە	سیاست
سیدی	صیدی
سیروان	سیروان
سیریێ	سیری
سیستەم	سیستم
سیستەماتیک	سیستماتیک
سیستەمێ	سیستم
سیستەمە	سیستم
سیلڤا	سیلوا
سیلۆ	سیلو
سیمۆن	سیمون
سیمە	سیم
سینا	سینا
سینایی	سینایی
سینگ	سینگ
سینگێ	سینگ
سینەما	سینما
سینەمایی	سینمایی
سیه	سیه
سیێ	سی
سێبەر	صبر
سێربەندی	سربندی
سێزدە	سزد
سێلتیک	سلتیک
سێڤا	سوا
سێکس	سکس
سێکسی	سکسی
سێکسێ	سکس
سێی	سی
سێیێ	سی
سێیەم	سیم
سێیەمین	سیمین
سەباح	صباح
سەبر	صبر
سەبری	صبری
سەبەبێ	سبب
سەخت	سخت
سەختێ	سخت
سەختە	سخت
سەد	سد
سەدام	صدام
سەدر	سدر
سەدری	صدری
سەدریان	صدریان
سەدرە	سدر
سەدڕ	سدر
سەدیق	صدیق
سەدێ	سد
سەدە	سد
سەدەم	صدم
سەدەمێ	صدم
سەر	سر
سەرا	سرا
سەراب	سرآب
سەرابێ	سرآب
سەران	سران
سەرباری	سرباری
سەرباز	سرباز
سەربازان	سربازان
سەربازی	سربازی
سەربازیێ	سربازی
سەربلند	سربلند
سەربلندی	سربلندی
سەربلندیێ	سربلندی
سەرتاسەری	سرتاسری
سەرحان	سرحان
سەرحەد	سرحد
سەرخۆشی	سرخوشی
سەردار	سردار
سەردەست	سردست
سەردەستیێ	سردستی
سەردەستێ	سردست
سەردەشت	سردشت
سەرفەراز	سرفراز
سەرفەرازیێ	سرفرازی
سەرما	سرما
سەروان	سروان
سەروەت	ثروت
سەروەر	سرور
سەروەری	سروری
سەروەرە	سرور
سەرڤە	سرو
سەرکێشی	سرکشی
سەری	سری
سەرێ	سر
سەرە	سر
سەرەخوشیێ	سرخوشی
سەرەخۆشی	سرخوشی
سەرەخۆشیێ	سرخوشی
سەرەدەر	سردر
سەرەدەست	سردست
سەرەراست	سرراست
سەرەک	سرک
سەرەکێ	سرک
سەعادەت	سعادت
سەعد	سعد
سەعدون	سعدون
سەعدی	سعدی
سەعید	سعید
سەعەد	سعد
سەفار	صفار
سەفین	صفین
سەفەر	سفر
سەقا	سقا
سەقز	سقز
سەقەت	سقط
سەلاح	سلاح
سەلام	سلام
سەلامی	سلامی
سەلمان	سلمان
سەلیم	سلیم
سەلەفی	سلفی
سەلەفیێ	سلفی
سەمیر	سمیر
سەمەر	ثمر
سەنتەر	سنتر
سەنتەرێ	سنتر
سەنتەرە	سنتر
سەنجابی	سنجابی
سەندیکا	سندیکا
سەنگ	سنگ
سەنگێ	سنگ
سەنگەر	سنگر
سەنگەری	سنگری
سەنگەرێ	سنگر
سەهم	سهم
سەهمێ	سهم
سەوز	سوز
سەید	سید
سەیدا	صیدا
سەیدە	سید
سەیر	سیر
سەیرە	سیر
سەیف	سیف
شاخکێ	شاخک
شاد	شاد
شادی	شادی
شار	شار
شارستانی	شارستانی
شاش	شاش
شاشی	شاشی
شاشیێ	شاشی
شاشێ	شاش
شاشە	شاش
شاعری	شاعری
شام	شام
شاملۆ	شاملو
شامێ	شام
شانس	شانس
شانسی	شانسی
شانسێ	شانس
شاه	شاه
شاهد	شاهد
شاهدە	شاهد
شاهروودی	شاهرودی
شاهۆ	شاهو
شاهی	شاهی
شاهین	شاهین
شاهێ	شاه
شاهەکێ	شاهک
شاکر	شاکر
شاکێری	شاکری
شاگردان	شاگردان
شایستە	شایست
شبلی	شبلی
شری	شری
شعر	شعر
شعری	شعری
شعرێ	شعر
شعرە	شعر
شعرەکێ	شعرک
شعورێ	شعور
شمال	شمال
شوخ	شوخ
شورتە	شورت
شورش	شورش
شورشێ	شورش
شورەش	شورش
شورەشێ	شورش
شوفێر	شوفر
شوو	شو
شووقە	شوق
شووقەکێ	شوقک
شوی	شوی
شویم	شویم
شکاندن	شکاندن
شکاندنێ	شکاندن
شکاک	شکاک
شکایەت	شکایت
شکستی	شکستی
شکەست	شکست
شکەستن	شکستن
شکەستنێ	شکستن
شکەفتێ	شکفت
شۆخ	شوخ
شۆر	شور
شۆرتە	شورت
شۆرش	شورش
شۆرشێ	شورش
شۆرشە	شورش
شۆرەش	شورش
شۆرەشگێر	شورشگر
شۆرەشگێری	شورشگری
شۆرەشگێرێ	شورشگر
شۆرەشێ	شورش
شۆرەشە	شورش
شۆفێر	شوفر
شۆفێریێ	شوفری
شۆفێرێ	شوفر
شۆڕش	شورش
شۆڕشی	شورشی
شۆڕشە	شورش
شۆڕی	شوری
شۆڕەش	شورش
شۆڕەشێ	شورش
شۆی	شوی
شیخ	شیخ
شیر	شیر
شیراز	شیراز
شیرازێ	شیراز
شیرزاد	شیرزاد
شیری	شیری
شیرین	شیرین
شیرینێ	شیرین
شیرێ	شیر
شیعی	شیعی
شیعەیان	شیعیان
شیعەیانە	شیعیان
شیلان	شیلان
شیلی	شیلی
شین	شین
شیڤا	شیوا
شیێن	شین
شێت	شط
شێخ	شخ
شێخە	شخ
شێر	شر
شێروان	شروان
شێروانی	شروانی
شێروانە	شروان
شێری	شری
شێرە	شر
شێست	شست
شێف	شف
شێل	شل
شێلم	شلم
شێلی	شلی
شێن	شن
شێنێ	شن
شێوێ	شو
شێوە	شو
شێوەکی	شوکی
شێوەکێ	شوک
شێوەی	شوی
شێوەیی	شویی
شێوەیێ	شوی
شێوەیە	شوی
شێین	شین
شەبنەم	شبنم
شەخسی	شخصی
شەر	شر
شەراکەت	شراکت
شەراکەتێ	شراکت
شەرت	شرط
شەرع	شرع
شەرعی	شرعی
شەرم	شرم
شەرمێ	شرم
شەرمە	شرم
شەرڤان	شروان
شەری	شری
شەریعەتی	شریعتی
شەریعەتێ	شریعت
شەریف	شریف
شەریفی	شریفی
شەریک	شریک
شەرێ	شر
شەرە	شر
شەرەف	شرف
شەرەفی	شرفی
شەرەفیێ	شرفی
شەرەفێ	شرف
شەرەکێ	شرک
شەش	شش
شەشی	ششی
شەشێ	شش
شەعبان	شعبان
شەفافیەتێ	شفافیت
شەفەق	شفق
شەمال	شمال
شەماڵ	شمال
شەنگ	شنگ
شەنگە	شنگ
شەهاب	شهاب
شەهباز	شهباز
شەهرام	شهرام
شەهید	شهید
شەهیدان	شهیدان
شەهیدێ	شهید
شەوقی	شوقی
شەوکەت	شوکت
شەڕ	شر
شەڕی	شری
شەڕێ	شر
شەڕەک	شرک
شەڕەکێ	شرک
شەڤ	شو
شەڤی	شوی
شەڤێ	شو
شەڤە	شو
شەڤەکێ	شوک
شەکر	شکر
شەکری	شکری
شەکرێ	شکر
شەکیب	شکیب
شەیدا	شیدا
عابد	عابد
عابدین	عابدین
عاجز	عاجز
عادل	عادل
عارف	عارف
عارفێ	عارف
عاشق	عاشق
عاقل	عاقل
عامر	عامر
عامری	عامری
عبد	عبد
عبدالرحمن	عبدالرحمن
عبدالرەحمان	عبدالرحمان
عبدالله	عبدالله
عزەت	عزت
عسمەت	عصمت
عشق	عشق
علی	علی
عیار	عیار
عێراق	عراق
عێراقی	عراقی
عێراقێ	عراق
عەبادی	عبادی
عەباس	عباس
عەباسی	عباسی
عەبدالخالق	عبدالخالق
عەبدالسەلام	عبدالسلام
عەبدی	عبدی
عەدالەت	عدالت
عەدنان	عدنان
عەرەب	عرب
عەرەبی	عربی
عەرەبیە	عربی
عەرەبە	عرب
عەرەفات	عرفات
عەزم	عزم
عەزمی	عظمی
عەزیز	عزیز
عەزیزی	عزیزی
عەسمانێ	عثمان
عەشق	عشق
عەشقێ	عشق
عەقل	عقل
عەقلی	عقلی
عەقلێ	عقل
عەلا	علا
عەلاوی	علاوی
عەلی	علی
عەلیرەزا	علیرضا
عەمار	عمار
عەمر	عمر
عەمران	عمران
عەمرێ	عمر
عەمید	عمید
عەمەر	عمر
عەور	عور
عەوری	عوری
عەیب	عیب
عەین	عین
غاز	غاز
غازی	غازی
غازێ	غاز
غروورێ	غرور
غیاس	غیاث
غیر	غیر
غەریب	غریب
غەریبە	غریب
غەزال	غزال
غەفوور	غفور
غەنی	غنی
فائیق	فایق
فاتح	فاتح
فارس	فارس
فارسان	فارسان
فارسی	فارسی
فاروق	فاروق
فاروقی	فاروقی
فارۆق	فاروق
فازل	فاضل
فازلیێ	فاضلی
فازلێ	فاضل
فازڵ	فاضل
فام	فام
فایق	فایق
فایەق	فایق
فرانس	فرانس
فرانسیس	فرانسیس
فرانک	فرانک
فرانکفورت	فرانکفورت
فراکسیۆن	فراکسیون
فرقە	فرق
فروتن	فروتن
فرووهەر	فروهر
فرۆتن	فروتن
فرۆتنێ	فروتن
فرۆید	فروید
فری	فری
فرێ	فر
فرە	فر
فرەه	فره
فشار	فشار
فشارێ	فشار
فشارەکێ	فشارک
فلان	فلان
فلانە	فلان
فوئاد	فواد
فورمێن	فورمن
فڕی	فری
فکر	فکر
فۆئاد	فواد
فۆتۆ	فوتو
فۆلکلۆرێ	فولکلور
فی	فی
فیفا	فیفا
فیلمێ	فیلم
فین	فین
فێدرال	فدرال
فێر	فر
فێری	فری
فێمینیستی	فمینیستی
فەتاح	فتاح
فەتح	فتح
فەتحی	فتحی
فەخری	فخری
فەر	فر
فەراغی	فراغی
فەرد	فرد
فەردیت	فردیت
فەرزاد	فرزاد
فەرمان	فرمان
فەرمانبەر	فرمانبر
فەرمانبەرێ	فرمانبر
فەرماندارێ	فرماندار
فەرمانی	فرمانی
فەرمانێ	فرمان
فەرمێ	فرم
فەرهاد	فرهاد
فەرید	فرید
فەرە	فر
فەرەیدون	فریدون
فەزل	فضل
فەزیلەت	فضیلت
فەقیر	فقیر
فەلاح	فلاح
فەلاحی	فلاحی
فەلسەفی	فلسفی
فەلسەفەی	فلسفی
فەلەستین	فلسطین
فەلەستینی	فلسطینی
فەلەک	فلک
فەهمی	فهمی
فەهیم	فهیم
فەهیمە	فهیم
فەوجێ	فوج
فەیاز	فیاض
فەیسبوکێ	فیسبوک
فەیسبۆک	فیسبوک
فەیسەل	فیصل
فەیسەلێ	فیصل
فەیلەسۆف	فیلسوف
قائید	قاید
قاتی	قاطی
قادر	قادر
قادری	قادری
قادرێ	قادر
قازی	قاضی
قاسم	قاسم
قاسملۆ	قاسملو
قالبێ	قالب
قانونی	قانونی
قانوون	قانون
قانوونا	قانونا
قانوونی	قانونی
قانوونیە	قانونی
قانوونێ	قانون
قانوونە	قانون
قاڵب	قالب
قایل	قایل
قایم	قایم
قبوول	قبول
قرار	قرار
قست	قسط
قستێ	قسط
قوم	قوم
قووڵ	قول
قۆلی	قولی
قیمەت	قیمت
قەبول	قبول
قەبوول	قبول
قەبیل	قبیل
قەترێ	قطر
قەتەر	قطر
قەتەرێ	قطر
قەد	قد
قەدر	قدر
قەدری	قدری
قەدەر	قدر
قەدەرێ	قدر
قەر	قر
قەرار	قرار
قەران	قرآن
قەرێ	قر
قەرێن	قرن
قەرە	قر
قەرەنی	قرنی
قەزا	قضا
قەزافی	قذافی
قەزایا	قضایا
قەساب	قصاب
قەست	قسط
قەسر	قصر
قەلەم	قلم
قەلەمدان	قلمدان
قەلەو	قلو
قەنات	قنات
قەناعەت	قناعت
قەناعەتێ	قناعت
قەندیل	قندیل
قەندیلێ	قندیل
قەهار	قهار
قەهرەمان	قهرمان
قەهرەمانان	قهرمانان
قەهرەمانیێ	قهرمانی
قەهرەمانێ	قهرمان
قەهرەمانە	قهرمان
قەڕێ	قر
قەڕێن	قرن
قەڵەم	قلم
قەید	قید
قەیرە	قیر
قەیس	قیس
قەیسەری	قیصری
لا	لا
لاتینی	لاتینی
لادن	لادن
لاشێ	لاش
لال	لال
لاهۆر	لاهور
لاوان	لاوان
لای	لای
لایێ	لای
لبنانێ	لبنان
لق	لق
لقا	لقا
لقمان	لقمان
لقێ	لق
لمە	لم
لهەڤ	لهو
لویس	لویس
لڤێرێ	لور
لڤێرە	لور
لک	لک
لکێ	لک
لگوری	لگوری
لگورەی	لگوری
لگوورەی	لگوری
لگۆری	لگوری
لۆلێ	لول
لی	لی
لیبی	لیبی
لیز	لیز
لیزا	لیزا
لیست	لیست
لیستێ	لیست
لیستە	لیست
لیڤەرپول	لیورپول
لیڤەرپۆل	لیورپول
لیگ	لیگ
لیگێ	لیگ
لێڤا	لوا
لێڤێن	لون
لێک	لک
لێی	لی
لەتیف	لطیف
لەش	لش
لەشکر	لشکر
لەشکرکێشیێ	لشکرکشی
لەشکری	لشکری
لەشکرێ	لشکر
لەشکرەکێ	لشکرک
لەشکەر	لشکر
لەشکەری	لشکری
لەشکەرێ	لشکر
لەشی	لشی
لەشێ	لش
لەعل	لعل
لەعلێ	لعل
لەم	لم
لەندێ	لند
لەندەن	لندن
لەندەنە	لندن
لەنگ	لنگ
لەوا	لوا
لەورا	لورا
لەوڕا	لورا
لەوەی	لوی
لەکێ	لک
لەیس	لیث
لەیلا	لیلا
ما	ما
ماتیۆ	ماتیو
ماجد	ماجد
مادی	مادی
مادێ	ماد
مادە	ماد
مادەیان	مادیان
مادەیێ	مادی
مار	مار
مارتن	مارتن
مارتین	مارتین
مارتینێز	مارتینز
مارش	مارش
مارک	مارک
مارکس	مارکس
ماری	ماری
ماریا	ماریا
مارێ	مار
مارە	مار
مارەکێ	مارک
ماسک	ماسک
ماسکێ	ماسک
ماسی	ماسی
ماسیێ	ماسی
ماسیە	ماسی
مافی	مافی
مال	مال
مالا	مآلا
مالکی	مالکی
مالی	مالی
مالێ	مال
مالەکێ	مالک
مام	مام
مامێ	مام
مامە	مام
مانا	مانا
ماندی	ماندی
مانی	مانی
مانەوی	مانوی
ماهر	ماهر
ماهیەتا	ماهیتا
ماک	ماک
ماکسیم	ماکسیم
ماڵ	مال
ماڵا	مآلا
ماڵی	مالی
ماڵێ	مال
ماڵەکەی	مالکی
ماین	ماین
ماینە	ماین
مایک	مایک
مایکل	مایکل
مایەوە	مایو
مایەڤە	مایو
مبارەک	مبارک
متران	مطران
محسن	محسن
محمد	محمد
محمەد	محمد
محەمد	محمد
محەمەد	محمد
محەمەدی	محمدی
محەمەدێ	محمد
مراجعەتێ	مراجعت
مراد	مراد
مرم	مرم
مری	مری
مرید	مرید
مرین	مرین
مرینە	مرین
مریێن	مرین
مزووری	مزوری
مسر	مسر
مسرا	مسرا
مسری	مسری
مسریان	مصریان
مسرێ	مسر
مسعود	مسعود
مسلح	مسلح
مشک	مشک
مشکێ	مشک
مشیر	مشیر
مشە	مش
معتدل	معتدل
مقداد	مقداد
مل	مل
ملا	ملا
ملازم	ملازم
ملم	ملم
ملک	ملک
ملکێ	ملک
ملیاردێرێ	ملیاردر
ملێ	مل
ملەتێ	ملت
من	من
منا	منا
منڤە	منو
منی	منی
منێ	من
منە	من
منەت	منت
مهاباد	مهاباد
مهابادێ	مهاباد
موئەید	موید
موبایل	موبایل
موبایلێ	موبایل
مورال	مورال
موز	موز
موزیک	موزیک
موزیکێ	موزیک
موسل	موصل
موسڵ	موصل
موسەوی	موسوی
مول	مول
مولانا	مولانا
مومیا	مومیا
مونا	مونا
مونتاژ	مونتاژ
مونتاژێ	مونتاژ
مووسل	موصل
مووسلێ	موصل
مووسڵ	موصل
مووسەوی	موسوی
مووشەک	موشک
مووچەیێن	موچین
مۆبایل	موبایل
مۆبایلێ	موبایل
مۆرال	مورال
مۆز	موز
مۆزیک	موزیک
مۆزیکێ	موزیک
مۆزێ	موز
مۆشەک	موشک
مۆلەتان	مولتان
مۆلەر	مولر
مۆنتاژ	مونتاژ
می	می
میتران	میتران
میتەران	میتران
میرزا	میرزا
میری	میری
میزانیێ	میزانی
میزێ	میز
میسان	میسان
میسر	میسر
میل	میل
میلان	میلان
میلیشیا	میلیشیا
مین	مین
مینا	مینا
میکس	میکس
میگێل	میگل
مێرا	مرا
مێران	مران
مێرگ	مرگ
مێرگێ	مرگ
مێری	مری
مێزا	مزا
مێزی	مذی
مێشک	مشک
مێشکی	مشکی
مێشکێ	مشک
مێل	مل
مێلاک	ملاک
مێلاکێ	ملاک
مێیان	میان
مێیە	می
مەئینا	مینا
مەبوو	مبو
مەبەحس	مبحث
مەتر	متر
مەتران	مطران
مەترس	مترس
مەترەک	مترک
مەتین	متین
مەتینی	متینی
مەجید	مجید
مەحالە	محال
مەحمود	محمود
مەحمودی	محمودی
مەحموود	محمود
مەحموودیێ	محمودی
مەحەمەد	محمد
مەخمور	مخمور
مەخموور	مخمور
مەخموورێ	مخمور
مەخمۆر	مخمور
مەد	مد
مەداد	مداد
مەدەنی	مدنی
مەرا	مرا
مەرجان	مرجان
مەرجەع	مرجع
مەرجەعێ	مرجع
مەرجەعە	مرجع
مەردان	مردان
مەردانە	مردان
مەرقەدێ	مرقد
مەروان	مروان
مەرکەزی	مرکزی
مەرگ	مرگ
مەریخێ	مریخ
مەریوان	مریوان
مەریەم	مریم
مەرەم	مرم
مەرەمێ	مرم
مەزارێ	مزار
مەزلووم	مظلوم
مەزن	مزن
مەزنێ	مزن
مەزنە	مزن
مەزهەب	مذهب
مەزهەبی	مذهبی
مەزهەر	مظهر
مەزڵوم	مظلوم
مەست	مست
مەستی	مستی
مەسرور	مسرور
مەسروور	مسرور
مەسرۆر	مسرور
مەسعود	مسعود
مەسعوود	مسعود
مەسعوودی	مسعودی
مەسیحی	مسیحی
مەسیحیان	مسیحیان
مەسەلە	مثل
مەسەلەی	مصلی
مەشق	مشق
مەعسوم	معصوم
مەعقولە	معقول
مەعلومە	معلوم
مەعنا	معنا
مەعنەوی	معنوی
مەغرب	مغرب
مەغرۆر	مغرور
مەل	مل
مەلا	ملا
مەلەڤانی	ملوانی
مەنتقی	منطقی
مەند	مند
مەنسور	منثور
مەنسوور	منثور
مەنۆچێهری	منوچهری
مەنە	من
مەه	مه
مەهاباد	مهاباد
مەهدی	مهدی
مەهران	مهران
مەهێ	مه
مەهەر	مهر
مەولانا	مولانا
مەولود	مولود
مەولوود	مولود
مەڤە	مو
مەکتەب	مکتب
مەکتەبی	مکتبی
مەکر	مکر
مەکی	مکی
مەکەن	مکن
مەکەهێ	مکه
مەگەر	مگر
مەیدانی	میدانی
مەیدانێ	میدان
مەیسەر	میسر
مەیل	میل
مەیێ	می
مەیێن	مین
مەیە	می
نا	نا
نابە	ناب
ناتق	ناطق
ناتو	ناتو
ناتوانێ	ناتوان
ناتۆ	ناتو
ناجی	ناجی
ناخێن	ناخن
نادر	نادر
نادیا	نادیا
نازم	نازم
نازک	نازک
نازێ	ناز
نازەنین	نازنین
ناسا	ناسا
ناسر	ناصر
ناسریێ	ناصری
ناف	ناف
نالی	نالی
نالە	نال
نامووس	ناموس
نامووسێ	ناموس
نامێ	نام
نامە	نام
نامەیێ	نامی
نامەیە	نامی
نان	نان
نانێ	نان
ناو	ناو
ناپولی	ناپولی
ناچار	ناچار
ناچاری	ناچاری
ناڤ	ناو
ناڤبری	ناوبری
ناڤبریێ	ناوبری
ناڤێ	ناو
ناڤە	ناو
ناڤەک	ناوک
ناڤەکێ	ناوک
ناکۆک	ناکوک
ناڵی	نالی
نایاب	نایاب
نبۆ	نبو
نجێفی	نجفی
نرخ	نرخ
نرخێ	نرخ
نزا	نزا
نزار	نزار
نزم	نظم
نسری	نسری
نمایش	نمایش
نمەکی	نمکی
نهێلی	نهلی
نهێلێ	نهل
نو	نو
نوبڵ	نوبل
نوبڵێ	نوبل
نورمال	نورمال
نورمالە	نورمال
نوری	نوری
نوزدێ	نوزد
نوو	نو
نووبهارێ	نوبهار
نووری	نوری
نوونە	نون
نووچه	نوچه
نووچەیێن	نوچین
نووکریە	نوکری
نووکە	نوک
نووێ	نو
نوچەیێن	نوچین
نوکە	نوک
نویێن	نوین
نوێ	نو
نڤشی	نوشی
نڤیس	نویس
نڤیسی	نویسی
نڤیسیە	نویسی
نک	نک
نکو	نکو
نۆبل	نوبل
نۆبلێ	نوبل
نۆرد	نورد
نۆرمال	نورمال
نۆزدە	نوزد
نۆچەیێن	نوچین
نۆکە	نوک
نۆکەیا	نوکیا
نیا	نیا
نیاز	نیاز
نیازە	نیاز
نیتراتێ	نیترات
نیسانێ	نیسان
نیوز	نیوز
نیوکاسل	نیوکاسل
نیویورک	نیویورک
نیویۆرک	نیویورک
نیڤ	نیو
نیڤێ	نیو
نیڤە	نیو
نیک	نیک
نیۆز	نیوز
نیە	نی
نیەت	نیت
نێر	نر
نێروەی	نروی
نێروەیی	نرویی
نێرین	نرین
نێرینە	نرین
نێو	نو
نێڕین	نرین
نێڤ	نو
نێڤدەولەتی	نودولتی
نێڤدەولەتیە	نودولتی
نەئینا	نینا
نەبا	نبا
نەباش	نباش
نەباشە	نباش
نەبریە	نبری
نەبوو	نبو
نەبووی	نبوی
نەبوویمە	نبویم
نەبوویی	نبویی
نەبوویە	نبوی
نەبووە	نبو
نەبویە	نبوی
نەبی	نبی
نەبید	نبید
نەبین	نبین
نەبینی	نبینی
نەبینە	نبین
نەتنێ	نتن
نەتەوان	نتوان
نەجات	نجات
نەجار	نجار
نەجم	نجم
نەجهێ	نجه
نەجیب	نجیب
نەجیبە	نجیب
نەجەف	نجف
نەجەفی	نجفی
نەخری	نخری
نەخشەکێ	نخشک
نەخواستیە	نخواستی
نەخواستە	نخواست
نەخۆت	نخوت
نەخێر	نخر
نەدا	ندا
نەداد	نداد
نەدادی	ندادی
نەدان	ندان
نەدەم	ندم
نەرم	نرم
نەرمی	نرمی
نەرین	نرین
نەزیر	نذیر
نەسر	نثر
نەسرا	نسرا
نەسرین	نسرین
نەسرینێ	نسرین
نەسرەت	نصرت
نەسیری	نصیری
نەشیت	نشیت
نەشێت	نشت
نەشێین	نشین
نەفت	نفت
نەفتا	نفتا
نەفتێ	نفت
نەفرەت	نفرت
نەفس	نفس
نەقشبەندی	نقشبندی
نەقشەبەندی	نقشبندی
نەقیب	نقیب
نەقیبێ	نقیب
نەل	نل
نەما	نما
نەمازە	نماز
نەمان	نمان
نەمانێ	نمان
نەه	نه
نەهی	نهی
نەهێ	نه
نەهێلم	نهلم
نەهێلە	نهل
نەهەمین	نهمین
نەو	نو
نەواب	نواب
نەوروز	نوروز
نەوروزێ	نوروز
نەورۆز	نوروز
نەورۆزێ	نوروز
نەوزاد	نوزاد
نەوشیروان	نوشیروان
نەوشێروان	نوشروان
نەچین	نچین
نەژاد	نژاد
نەڤیێن	نوین
نەڤێن	نون
نەک	نک
نەکارێ	نکار
نەکرد	نکرد
نەکو	نکو
نەکە	نک
نەکەن	نکن
نەکەنە	نکن
نەیا	نیا
نەیاسایی	نیاسایی
نەینەوا	نینوا
نەیێ	نی
هات	هات
هاتە	هات
هادی	هادی
هاری	هاری
هاشم	هاشم
هاشمی	هاشمی
هانا	هانا
هانی	هانی
هاون	هاون
هاڤێن	هاون
هاگ	هاگ
هاگی	هاگی
هزار	هزار
هزاران	هزاران
هزارەها	هزارها
هشتیە	هشتی
هشیار	هشیار
هشیاری	هشیاری
هشیاریێ	هشیاری
هل	هل
هلو	هلو
همبەری	همبری
هند	هند
هندێ	هند
هندە	هند
هنگ	هنگ
هنگێ	هنگ
هوانگ	هوانگ
هورمونێ	هورمون
هورمۆنێ	هورمون
هورمۆنە	هورمون
هوشیار	هوشیار
هوشیاریێ	هوشیاری
هوشیارە	هوشیار
هوو	هوو
هوور	هور
هووو	هوو
هۆش	هوش
هۆشیاری	هوشیاری
هۆشیاریێ	هوشیاری
هۆشەنگ	هوشنگ
هۆل	هول
هۆلێ	هول
هۆلە	هول
هۆڤە	هوو
هیز	هیز
هیوا	هیوا
هیچ	هیچ
هیڤێن	هیون
هێدی	هدی
هێرناندێز	هرناندز
هێل	هل
هێلن	هلن
هێلی	هلی
هێلیکۆپتەر	هلیکوپتر
هێلیکۆپتەرێ	هلیکوپتر
هێلێ	هل
هێلێن	هلن
هێما	هما
هێندە	هند
هێنگێ	هنگ
هێچ	هچ
هێک	هک
هێگل	هگل
هەدەر	هدر
هەر	هر
هەرحال	هرحال
هەرسێ	هرس
هەرچەند	هرچند
هەرچەندە	هرچند
هەرکەسێ	هرکس
هەرێ	هر
هەرێم	هرم
هەرێمێ	هرم
هەرە	هر
هەرەسێ	هرس
هەرەمێ	هرم
هەزار	هزار
هەزاران	هزاران
هەست	هست
هەستی	هستی
هەستێ	هست
هەستە	هست
هەشت	هشت
هەشتی	هشتی
هەشتێ	هشت
هەشتەم	هشتم
هەشتەمین	هشتمین
هەل	هل
هەلۆ	هلو
هەلێر	هلر
هەم	هم
هەما	هما
هەمان	همان
هەماهەنگی	همآهنگی
هەماهەنگیێ	همآهنگی
هەمبەری	همبری
هەمو	همو
هەموار	هموار
هەموو	همو
هەمیان	همیان
هەمیانە	همیان
هەمە	هم
هەمەرەنگ	همرنگ
هەند	هند
هەوا	هوا
هەوار	هوار
هەوارێ	هوار
هەول	هول
هەولێ	هول
هەوڵ	هول
هەوەڤە	هوو
هەژموونی	هژمونی
هەڤدە	هود
هەڤرا	هورا
هەڤڕا	هورا
هەکە	هک
هەکەر	هکر
هەیهات	هیهات
هەیڤ	هیو
هەیڤا	هیوا
هەیڤن	هیون
هەیڤێ	هیو
هەیڤێن	هیون
هەیڤە	هیو
هەیکەلێ	هیکل
هەیەو	هیو
و	و
وئیرانێ	ویران
وا	وا
وات	وات
واتە	وات
وادی	وادی
واقع	واقع
واقعی	واقعی
واقعێ	واقع
وان	وان
وانا	وانا
وانێ	وان
وانە	وان
وب	وب
وتی	وطی
وزیرێ	وزیر
وزەی	وذی
وزەیێ	وذی
وشە	وش
ول	ول
ولا	ولا
ون	وِن
ووتی	وطی
ووردی	وردی
ووزەیێ	وذی
وول	ول
وی	وی
ویدا	ویدا
وینە	وین
ویڤە	ویو
ویێ	وی
ویێن	وین
ویە	وی
وێ	و
وێب	وب
وێلز	ولز
وێلی	ولی
وێنێ	وِن
وێنە	وِن
وێنەک	ونک
وێنەکێ	ونک
وێنەگر	ونگر
وێیە	وی
وە	و
وەحید	وحید
وەرزش	ورزش
وەرزشێ	ورزش
وەرزی	ورزی
وەزارەت	وزارت
وەزارەتێ	وزارت
وەزیر	وزیر
وەزیران	وزیران
وەزیری	وزیری
وەزیرێ	وزیر
وەستا	وسطا
وەسف	وصف
وەسەت	وست
وەفا	وفا
وەفاداری	وفاداری
وەفاداریێ	وفاداری
وەل	ول
وەلی	ولی
وەلید	ولید
وەلێ	ول
وەهبی	وهبی
وەهم	وهم
وەکالەت	وکالت
وەی	وی
وەیسی	ویسی
وەینە	وین
وەیە	وی
پا	پا
پابلۆ	پابلو
پابەند	پابند
پابەندە	پابند
پار	پار
پارت	پارت
پارتی	پارتی
پارتیزانی	پارتیزانی
پارتیێ	پارتی
پارتیە	پارتی
پارتێ	پارت
پارتە	پارت
پارچە	پارچ
پارچەیێن	پارچین
پارچەیە	پارچی
پارک	پارک
پارکێ	پارک
پاریس	پاریس
پاریسێ	پاریس
پارێ	پار
پارە	پار
پارەکێ	پارک
پاسداران	پاسداران
پاشا	پاشا
پاشایی	پاشایی
پاشی	پاشی
پال	پال
پالە	پال
پاک	پاک
پاکستان	پاکستان
پاکستانێ	پاکستان
پاکیێ	پاکی
پاڵ	پال
پایتەخت	پایتخت
پایتەختێ	پایتخت
پاییزە	پاییز
پایە	پای
پایەیێن	پایین
پتر	پتر
پترێ	پتر
پترە	پتر
پر	پر
پران	پران
پرت	پرت
پرتی	پرتی
پردێ	پرد
پرس	پرس
پرسان	پرسان
پرسی	پرسی
پرسیم	پرسیم
پرسێ	پرس
پرسە	پرس
پرو	پرو
پرۆ	پرو
پری	پری
پرێس	پرس
پرە	پر
پرەک	پرک
پرەکێ	پرک
پزێ	پز
پشت	پشت
پشتگەرم	پشتگرم
پشتی	پشتی
پشتێ	پشت
پشتە	پشت
پشک	پشک
پشکێ	پشک
پلاس	پلاس
پلاستیک	پلاستیک
پلان	پلان
پلانێ	پلان
پلانەک	پلانک
پلانەکێ	پلانک
پلنگ	پلنگ
پلە	پل
پوتین	پوتین
پوستێ	پوست
پوستە	پوست
پوستەر	پوستر
پولیس	پولیس
پووچ	پوچ
پڕ	پر
پڕی	پری
پڕە	پر
پک	پک
پۆتین	پوتین
پۆر	پور
پۆست	پوست
پۆستێ	پوست
پۆستە	پوست
پۆستەرە	پوستر
پۆستەچی	پوستچی
پۆسیدە	پوسید
پۆلیس	پولیس
پۆپ	پوپ
پی	پی
پیت	پیت
پیتەر	پیتر
پیر	پیر
پیرا	پیرا
پیران	پیران
پیروز	پیروز
پیرۆز	پیروز
پیرۆزی	پیروزی
پیرۆزیێ	پیروزی
پیرۆزێ	پیروز
پیرۆزە	پیروز
پیرێ	پیر
پیرە	پیر
پیس	پیس
پیست	پیست
پیستی	پیستی
پیستێ	پیست
پیش	پیش
پیشە	پیش
پیشەکار	پیشکار
پیشەیێ	پیشی
پیلێ	پیل
پیچ	پیچ
پیچە	پیچ
پیچەک	پیچک
پیچەکێ	پیچک
پیێ	پی
پیێن	پین
پیەکێ	پیک
پێت	پت
پێتر	پتر
پێش	پش
پێشەنگ	پشنگ
پێشەنگە	پشنگ
پێل	پل
پێلان	پلان
پێلاڤ	پلاو
پێلاڤە	پلاو
پێن	پن
پێنج	پنج
پێنجێ	پنج
پێنجەمین	پنجمین
پێوەر	پور
پێک	پک
پێکر	پکر
پێی	پی
پەتا	پتا
پەترۆلیۆم	پترولیوم
پەتی	پتی
پەخش	پخش
پەخشێ	پخش
پەرت	پرت
پەردێ	پرد
پەردە	پرد
پەرست	پرست
پەرستیێ	پرستی
پەرواز	پرواز
پەروازێ	پرواز
پەروین	پروین
پەروەر	پرور
پەروەردێ	پرورد
پەروەردێن	پروردن
پەروەردە	پرورد
پەروەردەیێ	پروردی
پەری	پری
پەریشان	پریشان
پەرێ	پر
پەزی	پزی
پەزێ	پز
پەسەند	پسند
پەشیمان	پشیمان
پەلان	پلان
پەنج	پنج
پەنجێ	پنج
پەند	پند
پەهلەوی	پهلوی
پەکی	پکی
پەی	پی
پەیام	پیام
پەیامی	پیامی
پەیامێ	پیام
پەیامە	پیام
پەیامەک	پیامک
پەیامەکێ	پیامک
پەیج	پیج
پەیجێ	پیج
پەیدا	پیدا
پەیرەو	پیرو
پەیرەوێ	پیرو
پەیمان	پیمان
پەیوەندی	پیوندی
پەیوەندیێ	پیوندی
پەیوەندیە	پیوندی
پەیڕەو	پیرو
پەیڕەوی	پیروی
پەیڕەوێ	پیرو
پەیکەر	پیکر
پەیکەرێ	پیکر
پەیکەرە	پیکر
چادر	چادر
چارێک	چارک
چالاک	چالاک
چالاکی	چالاکی
چالاکیێ	چالاکی
چالاکیە	چالاکی
چالاکە	چالاک
چاوش	چاوش
چاپ	چاپ
چاپی	چاپی
چاپێ	چاپ
چاک	چاک
چایچی	چایچی
چایێ	چای
چت	چت
چرا	چرا
چرکە	چرک
چم	چم
چمە	چم
چنار	چنار
چنین	چنین
چو	چو
چول	چول
چوو	چو
چوول	چول
چوون	چون
چوونێ	چون
چوونە	چون
چووە	چو
چوڵ	چول
چڕکە	چرک
چڕەیە	چری
چۆل	چول
چۆن	چون
چۆک	چوک
چی	چی
چیت	چیت
چیتە	چیت
چین	چین
چینی	چینی
چینێ	چین
چینە	چین
چیه	چیه
چیە	چی
چێتر	چتر
چێترە	چتر
چێلسی	چلسی
چێکەم	چکم
چێکەن	چکن
چەترێ	چتر
چەرخ	چرخ
چەرخێ	چرخ
چەستەیێ	چستی
چەم	چم
چەمران	چمران
چەمێ	چم
چەمێن	چمن
چەند	چند
چەندان	چندان
چەندی	چندی
چەندین	چندین
چەندیێن	چندین
چەندێ	چند
چەندە	چند
چەنگ	چنگ
چەنگێ	چنگ
چەپ	چپ
چەپێ	چپ
چەپەرێ	چپر
چەڤەنگ	چونگ
چەک	چک
چەکی	چکی
چەکێ	چک
چەکێن	چکن
چەکە	چک
ڕا	را
ڕادەیێ	رادی
ڕادەیەکێ	رادیک
ڕازی	رازی
ڕاست	راست
ڕاستگۆ	راستگو
ڕاستی	راستی
ڕاستیێ	راستی
ڕاستیە	راستی
ڕاستە	راست
ڕاپۆرت	راپورت
ڕستە	رست
ڕوح	روح
ڕوو	رو
ڕووبەڕووی	روبروی
ڕووسی	روسی
ڕوونی	رونی
ڕووی	روی
ڕوویێ	روی
ڕۆژان	روژان
ڕۆژانە	روژان
ڕێز	رز
ڕێزێ	رز
ڕێزێن	رزن
ڕێسا	رثا
ڕێڤەبەر	روبر
ڕێڤەبەرێ	روبر
ڕێک	رک
ڕێکێ	رک
ڕێکێن	رکن
ڕێیا	ریا
ڕێیەکا	ریکا
ڕەئیا	ریا
ڕەئیسی	ریسی
ڕەجەب	رجب
ڕەز	رز
ڕەسول	رسول
ڕەسوڵ	رسول
ڕەش	رش
ڕەشید	رشید
ڕەفتار	رفتار
ڕەمەزان	رمضان
ڕەنگێ	رنگ
ڕەنگە	رنگ
ڕەوا	روا
ڕەوانەی	روانی
ڕەوش	روش
ڕەوشێ	روش
ڕەوشە	روش
ڕەڤی	روی
ژان	ژان
ژانرێ	ژانر
ژمن	ژمن
ژن	ژن
ژنوو	ژنو
ژنێ	ژن
ژنە	ژن
ژیان	ژیان
ژیانێ	ژیان
ژیانە	ژیان
ڤ	و
ڤاتیکان	واتیکان
ڤاتیکانێ	واتیکان
ڤالا	والا
ڤالە	وال
ڤان	وان
ڤانێ	وان
ڤی	وی
ڤیاریال	ویاریال
ڤیتامین	ویتامین
ڤیدیو	ویدیو
ڤیدیوو	ویدیو
ڤیدیویی	ویدیویی
ڤیدیۆ	ویدیو
ڤیدیۆیی	ویدیویی
ڤیرە	ویر
ڤیلا	ویلا
ڤینێ	وین
ڤێ	و
ڤێلا	ولا
ڤە	و
ڤەبڕ	وبر
ڤەنە	وِن
ڤەیە	وی
کابینێ	کابین
کابینە	کابین
کاتە	کات
کادر	کادر
کادرێ	کادر
کار	کار
کارا	کارا
کاربەر	کاربر
کارت	کارت
کارتێن	کارتن
کارلۆ	کارلو
کارمەند	کارمند
کارمەندان	کارمندان
کارمەندی	کارمندی
کارمەندێ	کارمند
کارن	کارن
کاروان	کاروان
کاروانی	کاروانی
کاروانێ	کاروان
کارکەن	کارکن
کارگێری	کارگری
کارگێریێ	کارگری
کارگێرێ	کارگر
کارگێڕێ	کارگر
کاری	کاری
کاریکاتۆر	کاریکاتور
کارێ	کار
کارێت	کارت
کارێن	کارن
کارە	کار
کارەک	کارک
کارەکێ	کارک
کارەکە	کارک
کازم	کاظم
کازمی	کاظمی
کازمێ	کاظم
کاسا	کاسا
کاسێت	کاست
کاغەزێ	کاغذ
کافری	کافری
کافیە	کافی
کافێ	کاف
کامل	کامل
کامەران	کامران
کانت	کانت
کانتۆنا	کانتونا
کاندید	کاندید
کاندیدا	کاندیدا
کاندیدێ	کاندید
کانی	کانی
کانیێ	کانی
کانێ	کان
کت	کت
کتکێ	کتک
کتێب	کتب
کتێبا	کتبا
کتێبی	کتبی
کتێبێ	کتب
کر	کر
کربن	کربن
کرد	کرد
کردن	کردن
کرم	کرم
کرمانجی	کرمانجی
کرنا	کرنا
کرند	کرند
کری	کری
کریستیان	کریستیان
کریستیانو	کریستیانو
کریستیانۆ	کریستیانو
کریم	کریم
کریە	کری
کرێ	کر
کرێت	کرت
کرێتە	کرت
کرێدار	کردار
کرە	کر
کشەیێ	کشی
کف	کف
کلاسیک	کلاسیک
کلدانی	کلدانی
کلم	کلم
کلینیک	کلینیک
کلیپ	کلیپ
کلیپێ	کلیپ
کلیپە	کلیپ
کلیک	کلیک
کم	کم
کن	کن
کنارێ	کنار
کنفێ	کنف
کو	کو
کوبا	کوبا
کوبانێ	کوبان
کوت	کوت
کود	کود
کور	کور
کوران	کوران
کورسێ	کورس
کوری	کوری
کورێ	کور
کورە	کور
کوشندە	کوشند
کول	کول
کولە	کول
کومار	کومار
کومارێ	کومار
کون	کون
کوو	کو
کوور	کور
کوون	کون
کوپێن	کوپن
کوچ	کوچ
کوچک	کوچک
کوڕ	کور
کوڕان	کوران
کوڕانی	کورانی
کوڕی	کوری
کوڕێ	کور
کویر	کویر
کویرە	کویر
کوێت	کوت
کوێتێ	کوت
کوێلە	کول
کۆ	کو
کۆبانێ	کوبان
کۆدێ	کود
کۆرێ	کور
کۆرە	کور
کۆشش	کوشش
کۆمار	کومار
کۆمارێ	کومار
کۆن	کون
کۆنێ	کون
کۆچ	کوچ
کۆچک	کوچک
کۆچکێ	کوچک
کۆچی	کوچی
کۆڕ	کور
کۆک	کوک
کۆیێ	کوی
کۆیە	کوی
کی	کی
کیرێ	کیر
کیستێ	کیست
کیش	کیش
کیشە	کیش
کیفی	کیفی
کیلو	کیلو
کیلۆ	کیلو
کیلۆمەتر	کیلومتر
کیم	کیم
کیمیا	کیمیا
کیمیاوی	کیمیاوی
کیمیایی	کیمیایی
کین	کین
کینێ	کین
کینە	کین
کیڤی	کیوی
کیڤە	کیو
کیڤەیە	کیوی
کێر	کر
کێرک	کرک
کێری	کری
کێش	کش
کێشوەرێ	کشور
کێشێ	کش
کێشە	کش
کێشەدار	کشدار
کێشەو	کشو
کێشەک	کشک
کێشەی	کشی
کێشەیێ	کشی
کێشەیە	کشی
کێشەیەک	کشیک
کێشەیەکێ	کشیک
کێل	کل
کێم	کم
کێماسی	کماسی
کێماسیێ	کماسی
کێمتر	کمتر
کێمترین	کمترین
کێمترە	کمتر
کێمی	کمی
کێمە	کم
کێمەک	کمک
کێک	کک
کێیە	کی
کەبەد	کبد
کەت	کت
کەتی	کتی
کەتیە	کتی
کەتە	کت
کەد	کد
کەر	کر
کەرامەت	کرامت
کەربێن	کربن
کەربەلا	کربلا
کەرتێ	کرت
کەرخ	کرخ
کەرخی	کرخی
کەرستێ	کرست
کەرستێن	کرستن
کەرستە	کرست
کەرکووک	کرکوک
کەرکووکێ	کرکوک
کەرکوک	کرکوک
کەرکوکێ	کرکوک
کەریم	کریم
کەریمی	کریمی
کەرێ	کر
کەرەج	کرج
کەرەستێ	کرست
کەرەستێن	کرستن
کەرەستە	کرست
کەرەم	کرم
کەرەکێ	کرک
کەس	کس
کەسی	کسی
کەسێ	کس
کەسە	کس
کەسەر	کسر
کەش	کش
کەشێ	کش
کەعبێ	کعب
کەفالەت	کفالت
کەل	کل
کەلا	کلا
کەلێ	کل
کەلەک	کلک
کەم	کم
کەمال	کمال
کەمتر	کمتر
کەمپ	کمپ
کەمپێ	کمپ
کەمی	کمی
کەن	کن
کەند	کند
کەندێ	کند
کەنعان	کنعان
کەنگی	کنگی
کەنی	کنی
کەنیزە	کنیز
کەنیزەک	کنیزک
کەنیێ	کنی
کەنە	کن
کەهرەبا	کهربا
کەو	کو
کەوت	کوت
کەوسەر	کوثر
کەوپەر	کوپر
کەوپەرێ	کوپر
کەوێ	کو
کەڤتە	کوت
کەڤر	کور
کەڤران	کوران
کەڤری	کوری
کەڤشک	کوشک
کەڤشکی	کوشکی
کەڤشکێ	کوشک
کەڤلێ	کول
کەڤن	کون
کەڤنە	کون
کەڤیت	کویت
کەڤیتێ	کویت
کەڤیتە	کویت
کەی	کی
کەیس	کیس
کەیسێ	کیس
کەیف	کیف
کەیفێ	کیف
کەین	کین
کەینە	کین
کەیڤی	کیوی
کەیە	کی
گابریێل	گابریل
گارەی	گاری
گاز	گاز
گازی	گازی
گازێ	گاز
گاڤ	گاو
گاڤێ	گاو
گاڤە	گاو
گای	گای
گر	گر
گرا	گرا
گرافیک	گرافیک
گران	گران
گرانی	گرانی
گرانێ	گران
گرانە	گران
گرفت	گرفت
گرفتێن	گرفتن
گرفتە	گرفت
گروپ	گروپ
گروپێ	گروپ
گرۆپ	گروپ
گرۆپێ	گروپ
گرۆپە	گروپ
گری	گری
گریان	گریان
گریێ	گری
گرێ	گر
گرێدان	گردان
گرێدانێ	گردان
گرێدی	گردی
گرێدەن	گردن
گرێکان	گرکان
گرێی	گری
گرێیان	گریان
گشت	گشت
گشتی	گشتی
گشتیێ	گشتی
گلاسکو	گلاسکو
گلە	گل
گلەو	گلو
گوتی	گوتی
گوتیە	گوتی
گور	گور
گورستانێ	گورستان
گوری	گوری
گورەی	گوری
گوشت	گوشت
گوشتێ	گوشت
گول	گول
گولی	گولی
گولێ	گول
گولە	گول
گون	گون
گونەه	گونه
گونەە	گون
گوه	گوه
گوهڕین	گوهرین
گوهێ	گوه
گوهەرین	گوهرین
گوهەرینێ	گوهرین
گووتی	گوتی
گووتیە	گوتی
گوول	گول
گووگل	گوگل
گوڕ	گور
گوڵ	گول
گۆتی	گوتی
گۆتیێ	گوتی
گۆتیە	گوتی
گۆر	گور
گۆری	گوری
گۆرێ	گور
گۆرەی	گوری
گۆشتێ	گوشت
گۆشە	گوش
گۆشەی	گوشی
گۆل	گول
گۆلی	گولی
گۆلێ	گول
گۆن	گون
گۆه	گوه
گۆڕ	گور
گۆڕستانێ	گورستان
گۆڕی	گوری
گۆڕێ	گور
گۆڕەی	گوری
گۆڵ	گول
گۆیا	گویا
گیرو	گیرو
گیرۆ	گیرو
گێرا	گرا
گێران	گران
گێڕان	گران
گەر	گر
گەرا	گرا
گەردوونێ	گردون
گەردۆن	گردون
گەردی	گردی
گەرم	گرم
گەرما	گرما
گەرمی	گرمی
گەرمێ	گرم
گەرمە	گرم
گەریان	گریان
گەریێ	گری
گەشت	گشت
گەشتێن	گشتن
گەشتە	گشت
گەل	گل
گەلۆ	گلو
گەلی	گلی
گەلیێ	گلی
گەلێ	گل
گەلێن	گلن
گەلێکە	گلک
گەلە	گل
گەلەک	گلک
گەلەکێ	گلک
گەلەکە	گلک
گەنج	گنج
گەنجی	گنجی
گەنجێ	گنج
گەنجە	گنج
گەنگی	گنگی
گەه	گه
گەوریێ	گوری
گەورە	گور
گەورەی	گوری
گەڕا	گرا
گەڕیان	گریان
گەڕێ	گر
گەڤێن	گون
گەڤەرێ	گور
ۆ	و
یا	یا
یاد	یاد
یادە	یاد
یار	یار
یارا	یارا
یاری	یاری
یاریێ	یاری
یاریە	یاری
یازدێ	یازد
یازدە	یازد
یاسا	یاسا
یاسین	یاسین
یوسف	یوسف
یوسفی	یوسفی
یونان	یونان
یونانێ	یونان
یونایتد	یونایتد
یونس	یونس
یووسف	یوسف
یوونس	یونس
یوڤێنتوس	یوونتوس
یڤێن	یون
یۆرۆ	یورو
یۆرۆیی	یورویی
یۆنان	یونان
یۆنانی	یونانی
یۆنایتد	یونایتد
یۆنگ	یونگ
یێل	یل
یەدەک	یدک
یەزد	یزد
یەزدانێ	یزدان
یەمەن	یمن
یەمەنێ	یمن
یەنس	ینس
یەک	یک
یەکسان	یکسان
یەکسانی	یکسانی
یەکسانیێ	یکسانی
یەکی	یکی
یەکێ	یک
یەکە	یک
یەکەم	یکم
یەکەمین	یکمین