أحرار	أحرار
أن	أن
ئ	ئ
ئا	آ
ئاب	آب
ئابێ	آب
ئاخ	آخ
ئاخر	آخر
ئاخرەت	اخرط
ئاخفت	اخفت
ئاخفتن	اخفتن
ئاخفتنێ	اخفتن
ئاخڤین	اخوين
ئاخین	آخين
ئاخێ	آخ
ئاخە	آخ
ئادارا	ادارآ
ئادەم	آدم
ئار	آر
ئارام	آرام
ئارامی	آرامي
ئارامیێ	آرامي
ئارامە	آرام
ئاری	آري
ئارێ	آر
ئارێشێ	ارش
ئارێشە	ارش
ئازا	آضا
ئازار	آذار
ئازۆ	اضو
ئازەری	آذري
ئاست	اسط
ئاستا	آستا
ئاستی	اسطي
ئاستێ	اسط
ئاستێن	اسطن
ئاستە	اسط
ئاستەکی	اصطكي
ئاستەکێ	اصطك
ئاستەکە	اصطك
ئاسمان	آثمان
ئاسمانێ	آثمان
ئاسن	آسن
ئاسنی	اثني
ئاسنێن	اصنن
ئاسى	آسى
ئاسۆ	اثو
ئاسۆس	اسوس
ئاسۆیێن	اثوين
ئاسیا	آسيا
ئاسێ	آس
ئاسێکری	اسكري
ئاشت	اشت
ئاشتی	اشتي
ئاشتیێ	اشتي
ئاشنا	اشنآ
ئاشوری	آشوري
ئاشووری	آشوري
ئاشکرا	اشكرا
ئاشکرانە	اشكران
ئاشکەرا	اشكرا
ئافرەت	افرط
ئافرەتا	افرطا
ئافرەتان	افرطان
ئافرەتن	افرطن
ئافرەتێ	افرط
ئافرەتێن	افرطن
ئافرەتە	افرط
ئاقل	اقل
ئال	آل
ئالان	الآن
ئالتون	التون
ئالزی	الذي
ئالووسی	الوثي
ئالى	آلى
ئالی	آلي
ئالیان	آليان
ئالیانە	آليان
ئالین	آلين
ئالینێ	آلين
ئالیێ	آلي
ئالیێن	آلين
ئالێ	آل
ئالێن	آلن
ئالەکێ	الك
ئامادە	آماد
ئامر	آمر
ئامێدی	آمدي
ئامێدیێ	آمدي
ئامێرێن	امرن
ئامەد	آمد
ئامەدێ	آمد
ئان	آن
ئانەهیا	انهيا
ئاها	آها
ئاڤ	آو
ئاڤی	آوي
ئاڤیێ	آوي
ئاڤیێن	آوين
ئاڤێ	آو
ئاڤە	آو
ئاکام	آكام
ئاکرێ	آكر
ئایدا	ايدآ
ئایدیا	ايديا
ئایرین	ايرين
ئایە	آي
ئبن	بن
ئحسان	حسان
ئنجیل	نجيل
ئها	ها
ئو	و
ئوردن	وردن
ئوردنێ	وردن
ئورمیێ	ورمي
ئوسامە	وسام
ئوسمان	وصمان
ئوسێ	وص
ئول	ول
ئولى	ولى
ئولی	ولي
ئومێد	ومد
ئومێدا	ومدا
ئومێدن	ومدن
ئومێدێن	ومدن
ئومێدە	ومد
ئوکیف	وكيف
ئۆرمیێ	ورمي
ئۆستن	وسطن
ئۆسمان	وصمان
ئۆسێ	وص
ئۆل	ول
ئۆلا	ولا
ئۆلى	ولى
ئۆلی	ولي
ئۆمێد	ومد
ئۆمێدا	ومدا
ئۆمێدێن	ومدن
ئیبدو	يبدو
ئیتاڕ	يطار
ئیتر	يطر
ئیحسان	يحصان
ئیدارا	يدارآ
ئیدارى	يدارى
ئیداری	يداري
ئیدارێن	يدارن
ئیدارە	يدار
ئیدارەی	يداري
ئیدارەیا	يداريا
ئیدارەیێ	يداري
ئیدانە	يدان
ئیدمان	يدمان
ئیدونا	يدونا
ئیدى	يدى
ئیدی	يدي
ئیرادا	يرادا
ئیرادێ	يراد
ئیرادە	يراد
ئیراق	يراق
ئیراقا	يراقا
ئیراقێ	يراق
ئیران	يران
ئیرانا	يرانا
ئیرانێ	يران
ئیرنا	يرنا
ئیرو	يرو
ئیرۆ	يرو
ئیسال	يصال
ئیسف	يسف
ئیسفێ	يسف
ئیش	يش
ئیشێن	يشن
ئیلا	يلا
ئیلخان	يلخان
ئیلونا	يلونا
ئیلونێ	يلون
ئیلۆن	يلون
ئیلۆنا	يلونا
ئیلۆنێ	يلون
ئیمام	يمام
ئیمان	يمان
ئیمانێ	يمان
ئیمزا	يمضا
ئیمەلێ	يمل
ئینابا	ينابا
ئینابوونە	ينابون
ئینت	ينت
ئینم	ينم
ئینن	ينن
ئینیت	ينيط
ئێحسان	حسان
ئێخست	خست
ئێخستن	خستن
ئێخستنە	خستن
ئێخستە	خست
ئێخنە	خن
ئێخیت	خيت
ئێخیتە	خيت
ئێخینە	خين
ئێدارا	دارآ
ئێدی	دي
ئێدێ	د
ئێراقا	راقا
ئێراقێ	راق
ئێرش	رش
ئێرشی	رشي
ئێرشێن	رشن
ئێرڤن	رون
ئێزدی	ضدي
ئێزی	ذي
ئێستا	سطا
ئێسکەر	سكر
ئێش	ش
ئێشان	شان
ئێشانا	شانا
ئێشانێ	شان
ئێشم	شم
ئێشیت	شيط
ئێشێ	ش
ئێشێن	شن
ئێشە	ش
ئێل	ل
ئێما	ما
ئێمزا	مضا
ئێمن	من
ئێمناهی	مناهي
ئێمناهیێ	مناهي
ئێمە	م
ئێن	ن
ئێڤارى	وارى
ئێڤاری	واري
ئێڤاریا	واريا
ئێک	ك
ئێکانە	كان
ئێکدو	كدو
ئێکدوو	كدو
ئێکرێز	كرز
ئێکرێزی	كرزي
ئێکرێزیێ	كرزي
ئێکسە	كث
ئێکسەر	كسر
ئێکلا	كلا
ئێکن	كن
ئێکو	كو
ئێکڕێزیێ	كرزي
ئێکی	كي
ئێکین	كين
ئێکێ	ك
ئێکێب	كب
ئێکێدا	كدا
ئێکە	ك
ئێکەتی	كتي
ئێکەتیێ	كتي
ئێکەتیێن	كتين
ئێکەتیە	كتي
ئێکەتێ	كت
ئێکەم	كم
ئێکەما	كما
ئێکەمین	كمين
ئێڵ	ل
ئە	
ئەبیەن	بين
ئەتروشی	تروشي
ئەترووش	تروش
ئەترووشی	تروشي
ئەتیک	تِيك
ئەجندا	جندا
ئەحمد	حمد
ئەحمەد	حمد
ئەحمەدی	حمدي
ئەحمەدێ	حمد
ئەحمەدە	حمد
ئەحمەر	حمر
ئەحمەری	حمري
ئەختەرا	خطرا
ئەختەرێ	خطر
ئەختەرە	خطر
ئەخلاق	خلاق
ئەخلاقێ	خلاق
ئەدهەم	دهم
ئەدڤار	دوار
ئەدیب	ديب
ئەدەب	دب
ئەدەبا	دبا
ئەدەبی	دبي
ئەدەبێ	دب
ئەدەبە	دب
ئەرب	رب
ئەرد	رد
ئەردان	ردان
ئەردى	ردى
ئەردی	ردي
ئەردێ	رد
ئەرزاقێ	رزاق
ئەرزان	رزان
ئەرشیف	رشيف
ئەرشێ	رش
ئەرشەد	رشد
ئەرک	رك
ئەرکان	ركان
ئەرکانێ	ركان
ئەرکی	ركي
ئەرکێ	رك
ئەرکێن	ركن
ئەرکە	رك
ئەرکەکێ	ركك
ئەرکەکە	ركك
ئەرێ	ر
ئەرێنى	رنى
ئەرێنی	رني
ئەرێنیێن	رنين
ئەرێنێ	رن
ئەرەب	رب
ئەرەبان	ربان
ئەرەبى	ربى
ئەرەبی	ربي
ئەرەبێن	ربن
ئەرەدنا	ردنا
ئەرەنى	رنى
ئەز	ذ
ئەزا	ذا
ئەزم	ذم
ئەزیز	زيز
ئەزێ	ذ
ئەس	ث
ئەساسێ	ساس
ئەستانە	سطان
ئەستون	ستون
ئەسل	سل
ئەسلان	صلان
ئەسمان	ثمان
ئەسمانى	سمانى
ئەسمانی	ثماني
ئەسمانیێن	ثمانين
ئەسمانێ	ثمان
ئەسوەد	سود
ئەسیست	سيست
ئەسیل	ثيل
ئەسەد	سد
ئەسەدى	سدى
ئەسەدی	ثدي
ئەسەدێ	سد
ئەشقا	شقا
ئەشواق	شواق
ئەشکرا	شكرا
ئەشکەرا	شكرا
ئەشیر	شير
ئەعرەجی	عرجي
ئەف	ف
ئەفسانە	فصان
ئەفسەر	فسر
ئەفسەرێ	فسر
ئەفسەرێن	فسرن
ئەفەندی	فندي
ئەقل	قل
ئەقلانە	قلان
ئەقلى	قلى
ئەقلیەتا	قليتا
ئەقلێ	قل
ئەقلێن	قلن
ئەقلە	قل
ئەلحەق	لحق
ئەلفەقیە	لفقي
ئەلوەسەت	لوثت
ئەلیزێ	ليذ
ئەلینا	لينا
ئەم	م
ئەمان	مان
ئەمانە	مان
ئەمجەد	مجد
ئەمرێ	مر
ئەمن	من
ئەمنا	منا
ئەمنى	منى
ئەمنی	مني
ئەمنیا	منيا
ئەمنیێن	منين
ئەمڕۆ	مرو
ئەمڕۆی	مروي
ئەمیر	مير
ئەمیرا	ميرا
ئەمیرێ	مير
ئەمێن	من
ئەمە	م
ئەمەش	مش
ئەمەل	مل
ئەنبار	نبار
ئەنتەر	نطر
ئەنجومەنێ	نجومن
ئەنجوومەنێ	نجومن
ئەندام	ندام
ئەندامێ	ندام
ئەندامێن	ندامن
ئەنزلی	نزلي
ئەنساری	نساري
ئەنفال	نفال
ئەنفالێ	نفال
ئەنفالە	نفال
ئەنقەرێ	نقر
ئەنقەرە	نقر
ئەنقەست	نقسط
ئەنمار	نمار
ئەنوەر	نور
ئەنەس	نص
ئەنەکەسێ	نكث
ئەنەکەسە	نكث
ئەنەکەسەیە	نكسي
ئەها	ها
ئەهل	هل
ئەهلی	هلي
ئەو	و
ئەوا	وا
ئەوانەی	واني
ئەور	ور
ئەورێن	ورن
ئەوسا	وصا
ئەوقاف	وقاف
ئەوقافێ	وقاف
ئەون	ون
ئەوی	وي
ئەوین	وين
ئەویێن	وين
ئەوێ	و
ئەوێن	ون
ئەوە	و
ئەوەش	وش
ئەوەی	وي
ئەوەیە	وي
ئەى	ى
ئەڤ	و
ئەڤا	وا
ئەڤجا	وجا
ئەڤجار	وجار
ئەڤر	ور
ئەڤرۆکە	وروك
ئەڤسالە	وصال
ئەڤی	وي
ئەڤین	وين
ئەڤینێ	وين
ئەڤێ	و
ئەڤێن	ون
ئەڤە	و
ئەڤەنە	ون
ئەڤەیە	وي
ئەکاد	كاد
ئەکبەر	كبر
ئەکتیف	كتيف
ئەکرەم	كرم
ئەی	ي
ئەیلونێ	يلون
ئەیلۆنێ	يلون
ئەیمەن	يمن
ئەینی	يني
ئەینیا	ينيا
ئەینیێ	يني
ا	آ
ابن	ابن
ابو	آبو
اعملوا	اعملوا
الله	الله
ان	آن
ب	ب
بئێخنە	بخن
باب	باب
بابا	بابا
بابێ	باب
بابە	باب
باتێل	باطل
باتێلێ	باطل
باج	باج
باجێ	باج
باجە	باج
بادى	بادى
بادی	بادي
بادینان	بادينان
بار	بار
بارا	بارا
بارزان	بارزان
بارن	بارن
بارکەن	باركن
باری	باري
باریت	باريت
بارین	بارين
بارینا	بارينا
بارینێ	بارين
بارینە	بارين
باریە	باري
بارێ	بار
بارێن	بارن
بارە	بار
بارەکێ	بارك
بازار	بازار
بازارێ	بازار
بازاڕێ	بازار
بازل	بازل
بازێ	باز
باس	باس
باسم	باسم
باسکێ	باسك
باسێ	باص
باش	باش
باشێ	باش
باشە	باش
باقر	باقر
باقی	باقي
بالا	بالا
بالێ	بال
بان	بان
بانی	باني
بانە	بان
باهز	باهظ
باهیێ	باهي
باکور	باكور
باکورێ	باكور
باکوور	باكور
باکوورێ	باكور
باکۆر	باكور
باکۆرێ	باكور
باڵا	بالا
بایدن	بايدن
بت	بت
بتنێ	بطن
بجێل	بجل
بخوت	بخوت
بخۆت	بخوت
بخەنە	بخن
بد	بد
بدت	بدت
بدن	بدن
بدێ	بد
بدە	بد
بدەت	بدت
بدەتن	بدتن
بدەتێ	بدت
بدەتە	بدت
بدەن	بدن
بدەنێ	بدن
بدەنە	بدن
بدەی	بدي
بدەین	بدين
بدەینێ	بدين
بدەینە	بدين
بدەیێ	بدي
بدەیە	بدي
بر	بر
برا	برا
برای	براي
برایێ	براي
برد	برد
برس	برص
برسى	برصى
برسێ	برص
برن	برن
برنا	برنا
برنە	برن
برهن	برهن
بروکسل	بروكسل
بروکسێلێ	بروكسل
برى	برى
بری	بري
بریا	بريا
بریت	بريت
بریتانی	بريطاني
بریتانیا	بريطانيا
برین	برين
برینا	برينا
برینێ	برين
برینە	برين
بریە	بري
برێت	برت
برێنس	برنس
برێکا	بركا
برێکارێ	بركار
برێکێن	بركن
برێیا	بريا
برە	بر
بزانە	بضان
بسەر	بسر
بسەرێ	بسر
بشێت	بشت
بشێن	بشن
بشێی	بشي
بلا	بلا
بلبل	بلبل
بلى	بلى
بلۆک	بلوك
بلی	بلي
بلێج	بلج
بم	بم
بن	بن
بنڤن	بنون
بنڤی	بنوي
بنی	بني
بنێ	بن
بنە	بن
بنەما	بنما
به	به
بها	بها
بهار	بهار
بهارێ	بهار
بهانە	بهان
بهاێ	بها
بهێت	بهت
بهێتە	بهت
بهێز	بهظ
بهێزن	بهظن
بهێزە	بهظ
بهێم	بهم
بهێمە	بهم
بهێن	بهن
بهێنێ	بهن
بهێنە	بهن
بهێین	بهين
بوار	بوار
بواری	بواري
بوارێ	بوار
بوتان	بوتان
بوری	بوري
بوریا	بوريا
بول	بول
بولا	بولا
بوم	بوم
بومە	بوم
بون	بون
بونا	بونا
بونە	بون
بوهایێ	بوهاي
بووری	بوري
بوورینا	بورينا
بووسە	بوس
بوول	بول
بووم	بوم
بوومە	بوم
بوون	بون
بوونا	بونا
بوونی	بوني
بوونێ	بون
بوونە	بون
بووکەر	بوكر
بڕین	برين
بڕینا	برينا
بڕیە	بري
بڕێ	بر
بڕەکا	بركا
بکت	بكت
بکرن	بكرن
بکرێت	بكرت
بکم	بكم
بکن	بكن
بکڕن	بكرن
بکی	بكي
بکە	بك
بکەت	بكت
بکەتە	بكت
بکەم	بكم
بکەمە	بكم
بکەن	بكن
بکەنێ	بكن
بکەنە	بكن
بکەى	بكى
بکەی	بكي
بکەیت	بكيت
بکەین	بكين
بکەینە	بكين
بکەیێ	بكي
بکەیە	بكي
بۆارێ	بوار
بۆتان	بوتان
بۆرن	بورن
بۆری	بوري
بۆریا	بوريا
بۆرین	بورين
بۆرینا	بورينا
بۆستا	بوسطا
بۆش	بوش
بۆل	بول
بۆلا	بولا
بۆلێ	بول
بۆمە	بوم
بۆنە	بون
بۆنەی	بوني
بۆهایێ	بوهاي
بی	بي
بیان	بيان
بیانوو	بيانو
بیانێ	بيان
بیت	بيت
بیتن	بيتن
بیتە	بيت
بیر	بير
بیرا	بيرا
بیرو	بيرو
بیروت	بيروت
بیرڤە	بيرو
بیرێ	بير
بیرە	بير
بیست	بيست
بیستێ	بيست
بیل	بيل
بین	بين
بینت	بينت
بینتە	بينت
بینن	بينن
بیننە	بينن
بینی	بيني
بینە	بين
بیێ	بي
بیە	بي
بێ	ب
بێت	بط
بێتە	بط
بێتەلێ	بطل
بێختە	بخت
بێخن	بخن
بێخنە	بخن
بێخە	بخ
بێدەرا	بدرا
بێرا	برا
بێرین	برين
بێریێن	برين
بێرێزی	برزي
بێرێن	برن
بێزار	بذار
بێل	بل
بێن	بن
بێنە	بن
بێهن	بهن
بێوار	بوار
بێواری	بواري
بێی	بي
بێینەوە	بينو
بە	ب
بەت	بط
بەتال	بطال
بەحرەین	بحرين
بەحرەینێ	بحرين
بەحس	بحث
بەحسا	بحثا
بەحسێ	بحث
بەخت	بخت
بەختێ	بخت
بەد	بد
بەدر	بدر
بەدەل	بدل
بەدەنا	بدنا
بەر	بر
بەرا	برا
بەراز	براز
بەرازیل	برازيل
بەرازیلی	برازيلي
بەرازیلێ	برازيل
بەران	بران
بەرتیل	برطيل
بەرد	برد
بەردا	بردا
بەردان	بردان
بەردانێ	بردان
بەردانە	بردان
بەردت	بردت
بەردێ	برد
بەردەت	بردت
بەردەن	بردن
بەردەی	بردي
بەرز	برز
بەرزە	برز
بەرزەیە	برزي
بەرسڤا	برصوا
بەرلین	برلين
بەرمیل	برميل
بەرهەمی	برهمي
بەرهەمێن	برهمن
بەرهەڤم	برهوم
بەروکێ	بروك
بەرى	برى
بەری	بري
بەریا	بريا
بەریتانی	بريطاني
بەریتانیا	بريطانيا
بەرین	برين
بەرێ	بر
بەرێز	برز
بەرێزان	برزان
بەرێزە	برز
بەرێن	برن
بەرە	بر
بەرەى	برى
بەرەکێ	برك
بەرەکەت	بركت
بەرەی	بري
بەرەیێ	بري
بەرەیێن	برين
بەس	بس
بەسامێ	بسام
بەستا	بسطا
بەستن	بسطن
بەستنا	بسطنا
بەستنێ	بسطن
بەستی	بسطي
بەسرا	بصرا
بەسرە	بسر
بەسێ	بس
بەسە	بس
بەسەر	بسر
بەش	بش
بەشی	بشي
بەشیر	بشير
بەشێ	بش
بەشێن	بشن
بەشە	بش
بەعس	بعث
بەعسا	بعثا
بەغداد	بغداد
بەلا	بلا
بەلجیکا	بلجيكا
بەلی	بلي
بەلێ	بل
بەم	بم
بەن	بن
بەنج	بنج
بەنجا	بنجا
بەنجێ	بنج
بەند	بند
بەندێ	بند
بەندە	بند
بەندەر	بندر
بەندەرێ	بندر
بەنکێ	بنك
بەنی	بني
بەنە	بن
بەهار	بهار
بەهارێ	بهار
بەهانە	بهان
بەهر	بهر
بەهرا	بهرا
بەهرام	بهرام
بەهرە	بهر
بەهى	بهى
بەهیا	بهيا
بەهێز	بهظ
بەوەش	بوش
بەڕێز	برز
بەڕێزان	برزان
بەکتریا	بكتريا
بەکر	بكر
بەکری	بكري
بەیانێ	بيان
بەیتا	بيتا
بەیتێ	بيت
بەیتە	بيت
بەین	بين
بەینە	بين
ت	ت
تا	تا
تابووت	تابوت
تابووتێ	تابوت
تاجر	تاجر
تاخێ	تآخ
تاخێن	تآخن
تارق	طارق
تاری	طاري
تاریێ	طاري
تاعەت	طاعت
تال	طال
تام	تام
تانک	تانك
تانکێ	تانك
تاها	تاها
تاهر	طاهر
تایبەت	طايبت
تایبەتا	طايبتا
تایبەتن	طايبتن
تایبەتێ	طايبت
تایبەتە	طايبت
تایوان	تايوان
تایوانی	تايواني
تایوانێ	تايوان
تبلێن	طبلن
تر	تر
ترس	ترس
ترسا	ترسا
ترسن	ترسن
ترسى	ترسى
ترسیان	ترصيان
ترسێ	ترس
ترسە	ترس
ترم	ترم
ترن	ترن
ترک	ترك
ترکى	تركى
ترکیا	تركيا
تری	طري
تریش	تريش
ترین	ترين
تریێ	طري
ترێنا	ترنا
ترەس	ترس
تزبح	تذبح
تشت	تشت
تشتا	تشتا
تشتان	تشتان
تشتى	تشتى
تشتی	تشتي
تشتێ	تشت
تشتێن	تشتن
تشتە	تشت
تشتەک	تشتك
تشتەکى	تشتكى
تشتەکی	تشتكي
تشتەکێ	تشتك
تشتەکە	تشتك
تشێ	طش
تل	تل
تلیلی	تليلي
تلێن	طلن
تم	تم
تمام	تمام
تنی	طني
تنێ	تن
تنێبونێ	تنبون
تنێبوونێ	تنبون
تو	تو
توبا	توبا
تور	تور
تورا	طورا
توران	طوران
تورک	تورك
تورکا	توركا
تورکان	توركان
تورکن	توركن
تورکی	توركي
تورکیێ	توركي
تورکێن	توركن
توری	طوري
تورێن	طورن
تورە	طور
تورەیە	طوري
توشى	توشى
توشی	توشي
توفیق	توفيق
تون	تون
تونسێ	تونس
توهمەتا	توهمتا
توورە	طور
تووش	توش
تووشى	توشى
تووشی	توشي
تووشێ	توش
توڕا	طورا
توڕێن	طورن
توی	طوي
تویتا	طويتا
تڕانە	طران
تڕسا	طرسا
تڤر	طور
تکێتا	تكتا
تۆ	تو
تۆخمێن	توخمن
تۆرا	طورا
تۆران	طوران
تۆرێ	طور
تۆرێن	طورن
تۆرە	طور
تۆز	توذ
تۆزێ	توذ
تۆش	توش
تۆشى	توشى
تۆشی	توشي
تۆل	طول
تۆلا	طولا
تۆماس	توماس
تۆڕا	طورا
تۆڕێن	طورن
تۆڕە	طور
تی	تي
تیم	تيم
تیما	تيما
تیمان	تيمان
تیمێ	تيم
تیمێن	تيمن
تین	تين
تیۆر	طيور
تیۆرێ	طيور
تیۆرە	طيور
تێ	ت
تێبکەون	تبكون
تێبینی	تبيني
تێجۆی	تجوي
تێجۆیێ	تجوي
تێدا	تدا
تێدانە	تدان
تێر	طر
تێرا	طرا
تێزا	تذآ
تێزی	تزي
تێست	طست
تێسلا	تصلا
تێشتێ	تشت
تێلی	طلي
تێلێن	طلن
تێلەفزیۆن	تلفزيون
تێلەفۆنێ	تلفون
تێمێن	تمن
تێن	تن
تێنتیێ	تنتي
تێنسا	تنصا
تێنشیر	تنشير
تێنە	تن
تێهنا	تهنا
تێهنی	تهني
تێهنیێ	تهني
تێهنێ	تهن
تێکبدەن	تكبدن
تێکدا	تكدا
تێکدان	تكدان
تێکدەرانە	تكدران
تێکساس	تكساس
تێکستا	تكستا
تێکستێ	تكست
تێکهەل	تكهل
تێکهەلی	تكهلي
تێکهەلە	تكهل
تێکڕا	تكرا
تێکەل	تكل
تێکەلى	تكلى
تێکەلی	تكلي
تە	ت
تەباخێ	طباخ
تەبیت	تبيت
تەتەر	تتر
تەحریر	تحرير
تەحسین	تحسين
تەحل	طحل
تەخ	تخ
تەخت	تخت
تەختان	تخطان
تەختی	تخطي
تەختێ	تخت
تەخمین	تخمين
تەخوین	تخوين
تەخێن	تخن
تەدا	تدا
تەر	طر
تەرخان	ترخان
تەرزێ	طرز
تەرش	طرش
تەرم	ترم
تەرمین	ترمين
تەرمێ	ترم
تەرمێن	ترمن
تەزویر	تزوير
تەسلیم	تسليم
تەسنیم	تسنيم
تەسەل	تصل
تەشەمع	تشمع
تەشەمعێ	تشمع
تەعلو	تعلو
تەقدیرێ	تقدير
تەقین	تقين
تەقینا	تقينا
تەقینێ	تقين
تەقە	طق
تەقەمەنی	تقمني
تەقەمەنیێن	تقمنين
تەقەیا	تقيآ
تەلعەت	طلعت
تەلییف	تلييف
تەلییفێ	تلييف
تەلیێن	تلين
تەلەبە	طلب
تەلەفزیۆن	تلفزيون
تەلەفۆنێ	تلفون
تەلەییف	تلييف
تەلەییفێ	تلييف
تەماتان	تماتان
تەماشە	تماش
تەماشەى	تماشى
تەماشەی	تماشي
تەمام	تمام
تەموزێ	تموز
تەمیم	تميم
تەمەتى	تمطى
تەمەر	طمر
تەمەن	تمن
تەمەنی	تمني
تەمەنێ	تمن
تەن	تن
تەنا	طنا
تەنان	طنان
تەنانە	طنان
تەناهی	تناهي
تەناهیێ	تناهي
تەناکرن	تناكرن
تەنسا	تنصا
تەنی	طني
تەنیا	تنيا
تەنێ	تن
تەنێن	طنن
تەنەکێ	تنك
تەها	طها
تەهران	طهران
تەهرانێ	طهران
تەوار	طوار
تەوافق	توافق
تەوافێ	طواف
تەوافێن	توافن
تەوفیق	توفيق
تەوفیقە	توفيق
تەوەر	طور
تەوەران	طوران
تەوەرێ	طور
تەوەرێن	طورن
تەوەرەکێ	تورك
تەوەرەکێن	توركن
تەڕ	طر
تەڤ	تو
تەڤاهی	طواهي
تەڤایا	طوايا
تەڤلى	طولى
تەڤلی	تولي
تەڤن	تون
تەڤنێ	تون
تەڤە	تو
تەکست	تكست
تەکسی	تكسي
تەکسیێ	تكسي
تەکنولوجیا	تكنولوجيا
تەکنۆلۆجی	تكنولوجي
تەکنۆلۆجیا	تكنولوجيا
تەکنیکی	تكنيكي
تەکەز	تكز
تەکەزی	تكزي
تەکەزیێ	تكزي
تەکەست	تكست
تەیار	تيار
تەیب	طيب
تەیبی	طيبي
تەیران	طيران
تەیف	طيف
تەیێ	تي
تەیە	تي
ج	ج
جابر	جابر
جادا	جادا
جادێ	جاد
جادە	جاد
جار	جار
جارا	جارا
جاران	جاران
جارى	جارى
جاری	جاري
جارێ	جار
جارێن	جارن
جارە	جار
جاسم	جاسم
جاش	جاش
جاف	جاف
جاما	جاما
جامێرە	جامر
جان	جان
جانێ	جان
جانێن	جانن
جاک	جاك
جبور	جبور
جددی	جددي
جدعە	جدع
جدی	جدي
جزر	جزر
جل	جل
جلال	جلال
جمال	جمال
جمیل	جميل
جندی	جندي
جه	جه
جها	جها
جهان	جهان
جهی	جهي
جهێ	جه
جهێن	جهن
جهە	جه
جو	جو
جوان	جوان
جوانی	جواني
جوانیێ	جواني
جوانێ	جوان
جوانە	جوان
جود	جود
جودا	جودا
جودانە	جودان
جودی	جودي
جور	جور
جورئەت	جورت
جورا	جورا
جورێ	جور
جورێن	جورن
جورە	جور
جوقی	جوقي
جومعە	جومع
جون	جون
جوودا	جوودا
جڤین	جوين
جڤینا	جوينا
جڤینێ	جوين
جۆ	جو
جۆدا	جودا
جۆدی	جودي
جۆر	جور
جۆرا	جورا
جۆران	جوران
جۆرج	جورج
جۆرجیا	جورجيا
جۆرن	جورن
جۆری	جوري
جۆرێ	جور
جۆرێن	جورن
جۆرە	جور
جۆش	جوش
جۆقی	جوقي
جۆن	جون
جۆڕێ	جور
جیران	جيران
جیرانێ	جيران
جیم	جيم
جیمس	جيمس
جیهان	جيهان
جیهانێ	جيهان
جیۆلۆجی	جيولوجي
جێ	ج
جێبە	جب
جێرمان	جرمان
جێمز	جمز
جێنین	جنين
جە	ج
جەبار	جبار
جەددە	جدد
جەزا	جزا
جەزائر	جزار
جەستە	جصت
جەسەد	جسد
جەسەدا	جسدا
جەسەدێ	جسد
جەعفەر	جعفر
جەعفەری	جعفري
جەلال	جلال
جەلالە	جلال
جەلتا	جلطا
جەلتێ	جلط
جەلتێن	جلطن
جەلتە	جلط
جەلیل	جليل
جەم	جم
جەماعی	جماعي
جەمال	جمال
جەمیل	جميل
جەمێ	جم
جەنابێ	جناب
جەنازێ	جناز
جەنان	جنان
جەنەرال	جنرال
جەواد	جواد
جەوهەر	جوهر
جەوهەرێ	جوهر
جەویە	جوي
جەیش	جيش
جەیهان	جيهان
حاج	حاج
حاجى	حاجى
حاجی	حاجي
حازر	حازر
حازری	حاضري
حازم	حازم
حاشا	حاشا
حافز	حافز
حال	حال
حالی	حالي
حالێ	حال
حالە	حال
حالەت	حالت
حالەتا	حالتا
حالەتێ	حالت
حالەتە	حالت
حامد	حامد
حاکم	حاكم
حاکمێن	حاكمن
حبرێ	حبر
حدود	حدود
حدوود	حدود
حرف	حرف
حزب	حزب
حزبا	حزبا
حزبان	حزبان
حزبن	حزبن
حزبی	حزبي
حزبێ	حزب
حزبێن	حزبن
حزبە	حزب
حزوری	حضوري
حساب	حساب
حسابێ	حساب
حسن	حسن
حسنا	حسنا
حسۆ	حسو
حسین	حصين
حسێن	حصن
حسێنی	حصني
حوسێن	حوسن
حووت	حوت
حوکم	حوكم
حوکمێ	حوكم
حوکمەت	حوكمت
حوکمەتا	حوكمتا
حوکمەتێ	حوكمت
حوکمەتێن	حوكمتن
حوکەتا	حوكتا
حکمەت	حكمت
حکومی	حكومي
حکوومی	حكومي
حکیم	حكيم
حۆکمەت	حوكمت
حۆکمەتا	حوكمتا
حیدر	حيدر
حەب	حب
حەبیب	حبيب
حەبێن	حبن
حەتا	حطا
حەج	حج
حەجی	حجي
حەجیا	حجيا
حەجیێ	حجي
حەجیێن	حجين
حەجێ	حج
حەرام	حرام
حەرامە	حرام
حەردان	حردان
حەریری	حريري
حەز	حظ
حەزا	حظا
حەزرەتێ	حذرت
حەزو	حذو
حەزێن	حضن
حەسن	حصن
حەسۆ	حسو
حەسەن	حصن
حەسەنی	حصني
حەسەکێ	حسك
حەشد	حشد
حەشدا	حشدا
حەشدێ	حشد
حەشدە	حشد
حەفازە	حفاض
حەفت	حفت
حەفتا	حفتا
حەفتێ	حفت
حەق	حق
حەقیێ	حقي
حەلالە	حلال
حەلەبێ	حلب
حەماس	حماس
حەمامی	حمامي
حەمدی	حمدي
حەمزە	حمض
حەمۆ	حمو
حەمید	حميد
حەمە	حم
حەمەد	حمد
حەمەی	حمي
حەنا	حنا
حەنان	حنان
حەوکەمە	حوكم
حەویان	حويان
حەکیم	حكيم
حەیدەر	حيدر
حەیران	حيران
حەیفا	حيفا
خ	خ
خاتر	خاتر
خاترا	خاطرا
خار	خار
خارێ	خار
خازر	خازر
خال	خال
خالا	خالا
خالد	خالد
خالێ	خال
خالە	خال
خام	خام
خان	خان
خانا	خانا
خانێ	خان
خانە	خان
خدر	خدر
خدرێ	خدر
خراب	خراب
خرابە	خراب
خرش	خرش
خزم	خضم
خزمەت	خضمت
خزمەتا	خضمتا
خزمەتێ	خضمت
خزمەتێن	خضمتن
خزینا	خزينا
خستن	خستن
خستنە	خستن
خستە	خست
خشتێ	خشت
خشتە	خشت
خلاس	خلاس
خلیل	خليل
خو	خو
خوار	خوار
خوارێ	خوار
خواز	خواض
خوازن	خوازن
خوان	خوان
خورت	خورت
خورشید	خورشيد
خول	خول
خولا	خولا
خولان	خولان
خولێ	خول
خولێن	خولن
خوون	خون
خوونا	خونا
خوى	خوى
خویا	خويا
خوین	خوين
خوینا	خوينا
خوینێ	خوين
خوینە	خوين
خویێ	خوي
خویە	خوي
خوێ	خو
خوێن	خون
خوێنی	خوني
خوێیا	خويا
خوە	خو
خوەزی	خوضي
خوەنە	خون
خوەیا	خويا
خوەیێ	خوي
خوەیێن	خوين
خوەیە	خوي
خوەە	خو
خۆ	خو
خۆت	خوت
خۆرشید	خورشيد
خۆسەر	خوصر
خۆل	خول
خۆلا	خولا
خۆلێ	خول
خۆلێن	خولن
خۆنە	خون
خۆی	خوي
خۆیا	خويا
خۆیان	خويان
خۆینێ	خوين
خۆیێ	خوي
خۆیە	خوي
خۆە	خو
خیار	خيار
خیال	خيال
خیڤەتێ	خيوط
خێر	خر
خێرا	خرا
خێرات	خراط
خێری	خري
خێرێ	خر
خێرە	خر
خێزان	خزان
خێزانێ	خزان
خێلان	خلان
خە	خ
خەبات	خباط
خەباتێ	خباط
خەباتە	خباط
خەبەران	خبران
خەبەری	خبري
خەت	خط
خەتا	خطا
خەرج	خرج
خەرجی	خرجي
خەزان	خزان
خەزمەتا	خضمتا
خەزیرێ	خزير
خەست	خست
خەسلەتێ	خصلت
خەسلەتێن	خصلتن
خەل	خل
خەلات	خلاط
خەلاتێ	خلاط
خەلاتە	خلاط
خەلق	خلق
خەلۆ	خلو
خەلیفێ	خليف
خەلیفە	خليف
خەلیل	خليل
خەلیلێ	خليل
خەلیێن	خلين
خەلەت	خلط
خەلەتی	خلطي
خەلەتە	خلط
خەلەف	خلف
خەم	خم
خەما	خما
خەمل	خمل
خەملا	خملا
خەمی	خمي
خەمیس	خميس
خەمێ	خم
خەمێن	خمن
خەمە	خم
خەنجەر	خنجر
خەندقی	خندقي
خەندقیە	خندقي
خەو	خو
خەوا	خوا
خەون	خون
خەونا	خونا
خەونان	خونان
خەونی	خوني
خەونێ	خون
خەونێن	خونن
خەونە	خون
خەوێ	خو
خەیال	خيال
خەیالێ	خيال
خەیری	خيري
د	د
دئاستێ	داست
دئینا	دينا
دئینان	دينان
دئینت	دينت
دئینن	دينن
دئیننە	دينن
دئێخن	دخن
دئێخنە	دخن
دئێن	دن
دئێنە	دن
دئێک	دك
دئەڤ	دو
دئەڤی	دوي
دا	دآ
داب	داب
دابران	دابران
دابرنا	دابرنا
داد	داد
دادی	دادي
دادێ	داد
دادەتێ	دادت
دار	دار
دارا	دارا
داری	داري
داریا	داريا
داریان	داريان
دارین	دارين
دارێ	دار
دارێن	دارن
دارەکێ	دارك
دام	دام
دامە	دام
دان	دان
دانا	دانا
دانن	دانن
دانى	دانى
دانی	داني
دانیال	دانيال
دانیت	دانيت
دانیتە	دانيت
دانین	دانين
دانینە	دانين
دانێ	دان
دانێنە	دانن
دانە	دان
داهێنان	داهنان
داهێنانێ	داهنان
داو	داو
داود	داود
داوود	داوود
داوى	داوى
داوی	داوي
داویا	داويا
داویێ	داوي
داوە	داو
داوەت	داوت
داوەتا	داوتا
داوەتێ	داوت
داڤ	داو
داڤێن	داون
داڤە	داو
داکەت	داكت
داین	داين
داینە	داين
دبت	دبت
دبتە	دبت
دبلوماسی	دبلوماسي
دبلۆماسی	دبلوماسي
دبن	دبن
دبنێ	دبن
دبنە	دبن
دبی	دبي
دبێ	دب
دبە	دب
دبەت	دبت
دبەتە	دبت
دبەر	دبر
دبەن	دبن
دبەنە	دبن
دجەنان	دجنان
دخون	دخون
ددن	ددن
ددەت	ددت
ددەتە	ددت
ددەن	ددن
ددەنە	ددن
دراما	دراما
دربێن	دربن
درست	درست
درین	درين
درێ	در
درێسێ	درس
درێیا	دريا
درەوا	دروا
دستوری	دستوري
دستوور	دستور
دستووری	دستوري
دستوورێ	دستور
دشێ	دش
دشێت	دشت
دشێن	دشن
دشێی	دشي
دفن	دفن
دفنا	دفنا
دفنێ	دفن
دل	دل
دلان	دلان
دلى	دلى
دلۆ	دلو
دلی	دلي
دلێ	دل
دلێن	دلن
دلە	دل
دمرن	دمرن
دن	دن
دنانێ	دنان
دنڤن	دنون
دنڤە	دنو
دنیا	دنيا
دنێڤ	دنو
دهی	دهي
دهیتە	دهيت
دهێت	دهت
دهێتە	دهت
دهێمە	دهم
دهێن	دهن
دهێنە	دهن
دهەر	دهر
دهەمان	دهمان
دو	دو
دوئالی	دوالي
دوا	دوا
دوارێ	دوار
دور	دور
دورا	دورا
دورتموند	دورتموند
دورست	دورست
دورێن	دورن
دوست	دوست
دوستێن	دوستن
دوسیە	دوسي
دولار	دولار
دولەتا	دولتا
دونیا	دونيا
دونەم	دونم
دوهن	دوهن
دوهنێ	دوهن
دوهنە	دوهن
دوهی	دوهي
دوو	دو
دوور	دوور
دوورن	دوورن
دووری	دوري
دووریا	دوريا
دوورە	دور
دووف	دوف
دووم	دووم
دووی	دوي
دوویێ	دوي
دووێ	دو
دووێن	دون
دووەم	دوم
دووەمی	دومي
دوکان	دوكان
دوی	دوي
دویان	دويان
دویت	دويت
دویێ	دوي
دوێ	دو
دڤى	دوى
دڤی	دوي
دڤیا	دويا
دڤیان	دويان
دڤیت	دويت
دڤێ	دو
دڤێت	دوت
دڤێن	دون
دکت	دكت
دکتاتۆر	دكتاتور
دکتاتۆرە	دكتاتور
دکتور	دكتور
دکتورە	دكتور
دکتۆر	دكتور
دکتۆرە	دكتور
دکن	دكن
دکی	دكي
دکە	دك
دکەت	دكت
دکەتن	دكتن
دکەتێ	دكت
دکەتە	دكت
دکەن	دكن
دکەنە	دكن
دکەی	دكي
دڵ	دل
دڵەوە	دلو
دۆخی	دوخي
دۆخە	دوخ
دۆر	دور
دۆرا	دورا
دۆران	دوران
دۆرێن	دورن
دۆست	دوست
دۆستا	دوستا
دۆستێ	دوست
دۆستێن	دوستن
دۆسیێ	دوسي
دۆل	دول
دۆلا	دولا
دۆلار	دولار
دۆلارێ	دولار
دۆم	دوم
دی	دي
دیا	ديا
دیار	ديار
دیارێ	ديار
دیارە	ديار
دیبلۆماسی	ديبلوماسي
دید	ديد
دیدێ	ديد
دیر	دير
دیسا	ديثا
دیسان	ديصان
دیف	ديف
دیل	ديل
دین	دين
دینار	دينار
دینارێ	دينار
دینارە	دينار
دینامو	دينامو
دینامۆ	دينامو
دینی	ديني
دینێ	دين
دینە	دين
دیوان	ديوان
دیوانێ	ديوان
دیوانە	ديوان
دیکتاتۆر	ديكتاتور
دیکور	ديكور
دیکە	ديك
دیێ	دي
دیێن	دين
دیە	دي
دێ	د
دێر	در
دێران	دران
دێربیێ	دربي
دێرکی	دركي
دێرکێ	درك
دێرین	درين
دێرینا	درينا
دێرینێ	درين
دێل	دل
دێم	دم
دێمی	دمي
دێمێ	دم
دێوالی	دوالي
دێەباح	دباح
دە	د
دەبن	دبن
دەبنە	دبن
دەبێ	دب
دەبێت	دبت
دەبێتە	دبت
دەبەت	دبت
دەخیل	دخيل
دەر	در
دەرباس	درباس
دەردور	دردور
دەردۆر	دردور
دەردۆرێ	دردور
دەرز	درز
دەرزی	درزي
دەرزێن	درزن
دەرس	درس
دەرسا	درسا
دەرمان	درمان
دەرمانێ	درمان
دەرمانە	درمان
دەرهەم	درهم
دەروێش	دروش
دەروێشی	دروشي
دەروێشێ	دروش
دەروێشێن	دروشن
دەرکەت	دركت
دەرکەتن	دركتن
دەرکەتنێ	دركتن
دەریا	دريا
دەریێن	درين
دەرێ	در
دەرەکی	دركي
دەست	دست
دەستا	دستا
دەستن	دستن
دەستور	دستور
دەستوری	دستوري
دەستوور	دستور
دەستووری	دستوري
دەستوورێ	دستور
دەستێ	دست
دەستێن	دستن
دەستە	دست
دەشت	دشت
دەشتا	دشتا
دەشێ	دش
دەعوە	دعو
دەف	دف
دەقی	دقي
دەقێ	دق
دەقێن	دقن
دەلال	دلال
دەم	دم
دەما	دما
دەمان	دمان
دەمى	دمى
دەمی	دمي
دەمێ	دم
دەمێن	دمن
دەمە	دم
دەن	دن
دەنێ	دن
دەنە	دن
دەه	ده
دەهان	دهان
دەهمەنا	دهمنا
دەهی	دهي
دەهێ	ده
دەوار	دوار
دەوام	دوام
دەوامێ	دوام
دەور	دور
دەوران	دوران
دەولەت	دولت
دەولەتا	دولتا
دەولەتێ	دولت
دەولەتێن	دولتن
دەولەتە	دولت
دەوڵەت	دولت
دەوێت	دوت
دەڕوا	دروا
دەڤ	دو
دەڤا	دوا
دەڤی	دوي
دەڤێ	دو
دەڤێن	دون
دەڤەر	دور
دەڤەرا	دورا
دەڤەران	دوران
دەڤەرانە	دوران
دەڤەری	دوري
دەڤەرین	دورين
دەڤەرێ	دور
دەڤەرێن	دورن
دەڤەرە	دور
دەڤەرەکا	دوركا
دەڤەرەکێ	دورك
دەڤەرەکێن	دوركن
دەکەن	دكن
دەڵێ	دل
دەڵێت	دلت
دەڵێن	دلن
دەیان	ديان
دەیلی	ديلي
دەین	دين
دەینێ	دين
دەینە	دين
دەیک	ديك
دەیکا	ديكا
دەیکێ	ديك
دەیە	دي
دەە	د
ر	ر
را	رآ
رابن	رابن
رابیت	رابيت
رابین	رابين
رادیۆ	راديو
رادێ	راد
رادە	راد
رادەی	رادي
رازى	راضى
رازی	راضي
رازینە	راضين
رازیێ	راضي
راست	راست
راستا	راستا
راستێ	راست
راستە	راست
راسل	راسل
رافع	رافع
رانیا	رانيا
راهێنان	راهنان
راهێنانێ	راهنان
راکەن	راكن
رحا	رحا
ردا	ردا
ردە	رد
رزقێ	رزق
رستن	رستن
رشید	رشيد
رفعەت	رفعت
رفعەتێ	رفعت
رماد	رماد
رنا	رنا
رها	رها
رهێن	رهن
رو	رو
روبرت	روبرت
روبین	روبين
روح	روح
روحا	روحا
روحی	روحي
روسی	روسي
روسیا	روسيا
رولێ	رول
روما	روما
رومان	رومان
رومانی	روماني
رومەت	رومت
رون	رون
رونالدو	رونالدو
روهن	روهن
روو	رو
رووب	روب
روودا	روودا
روودان	رودان
روودانێ	رودان
روودانە	رودان
رووددەت	روددت
رووددەن	روددن
روودەت	رودت
رووسی	روسي
رووسیا	روسيا
روون	رون
رووى	روى
رووی	روي
روویێ	روي
روویێن	روين
روى	روى
روی	روي
روین	روين
رویێ	روي
رویێن	روين
رکو	ركو
رۆتین	روتين
رۆتینێ	روتين
رۆحا	روحا
رۆحی	روحي
رۆزە	روض
رۆسی	روسي
رۆسیا	روسيا
رۆل	رول
رۆلا	رولا
رۆلێ	رول
رۆلێن	رولن
رۆما	روما
رۆمان	رومان
رۆمانسی	رومانسي
رۆمانی	روماني
رۆمانێ	رومان
رۆمی	رومي
رۆن	رون
رۆنالدۆ	رونالدو
رۆهن	روهن
رۆڵ	رول
رۆڵی	رولي
ری	ري
ریال	ريال
ریب	ريب
ریێا	ريا
ریێن	رين
رێ	ر
رێا	رآ
رێباز	رباض
رێبازێ	رباض
رێبازە	رباض
رێخستن	رخصتن
رێز	رز
رێزا	رضا
رێزان	رزان
رێزو	رضو
رێزى	رضى
رێزێ	رز
رێزێن	رزن
رێشتن	رشتن
رێنما	رنما
رێڤە	رو
رێک	رك
رێکا	ركا
رێکان	ركان
رێکێ	رك
رێکێن	ركن
رێکە	رك
رێکەوت	ركوت
رێکەوتن	ركوتن
رێکەڤتن	ركوتن
رێکەڤتنێ	ركوتن
رێکەکا	رككا
رێکەکێ	ركك
رێی	ري
رێیا	ريا
رێیان	ريان
رێیێ	ري
رێیێن	رين
رێیە	ري
رە	ر
رەئیا	ريا
رەئیسی	ريثي
رەبیع	ربيع
رەبیعە	ربيع
رەت	رت
رەجەب	رجب
رەحمان	رحمان
رەحمێ	رحم
رەحیم	رحيم
رەحیمە	رحيم
رەخ	رخ
رەخنێ	رخن
رەخنە	رخن
رەخڤە	رخو
رەخێ	رخ
رەخێن	رخن
رەد	رد
رەز	رز
رەزا	رضا
رەزی	رضي
رەزێ	رز
رەزێن	رزن
رەسمی	رسمي
رەسمێن	رثمن
رەسول	رسول
رەسوول	رسول
رەسوولی	رسولي
رەسۆل	رسول
رەسەن	رسن
رەسەنێ	رسن
رەسەنە	رسن
رەش	رش
رەشا	رشا
رەشاش	رشاش
رەشان	رشان
رەشى	رشى
رەشی	رشي
رەشید	رشيد
رەشێ	رش
رەق	رق
رەقا	رقا
رەققە	رقق
رەقیب	رقيب
رەمزی	رمزي
رەمەزان	رمضان
رەمەزانێ	رمضان
رەنا	رنا
رەنینێ	رنين
رەها	رها
رەهینە	رهين
رەهێل	رهل
رەهێن	رهن
رەوا	روا
رەوایا	روايا
رەوت	روت
رەوتا	روتا
رەوتێ	روت
رەوتە	روت
رەوش	روش
رەوشا	روشا
رەوشی	روشي
رەوشێ	روش
رەوشێن	روشن
رەوشە	روش
رەوشەن	روشن
رەڤا	روا
رەڤن	رون
رەڤی	روي
رەڤیت	رويت
رەڤین	روين
رەڤینا	روينا
رەڤینان	روينان
رەڤینێ	روين
رەڤێ	رو
رەیان	ريان
ز	ز
زات	ذات
زاتی	ذاتي
زاتێ	ذات
زاد	زاد
زادە	ضاد
زارێ	ضار
زال	زال
زالمان	ظالمان
زالە	ذال
زامی	ذامي
زان	زان
زانا	زانا
زانی	زاني
زانیە	زاني
زاهر	زاهر
زاڵ	ذال
زاڵە	ذال
زاید	زايد
زمار	زمار
زمان	زمان
زمانێ	زمان
زمانە	زمان
زمزم	زمزم
زنار	زنار
زنک	ضنك
زور	زور
زورا	زورا
زوری	زوري
زورێ	زور
زولم	ظولم
زولما	ظولما
زولمێ	ظولم
زوهێر	ظوهر
زوو	ذو
زوور	زور
زوورا	زورا
زووی	ذوي
زوى	زوى
زوڵم	ظولم
زوی	ذوي
زڕینا	ذرينا
زڤر	زور
زڤرنە	زورن
زڤری	زوري
زڤڕ	زور
زڤڕی	زوري
زکری	ذكري
زکی	ذكي
زکێ	زك
زۆر	زور
زۆرا	زورا
زۆرن	زورن
زۆری	زوري
زۆریێ	زوري
زۆرێ	زور
زۆرە	زور
زۆلم	ظولم
زۆهێر	ظوهر
زی	ذي
زیاد	زياد
زیان	ذيان
زیانێ	ذيان
زیانە	ذيان
زیاێ	زيا
زیبان	ذيبان
زیز	زيز
زیق	زيق
زینێ	ذين
زێ	ذ
زێبار	ذبار
زێدان	ضدان
زێدە	ضد
زێدەیە	ضدي
زێر	زر
زێرى	ذرى
زێری	ضري
زێرین	ذرين
زێرینە	ذرين
زێمار	ذمار
زێندی	زندي
زێوێ	ذو
زێوە	ذو
زێڕی	ضري
زێڕین	ذرين
زەحمەت	زحمت
زەحمەتا	زحمتا
زەحمەتێ	زحمت
زەحمەتە	زحمت
زەر	زر
زەری	ضري
زەریف	ذريف
زەرەر	ضرر
زەرەرا	ضررا
زەفت	زفت
زەق	زق
زەلال	زلال
زەلالی	زلالي
زەلالە	زلال
زەلام	ظلام
زەلامێ	ظلام
زەمان	زمان
زەمانێ	زمان
زەمین	ضمين
زەمینێ	ضمين
زەمینە	ضمين
زەمەن	ضمن
زەمەنى	ضمنى
زەنون	ظنون
زەهرا	زهرا
زەهەب	ذهب
زەورا	زورا
زەوقێ	ذوق
زەوى	ذوى
زەوی	ذوي
زەڤی	ذوي
زەڤیا	ضويا
زەڤیێن	ضوين
زەکی	ذكي
زەکەریا	زكريا
زەڵامێ	ظلام
زەیت	ذيت
زەیتا	زيتا
زەیتی	زيتي
زەیتێن	زيتن
زەید	زيد
زەینەب	زينب
س	س
سابت	سابت
سابر	سابر
سابوونێ	صابون
سابۆنێ	صابون
ساخ	ساخ
ساختە	ساخط
ساخی	ساخي
ساخە	ساخ
سادق	صادق
سادە	صاد
سادەیە	سادي
سار	سار
ساعە	صاع
ساف	صاف
سال	سال
سالا	سالا
سالح	صالح
سالحی	صالحي
سالم	سالم
سالی	صالي
سالیێ	صالي
سالێ	سال
سالە	سال
سالەک	سالك
سالەکێ	سالك
سالەکە	سالك
سامى	سامى
سامی	سامي
سامەرا	سامرا
سان	سان
ساهى	ساهى
ساهی	ساهي
ساڕ	صار
ساڵ	سال
ساڵا	صالا
ساڵح	صالح
ساڵی	صالي
ساڵیێ	صالي
ساڵێ	سال
ساڵێک	سالك
ساڵە	سال
ساڵەکێ	سالك
ساڵەی	صالي
ست	ست
ستار	ستار
ستران	سطران
سترانێ	سطران
سترانە	سطران
ستونا	سطونا
ستوونا	سطونا
ستۆنا	سطونا
ستۆکهۆلمێ	ستوكهولم
ستی	سطي
ستێر	ستر
ستێرا	سطرا
ستێران	سطران
ستێرێ	ستر
ستێرێن	سطرن
ستێرە	ستر
سحارێ	سحار
سحرا	سحرا
سدقی	صدقي
سربیا	صربيا
سرۆد	صرود
سریان	سريان
سست	سست
سعود	سعود
سعودی	سعودي
سعودیێ	سعودي
سعودیە	سعودي
سعودێ	سعود
سعوودی	سعودي
سعوودیێ	سعودي
سعوودیە	سعودي
سعۆدی	سعودي
سعید	صعيد
سفر	سفر
سفران	سفران
سفرێ	سفر
سفرەی	سفري
سلاف	سلاف
سلبی	سلبي
سلک	سلك
سلۆ	سلو
سلێمان	ثلمان
سلێمانێ	ثلمان
سلە	سل
سمو	سمو
سمۆ	سمو
سنج	سنج
سندانێ	سندان
سندۆقێ	صندوق
سندی	سندي
سنور	سنور
سنورێ	سنور
سنوور	سنور
سنوورێ	سنور
سنوونێ	سنون
سنۆر	سنور
سنۆرێ	سنور
سنە	سن
سواری	صواري
سواریێ	صواري
سوبە	ثوب
سوتن	سوطن
سوتنا	سوطنا
سوتنێ	سوطن
سوتی	سوطي
سوحبەت	صوحبت
سود	سود
سودان	سودان
سودانی	سوداني
سودانیە	سوداني
سور	سور
سوران	سوران
سوریا	سوريا
سوریێ	سوري
سورە	ثور
سورەت	صورت
سوعبەتێ	صوعبت
سومالێ	صومال
سونان	صونان
سوننە	صونن
سونی	صوني
سونە	صون
سوودانی	سوداني
سوور	سوور
سووری	سوري
سووریا	سوريا
سووریێ	سوري
سووریە	سوري
سووندا	سوندا
سوونە	صون
سووەر	ثور
سوید	سويد
سویدێ	سويد
سویسرا	سويسرا
سویک	سويك
سوێدی	سودي
سوێدێ	سود
سڕ	سر
سڤک	سوك
سڤکە	سوك
سڤیل	سويل
سڤیلن	سويلن
سڤیلێ	سويل
سڤیلە	سويل
سکران	سكران
سکرێ	سكر
سکرێن	سكرن
سڵێمان	ثلمان
سۆتن	سوطن
سۆتنا	سوطنا
سۆتنێ	سوطن
سۆتی	سوطي
سۆد	سود
سۆر	ثور
سۆران	ثوران
سۆرن	صورن
سۆرێ	ثور
سۆرێن	صورن
سۆرە	ثور
سۆرەتا	صورتا
سۆفیا	صوفيا
سۆلی	سولي
سۆمال	صومال
سۆن	صون
سۆڤیەتا	سوويتا
سۆڤێتا	سووطا
سۆڤێتێ	سووط
سی	سي
سیادە	صياد
سیار	سيار
سیارێ	سيار
سیاسی	صياصي
سیاسیێ	صياصي
سیاسیە	صياصي
سیدی	صيدي
سیریێ	سيري
سیستەم	سيستم
سیستەما	سيستما
سیستەمێ	سيستم
سیستەمە	سيستم
سیلڤا	سيلوا
سیمە	صيم
سینا	صينا
سیناریۆ	سيناريو
سینەما	سينما
سیێ	سي
سێ	ث
سێبەر	سبر
سێدارێ	صدار
سێدارە	صدار
سێلڤا	صلوا
سێلەکا	سلكا
سێمێل	سمل
سێمێلیە	سملي
سێمێلێ	سمل
سێڤا	سوا
سێڤان	صوان
سێڤێن	صون
سێکا	سكا
سێی	سي
سێیێ	سي
سێیەم	صيم
سێێ	ث
سە	ث
سەباح	صباح
سەبر	سبر
سەبرا	صبرا
سەبری	صبري
سەبیح	صبيح
سەبەبێ	سبب
سەبەقێن	سبقن
سەخت	سخط
سەختا	سخطا
سەختێ	سخط
سەختە	سخط
سەد	سد
سەدام	ثدام
سەدان	سدان
سەدر	سدر
سەدری	صدري
سەدرە	سدر
سەدڕ	سدر
سەدیق	صديق
سەدێ	سد
سەدە	سد
سەدەم	سدم
سەدەما	صدما
سەدەمێ	سدم
سەدەمێن	صدمن
سەدەی	ثدي
سەدەیە	ثدي
سەر	سر
سەرا	صرا
سەراب	سراب
سەرابێ	سراب
سەران	صران
سەرایا	سرايا
سەرجان	سرجان
سەرحان	سرحان
سەردا	صردا
سەردانێ	صردان
سەرما	صرما
سەروان	ثروان
سەروەت	ثروت
سەروەر	سرور
سەروەرە	سرور
سەرى	سرى
سەرڤە	سرو
سەری	ثري
سەرێ	سر
سەرێن	صرن
سەرە	سر
سەرەتا	سرطا
سەرەدان	صردان
سەرەدانێ	صردان
سەرەدانە	صردان
سەرەک	سرك
سەرەکێ	سرك
سەعد	صعد
سەعدون	سعدون
سەعدى	سعدى
سەعدی	صعدي
سەعید	صعيد
سەعەت	صعت
سەعەتێ	صعت
سەعەد	صعد
سەفار	سفار
سەفین	سفين
سەفەر	سفر
سەقا	سقا
سەقەت	سقط
سەلاح	سلاح
سەلام	سلام
سەلمان	ثلمان
سەلیم	سليم
سەلەفی	سلفي
سەلەفیێ	سلفي
سەمام	سمام
سەمتا	سمتا
سەمیان	سميان
سەمیر	سمير
سەمەر	ثمر
سەنتان	ثنتان
سەنجابی	سنجابي
سەهم	سهم
سەهمێ	سهم
سەهەر	صهر
سەید	صيد
سەیدا	سيدا
سەیدە	صيد
سەیر	سير
سەیران	ثيران
سەیرانێ	ثيران
سەیرە	سير
سەیف	سيف
ش	ش
شاد	شاد
شادی	شادي
شار	شار
شارلی	شارلي
شاریا	شاريا
شاش	شاش
شاشێ	شاش
شاشە	شاش
شاعری	شاعري
شاعرێن	شاعرن
شام	شام
شامێ	شام
شانە	شان
شاه	شاه
شاهد	شاهد
شاهدێن	شاهدن
شاهدە	شاهد
شاهی	شاهي
شاهین	شاهين
شاهێ	شاه
شاویش	شاويش
شاکر	شاكر
شتی	شتي
شری	شري
شرین	شرين
شعبی	شعبي
شعر	شعر
شعری	شعري
شعرێ	شعر
شعرێن	شعرن
شعرە	شعر
شعورێ	شعور
شمال	شمال
شنی	شني
شنیێ	شني
شنەی	شني
شوا	شوا
شورتە	شورت
شوشی	شوشي
شوو	شو
شووشتنێ	شوشتن
شووقێن	شوقن
شووقە	شوق
شوون	شون
شوونا	شونا
شوی	شوي
شوین	شوين
شوینا	شوينا
شکاک	شكاك
شکۆ	شكو
شکەست	شكست
شکەستن	شكستن
شکەستنێ	شكستن
شۆر	شور
شۆرتە	شورت
شۆفینی	شوفيني
شۆڕی	شوري
شۆی	شوي
شیا	شيآ
شیان	شيان
شیانە	شيان
شیخ	شيخ
شیر	شير
شیراز	شيراز
شیرازێ	شيراز
شیرین	شيرين
شیرینێ	شيرين
شیرێ	شير
شیرەت	شيرت
شیرەتا	شيرتا
شیعا	شيعا
شیعان	شيعان
شیعی	شيعي
شیعە	شيع
شیعەنە	شيعن
شیلان	شيلان
شیلی	شيلي
شین	شين
شیوعی	شيوعي
شیێن	شين
شێت	شت
شێخ	شخ
شێخا	شخا
شێخان	شخان
شێخێن	شخن
شێخە	شخ
شێر	شر
شێران	شران
شێرو	شرو
شێرى	شرى
شێرۆ	شرو
شێری	شري
شێرە	شر
شێست	شصت
شێف	شف
شێفت	شفت
شێل	شل
شێلی	شلي
شێن	شن
شێنێ	شن
شێوا	شوا
شێواز	شواظ
شێوازێ	شواظ
شێوازە	شواظ
شێوێ	شو
شێوە	شو
شێوەى	شوى
شێوەکی	شوكي
شێوەکێ	شوك
شێوەی	شوي
شێوەیان	شويان
شێوەیێ	شوي
شێوەیە	شوي
شێین	شين
شەبەک	شبك
شەبەکا	شبكا
شەبەکان	شبكان
شەخسان	شخصان
شەخسی	شخصي
شەر	شر
شەران	شران
شەربەتا	شربتا
شەرت	شرط
شەرع	شرع
شەرعی	شرعي
شەرم	شرم
شەرمێ	شرم
شەرمە	شرم
شەرى	شرى
شەری	شري
شەریف	شريف
شەریک	شريك
شەرێ	شر
شەرێن	شرن
شەرە	شر
شەرەف	شرف
شەرەفا	شرفا
شەرەفى	شرفى
شەرەفی	شرفي
شەرەفیێ	شرفي
شەرەفێ	شرف
شەرەکی	شركي
شەرەکێ	شرك
شەعبان	شعبان
شەعبی	شعبي
شەفەق	شفق
شەمال	شمال
شەماڵ	شمال
شەهاب	شهاب
شەهبا	شهبا
شەهرام	شهرام
شەهی	شهي
شەهیان	شهيان
شەهید	شهيد
شەهیدێ	شهيد
شەهێدێن	شهدن
شەوقی	شوقي
شەوکەت	شوكت
شەڕ	شر
شەڕان	شران
شەڕى	شرى
شەڕی	شري
شەڕێ	شر
شەڕێن	شرن
شەڕەک	شرك
شەڕەکی	شركي
شەڕەکێ	شرك
شەڤ	شو
شەڤا	شوا
شەڤی	شوي
شەڤێ	شو
شەڤێن	شون
شەڤە	شو
شەڤەکێ	شوك
شەکر	شكر
شەکرا	شكرا
شەکرنا	شكرنا
شەکرێ	شكر
شەکیب	شكيب
شەیدا	شيدا
ساڵح	صالح
ع	ع
عابد	عابد
عاجز	عاجز
عادل	عادل
عادەیا	عاديا
عارف	عارف
عارفێ	عارف
عاشق	عاشق
عاقل	عاقل
عامر	عامر
عبد	عبد
عرووبە	عروب
عزەت	عزت
عسمەت	عصمت
عشق	عشق
عشقا	عشقا
على	على
علی	علي
عۆدا	عودا
عیار	عيار
عیسا	عيثا
عێراق	عراق
عێراقێ	عراق
عەباس	عباث
عەباسی	عباسي
عەبدی	عبدي
عەتو	عطو
عەتیە	عتي
عەجاج	عجاج
عەدنان	عدنان
عەدەسا	عدسا
عەریف	عريف
عەرەب	عرب
عەرەبان	عربان
عەرەبن	عربن
عەرەبی	عربي
عەرەبیە	عربي
عەرەبێن	عربن
عەرەبە	عرب
عەرەفات	عرفات
عەزم	عظم
عەزمی	عظمي
عەزیز	عزيز
عەسمانێ	عثمان
عەشق	عشق
عەشقا	عشقا
عەشقێ	عشق
عەشیر	عشير
عەقل	عقل
عەقلی	عقلي
عەقلێ	عقل
عەقلێن	عقلن
عەقید	عقيد
عەقیدێ	عقيد
عەلا	علا
عەلاوى	علاوى
عەلاوی	علاوي
عەلى	على
عەلی	علي
عەلەفی	علفي
عەمار	عمار
عەمر	عمر
عەمران	عمران
عەمری	عمري
عەمرێ	عمر
عەممان	عممان
عەمید	عميد
عەمەر	عمر
عەور	عور
عەوری	عوري
عەورێن	عورن
عەونی	عوني
عەیب	عيب
عەین	عين
غاز	غاز
غازا	غاظا
غازی	غازي
غازێ	غاز
غانا	غانا
غروورێ	غرور
غیاس	غياث
غیر	غير
غەدر	غدر
غەریب	غريب
غەریبە	غريب
غەزال	غزال
غەزە	غض
غەزەبا	غضبا
غەفوور	غفور
غەنی	غني
غەوارە	غوار
غەیت	غيط
غەیری	غيري
غەیس	غيث
فائیق	فايق
فاتح	فاتح
فاتیکانێ	فاتيكان
فارس	فارس
فارسان	فارسان
فارسی	فارسي
فاروق	فاروق
فاروقی	فاروقي
فارۆق	فاروق
فازل	فاضل
فازلیێ	فاضلي
فازلێ	فاضل
فازڵ	فاضل
فالح	فالح
فایدە	فايد
فایق	فايق
فایەق	فايق
فتارێ	فتار
فرانسیس	فرانسيس
فرانکفورت	فرانكفورت
فرقا	فرقا
فرقە	فرق
فرن	فرن
فرنان	فرنان
فرنسا	فرنسا
فری	فري
فرێ	فر
فرێکەن	فركن
فرە	فر
فرەنسا	فرنسا
فرەه	فره
فلان	فلان
فلانە	فلان
فلم	فلم
فلمێ	فلم
فلمێن	فلمن
فلمە	فلم
فلکلۆری	فلكلوري
فندی	فندي
فنلەندا	فنلندا
فهێت	فهت
فورسن	فورسن
فولکلۆری	فولكلوري
فڕی	فري
فڕەنسا	فرنسا
فکر	فكر
فکرا	فكرا
فۆلکلۆری	فولكلوري
فۆلکلۆرێ	فولكلور
فی	في
فیدرالی	فيدرالي
فیدرالیێ	فيدرالي
فیدرالیە	فيدرالي
فیدراڵی	فيدرالي
فیدڕالی	فيدرالي
فیدڕاڵی	فيدرالي
فیلمێ	فيلم
فین	فين
فێ	ف
فێر	فر
فێرى	فرى
فێری	فري
فێقی	فقي
فێقیێ	فقي
فێل	فل
فەتاح	فتاح
فەتح	فتح
فەتحی	فتحي
فەخری	فخري
فەر	فر
فەرتەنە	فرطن
فەرد	فرد
فەرقی	فرقي
فەرمى	فرمى
فەرمێ	فرم
فەرهاد	فرهاد
فەرید	فريد
فەریقێ	فريق
فەرە	فر
فەرەجا	فرجا
فەرەنسا	فرنسا
فەزل	فظل
فەزەع	فزع
فەعلى	فعلى
فەقی	فقي
فەقیر	فقير
فەلاح	فلاح
فەلسەفا	فلسفا
فەلسەفی	فلسفي
فەلسەفێ	فلسف
فەلسەفە	فلسف
فەلسەفەی	فلسفي
فەلەستین	فلسطين
فەلەستینی	فلسطيني
فەلەک	فلك
فەنار	فنار
فەهمی	فهمي
فەهیم	فهيم
فەهیمە	فهيم
فەوجا	فوجا
فەوجان	فوجان
فەوجێ	فوج
فەوجێن	فوجن
فەوزى	فوضى
فەیاز	فياض
فەیسەل	فيصل
فەیسەلێ	فيصل
فەیلی	فيلي
فەیلەسۆف	فيلسوف
فەیک	فيك
قات	قات
قاتێ	قات
قاتێن	قاتن
قادا	قادا
قادر	قادر
قادری	قادري
قادرێ	قادر
قازى	قاضى
قازی	قاضي
قاسم	قاسم
قالبێ	قالب
قانونی	قانوني
قانوون	قانون
قانوونی	قانوني
قانوونیە	قانوني
قانوونێ	قانون
قانوونە	قانون
قاڵب	قالب
قبوول	قبول
قرار	قرار
قست	قست
قستێ	قسط
قسە	قس
قسەی	قسي
قسەیان	قسيان
قفلێن	قفلن
قنینێ	قنين
قوتا	قوتا
قوتان	قوتان
قورئان	قوران
قورئانێ	قوران
قورس	قورص
قولون	قولون
قوم	قوم
قووڵ	قول
قۆلی	قولي
قیمەت	قيمت
قەبانی	قباني
قەبلان	قبلان
قەبول	قبول
قەبوول	قبول
قەبیل	قبيل
قەت	قط
قەترێ	قطر
قەتەر	قطر
قەتەری	قطري
قەتەرێ	قطر
قەد	قد
قەدر	قدر
قەدری	قدري
قەدەر	قدر
قەدەرا	قدرا
قەدەرێ	قدر
قەر	قر
قەرا	قرا
قەرار	قرار
قەران	قرآن
قەرزێن	قرضن
قەری	قري
قەرێ	قر
قەرێن	قرن
قەرە	قر
قەزا	قضا
قەزاز	قذاذ
قەزایا	قضايا
قەساب	قصاب
قەست	قسط
قەستا	قسطا
قەسر	قصر
قەفتا	قفتا
قەلا	قلا
قەلەم	قلم
قەلەو	قلو
قەلەوی	قلوي
قەلەویێ	قلوي
قەنات	قنات
قەندیل	قنديل
قەندیلێ	قنديل
قەهار	قهار
قەوارێ	قوار
قەوما	قوما
قەومى	قومى
قەومیە	قومي
قەڕێ	قر
قەڕێن	قرن
قەڵەم	قلم
قەید	قيد
قەیدان	قيدان
قەیرە	قير
قەیس	قيص
ل	ل
لا	لا
لائق	لائق
لاتینی	لاتيني
لادا	لادا
لادان	لادان
لادن	لادن
لادەت	لادت
لاشێ	لاش
لافا	لافا
لاهای	لاهاي
لاهۆر	لاهور
لایێن	لاين
لایەن	لاين
لایەنا	لاينا
لایەنان	لاينان
لایەنی	لايني
لایەنێ	لاين
لایەنێن	لاينن
لایەنە	لاين
لبن	لبن
لبنانێ	لبنان
لتوانیا	لتوانيا
لجەم	لجم
لخۆ	لخو
لدە	لد
لعلکم	لعلكم
لق	لق
لقا	لقا
لقمان	لقمان
لقێ	لق
لقێن	لقن
لمە	لم
لهەڤ	لهو
لو	لو
لویس	لويس
لڤى	لوى
لڤین	لوين
لڤینا	لوينا
لڤینان	لوينان
لڤینێ	لوين
لک	لك
لکێ	لك
لۆجستی	لوجستي
لۆرد	لورد
لۆمەی	لومي
لی	لي
لیبی	ليبي
لیبیا	ليبيا
لیز	ليذ
لیزا	ليزا
لیست	ليست
لیستا	ليستا
لیستێ	ليست
لیستێن	ليستن
لیستە	ليست
لێ	ل
لێدا	لدا
لێدان	لدان
لێدانێ	لدان
لێدانە	لدان
لێددەت	لددت
لێدەن	لدن
لێمان	لمان
لێهاتینە	لهاتين
لێهاتیە	لهاتي
لێڤا	لوا
لێڤێن	لون
لێڤە	لو
لێک	لك
لێکەت	لكت
لێی	لي
لە	ل
لەئاست	لاثت
لەتیف	لطيف
لەز	لذ
لەزێ	لذ
لەعل	لعل
لەعلێ	لعل
لەم	لم
لەما	لما
لەندەن	لندن
لەندەنە	لندن
لەهی	لهي
لەهیان	لهيان
لەهیێن	لهين
لەو	لو
لەوا	لوا
لەوما	لوما
لەوێ	لو
لەوێدا	لودا
لەوێوە	لو
لەوە	لو
لەوەی	لوي
لەکێ	لك
لەیس	ليس
م	م
ما	ما
ماجد	ماجد
مادا	مادا
ماددێ	مادد
ماددێن	ماددن
ماددە	مادد
مادی	مادي
مادێ	ماد
مادێن	مادن
مادە	ماد
مادەیێ	مادي
مار	مار
ماران	ماران
مارتن	مارتن
مارسیلیا	مارسيليا
مارکسی	ماركسي
ماری	ماري
ماریا	ماريا
مارین	مارين
مارێ	مار
مارە	مار
مازن	مازن
ماسک	ماسك
ماسکێ	ماسك
ماسی	مآسي
ماسیێ	مآسي
ماسیە	مآسي
ماسێ	ماس
مال	مال
مالا	مالا
مالکی	مالكي
مالی	مالي
مالێ	مال
مالەکێ	مالك
مان	مان
مانێ	مان
مانە	مان
ماهر	ماهر
ماوێ	ماو
ماوە	ماو
ماوەی	مآوي
ماوەیێ	مآوي
ماڤێ	ماو
ماڵ	مال
ماڵا	مالآ
ماڵی	مالي
ماڵێ	مال
ماڵەکەی	مالكي
مای	ماي
مایک	مايك
مایکل	مايكل
مایێ	ماي
مایە	ماي
مایەوە	مايو
مایەڤە	مايو
مبارەک	مبارك
متا	متا
متاوع	مطاوع
متران	مطران
محسن	محسن
محمد	محمد
محمەد	محمد
محێ	مح
محەمد	محمد
محەمەد	محمد
محەمەدێ	محمد
مر	مر
مراد	مراد
مرن	مرن
مرنا	مرنا
مرنێ	مرن
مرى	مرى
مری	مري
مرید	مريد
مساومە	مساوم
مستەفێ	مصطف
مسر	مسر
مسرا	مصرا
مسری	مثري
مسرێ	مصر
مسعود	مسعود
مسلح	مسلح
مشتی	مشتي
مشک	مشك
مشکێ	مشك
مشیر	مشير
مشە	مش
معتدل	معتدل
مقداد	مقداد
مل	مل
ملا	ملا
ملازم	ملازم
ملح	ملح
مللەت	مللت
مللەتێ	مللت
مللەتێن	مللتن
مللەتە	مللت
ملم	ملم
ململانێ	ململان
ململانە	ململان
ملک	ملك
ملکێ	ملك
ملیار	مليار
ملیون	مليون
ملیۆن	مليون
ملێ	مل
ملێن	ملن
ملەتێ	ملط
من	من
منا	منا
منن	منن
منی	مني
منێ	من
منە	من
منەت	منت
منەکێ	منك
موز	موز
موسا	موسا
موسل	موصل
موسڵ	موصل
مول	مول
مولەت	مولت
مولەتا	مولتا
مولەتێ	مولت
مونا	مونا
مونتێ	مونت
موندیال	مونديال
موندیالێ	مونديال
مووسا	موسا
مووسل	موصل
مووسلا	موثلا
مووسلێ	موصل
مووسڵ	موصل
مووشەک	موشك
موولەت	مولت
مۆز	موز
مۆزر	موزر
مۆزێ	موز
مۆسکۆ	موسكو
مۆشەک	موشك
مۆلەت	مولت
مۆلەتێ	مولت
مۆندیال	مونديال
مۆندیالێ	مونديال
مۆندیالە	مونديال
می	مي
میر	مير
میرێ	مير
میرە	مير
میزێ	ميز
میسان	ميسان
میسر	ميسر
میل	ميل
میلا	ميلا
میلان	ميلان
مینا	مينا
میونخ	ميونخ
مێ	م
مێر	مر
مێرا	مرا
مێران	مران
مێرى	مرى
مێری	مري
مێرێ	مر
مێزا	مضا
مێزی	مضي
مێزێ	مذ
مێزەى	مضى
مێسی	مسي
مێشک	مشك
مێشکێ	مشك
مێل	مل
مێلاک	ملاك
مێلاکێ	ملاك
مێیە	مي
مە	م
مەئمون	ممون
مەئینا	مينا
مەبەحس	مبحث
مەبەست	مبسط
مەبەستێ	مبسط
مەتا	متا
مەتر	متر
مەترا	مطرا
مەتران	مطران
مەترس	مترس
مەترێن	مطرن
مەتین	متين
مەجید	مجيد
مەحالە	محال
مەحمود	محمود
مەحموود	محمود
مەحەمەد	محمد
مەخمور	مخمور
مەخموور	مخمور
مەخموورێ	مخمور
مەخمۆر	مخمور
مەد	مد
مەدا	مدا
مەداد	مداد
مەدرید	مدريد
مەدین	مدين
مەدینێ	مدين
مەدەنی	مدني
مەرا	مرا
مەرج	مرج
مەرجان	مرجان
مەرجێ	مرج
مەرجێن	مرجن
مەرجە	مرج
مەرجەع	مرجع
مەرجەعێ	مرجع
مەرجەعە	مرجع
مەردان	مردان
مەردانە	مردان
مەرقەدێ	مرقد
مەرکەزی	مركزي
مەریخێ	مريخ
مەریەم	مريم
مەزارێ	مضار
مەزلووم	مظلوم
مەزن	مضن
مەزنا	مضنا
مەزنان	مضنان
مەزنى	مضنى
مەزنی	مضني
مەزنیێ	مضني
مەزنێ	مضن
مەزنە	مضن
مەزهەب	مذهب
مەزهەر	مزهر
مەزڵوم	مظلوم
مەست	مست
مەسرور	مسرور
مەسروور	مسرور
مەسرۆر	مسرور
مەسعود	مسعود
مەسعوود	مسعود
مەسیحی	مسيحي
مەسەلێن	مسلن
مەسەلە	مثل
مەسەلەی	مثلي
مەشق	مشق
مەشقا	مشقا
مەعدێ	معد
مەعسوم	معصوم
مەعقولە	معقول
مەعلومە	معلوم
مەعنا	معنا
مەعنەوی	معنوي
مەعیدێ	معيد
مەعیدە	معيد
مەغرب	مغرب
مەغرۆر	مغرور
مەفرەزێ	مفرز
مەفرەزە	مفرز
مەقلا	مقلا
مەل	مل
مەلا	ملا
مەلیۆن	مليون
مەلەفێ	ملف
مەمێ	مم
مەنتقی	منتقي
مەنتیق	منطيق
مەنسور	منصور
مەنسوور	منصور
مەنە	من
مەه	مه
مەها	مها
مەهان	مهان
مەهانە	مهان
مەهدى	مهدى
مەهدی	مهدي
مەهێ	مه
مەهێن	مهن
مەهەر	مهر
مەودا	مودا
مەولود	مولود
مەولوود	مولود
مەکتەب	مكتب
مەکر	مكر
مەکسیک	مكسيك
مەکسیکێ	مكسيك
مەکی	مكي
مەکەت	مكت
مەکەن	مكن
مەیادێ	مياد
مەیادە	مياد
مەیدانێ	ميدان
مەیسەر	ميسر
مەیل	ميل
مەیێ	مي
مەیە	مي
ن	ن
نابێت	نابت
نابە	ناب
نابەت	نابت
ناتق	ناطق
ناجى	ناجى
ناجی	ناجي
ناحیێ	ناحي
ناحیە	ناحي
نادر	نادر
نادیا	ناديا
نادەت	نادت
نادەتە	نادت
نادەن	نادن
نادەنە	نادن
نادەین	نادين
نادەینە	نادين
نازم	ناظم
نازوورێ	ناظور
نازک	نازك
نازێ	ناض
ناس	ناس
ناسا	ناسا
ناسر	ناثر
ناسریێ	ناصري
ناسی	ناسي
ناف	ناف
نالا	نالا
نالی	نالي
نالێت	نالت
نالە	نال
ناما	ناما
نامق	نامق
نامووس	ناموس
نامووسێ	ناموس
نامێ	نام
نامێن	نامن
نامە	نام
نامەیێ	نامي
نامەیە	نامي
ناهێت	ناهت
ناهێتە	ناهت
ناوی	ناوي
ناوەران	ناوران
ناڤا	ناوآ
ناڤی	ناوي
ناکەی	ناكي
ناڵی	نالي
نایف	نايف
نبۆ	نبو
نجێفی	نجفي
نخافتن	نخافتن
ندێ	ند
نرخ	نرخ
نرخێ	نرخ
نزا	نزا
نزار	نزار
نزانن	نزانن
نزم	نزم
نزما	نظما
نزمی	نظمي
نسری	نصري
نشکەکێ	نشكك
نفرەتێن	نفرتن
نفش	نفش
نفشى	نفشى
نفشێ	نفش
نفشێن	نفشن
نمرا	نمرا
نمرێن	نمرن
نمونە	نمون
نموونا	نمونا
نموونێن	نمونن
نموونە	نمون
نمۆنە	نمون
نها	نها
نهالێن	نهالن
نهو	نهو
نهۆ	نهو
نهینێن	نهينن
نهێلى	نهلى
نهێلێ	نهل
نو	نو
نوبڵ	نوبل
نوبڵێ	نوبل
نوتر	نوتر
نورى	نورى
نوری	نوري
نوفەل	نوفل
نوو	نو
نوورا	نوورا
نوورى	نورى
نووری	نوري
نوونە	نون
نوونەێن	نونن
نووى	نوى
نووکرن	نوكرن
نووکرنێ	نوكرن
نووی	نوي
نوویا	نويا
نوویە	نوي
نووێ	نو
نوى	نوى
نوڤلێتا	نوولتا
نوکەدا	نوكدا
نوی	نوي
نویا	نويا
نویێ	نوي
نویێن	نوين
نویە	نوي
نوێ	نو
نوێی	نوي
نوێیە	نوي
نڤستم	نوستم
نڤستن	نوسطن
نڤستنێ	نوسطن
نڤسین	نوصين
نڤش	نوش
نڤشى	نوشى
نڤشی	نوشي
نڤشێ	نوش
نڤشێن	نوشن
نڤشەکێ	نوشك
نڤینا	نوينا
نڤێسی	نوسي
نڤێسین	نوصين
نڤێسیە	نوسي
نڤێسەر	نوسر
نکو	نكو
نکی	نكي
نۆبل	نوبل
نۆبلا	نوبلا
نۆبلێ	نوبل
نۆتر	نوتر
نۆرد	نورد
نۆلا	نولا
نۆم	نوم
نۆڤلێتا	نوولتا
نۆڤی	نووي
نۆکەدا	نوكدا
نیا	نيا
نیان	نيان
نیتراتێ	نيترات
نیسانێ	نيسان
نیشا	نيشا
نیشان	نيشان
نیشانێ	نيشان
نیشانە	نيشان
نیف	نيف
نین	نين
نینە	نين
نیویورک	نيويورك
نیویۆرک	نيويورك
نیڤ	نيو
نیڤێ	نيو
نیڤە	نيو
نیە	ني
نیەت	نيط
نێر	نر
نێروەی	نروي
نێرین	نرين
نێرینە	نرين
نێزکى	نذكى
نێزکی	نزكي
نێف	نف
نێو	نو
نێڕین	نرين
نێڤ	نو
نە	ن
نەئینان	نينان
نەئێخینە	نخين
نەبا	نبآ
نەباش	نباش
نەباشە	نباش
نەبت	نبط
نەبتنێ	نبطن
نەبریە	نبري
نەبن	نبن
نەبنە	نبن
نەبونا	نبونا
نەبوو	نبو
نەبوون	نبون
نەبوونا	نبونا
نەبوونێ	نبون
نەبوونە	نبون
نەبووی	نبوي
نەبوویە	نبوي
نەبووە	نبو
نەبویە	نبوي
نەبی	نبي
نەبیت	نبيت
نەبیتە	نبيت
نەبید	نبيد
نەبین	نبين
نەبینن	نبينن
نەبینە	نبين
نەبێت	نبط
نەبێتە	نبط
نەبە	نب
نەبەس	نبس
نەبەن	نبن
نەتنێ	نتن
نەتەوا	نتوا
نەتەوان	نتوان
نەتەوى	نطوى
نەتەوی	نطوي
نەتەوێ	نتو
نەتەوێن	نتون
نەتەوە	نتو
نەتەوەى	نطوى
نەتەوەی	نطوي
نەتەوەیێ	نطوي
نەتەوەیێن	نطوين
نەتەوەیە	نطوي
نەتەوەێ	نتو
نەجات	نجات
نەجاد	نجاد
نەجار	نجار
نەجم	نجم
نەجمان	نجمان
نەجهێ	نجه
نەجیب	نجيب
نەجیبە	نجيب
نەجێ	نج
نەجەف	نجف
نەجەفی	نجفي
نەحەز	نحظ
نەحەزێن	نحزن
نەخاسم	نخاصم
نەخاسمە	نخاصم
نەخری	نخري
نەخش	نخش
نەخشێ	نخش
نەخشێن	نخشن
نەخشە	نخش
نەخشەی	نخشي
نەخشەیێ	نخشي
نەخوو	نخو
نەخێر	نخر
نەد	ند
نەدا	ندا
نەداد	نداد
نەدان	ندان
نەداینە	نداين
نەددا	نددا
نەدل	ندل
نەدمان	ندمان
نەدن	ندن
نەدورە	ندور
نەدوورە	ندور
نەدیت	نديت
نەدیتن	نديتن
نەدە	ند
نەدەت	ندت
نەدەتە	ندت
نەدەدا	نددا
نەدەم	ندم
نەدەن	ندن
نەدەنە	ندن
نەدەین	ندين
نەرازى	نراضى
نەرازی	نراضي
نەرازینە	نراضين
نەرم	نرم
نەرمی	نرمي
نەرمین	نرمين
نەرمینێ	نرمين
نەرویج	نرويج
نەرین	نرين
نەرینێن	نرينن
نەرێنى	نرنى
نەرێنی	نرني
نەزان	نزان
نەزانە	نزان
نەزیر	نزير
نەساخ	نساخ
نەسر	نسر
نەسرا	نصرا
نەسرین	نسرين
نەسرینێ	نسرين
نەسرەت	نسرط
نەسیف	نسيف
نەشرین	نشرين
نەشیا	نشيا
نەشیت	نشيط
نەشیێ	نشي
نەشێت	نشط
نەشێم	نشم
نەشێن	نشن
نەشێی	نشي
نەشێین	نشين
نەغەدێ	نغد
نەفت	نفط
نەفتا	نفطا
نەفتی	نفتي
نەفتێ	نفط
نەفرەت	نفرت
نەفرەتا	نفرتا
نەفس	نفس
نەقیب	نقيب
نەقیبێ	نقيب
نەل	نل
نەلڤینێ	نلوين
نەما	نما
نەمان	نمان
نەمانێ	نمان
نەمر	نمر
نەمرن	نمرن
نەمری	نمري
نەمرە	نمر
نەمسا	نمسا
نەمساوی	نمساوي
نەه	نه
نەهات	نهات
نەهاتە	نهات
نەهی	نهي
نەهینن	نهينن
نەهێ	نه
نەهێت	نهت
نەهێتە	نهت
نەهێلا	نهلا
نەهێلان	نهلان
نەهێلانێ	نهلان
نەهێلت	نهلت
نەهێلتە	نهلت
نەهێلن	نهلن
نەهێلە	نهل
نەهێن	نهن
نەهێنە	نهن
نەهەمین	نهمين
نەو	نو
نەواب	نواب
نەوال	نوال
نەوت	نوط
نەوروز	نوروز
نەوروزێ	نوروز
نەورۆز	نوروز
نەورۆزێ	نوروز
نەوەى	نوى
نەوەی	نوي
نەڕازی	نراضي
نەڤی	نوي
نەڤیا	نويا
نەڤیێن	نوين
نەڤێت	نوط
نەڤێن	نون
نەکارێ	نكار
نەکت	نكت
نەکر	نكر
نەکربن	نكربن
نەکرن	نكرن
نەکرنا	نكرنا
نەکرنێ	نكرن
نەکرى	نكرى
نەکری	نكري
نەکرین	نكرين
نەکرینە	نكرين
نەکریە	نكري
نەکو	نكو
نەکێشا	نكشا
نەکەت	نكت
نەکەتە	نكت
نەکەفتن	نكفتن
نەکەفتە	نكفت
نەکەم	نكم
نەکەن	نكن
نەکەنە	نكن
نەکەڤنە	نكون
نەکەی	نكي
نەکەین	نكين
نەیا	نيا
نەیار	نيار
نەیارێ	نيار
نەیێ	ني
نەیێن	نين
نەە	ن
ها	ها
هات	هات
هاتمە	هاتم
هاتی	هاتي
هاتین	هاتين
هاتینە	هاتين
هاتیە	هاتي
هاتە	هات
هادى	هادى
هادی	هادي
هاری	هاري
هاشم	هاشم
هاشمی	هاشمي
هان	هان
هانا	هانا
هانی	هاني
هاون	هاون
هاونێن	هاونن
هاڤی	هاوي
هاڤێن	هاون
هزار	هزار
هزر	هزر
هزرا	هزرا
هزرێ	هذر
هزرێن	هذرن
هزرە	هذر
هش	هش
هشا	هشا
هشێ	هش
هشێن	هشن
هل	هل
هلسنکی	هلسنكي
هند	هند
هندا	هندا
هندی	هندي
هندێ	هند
هندە	هند
هه	هه
هورمونی	هورموني
هورمونێ	هورمون
هورمۆنێ	هورمون
هورمۆنە	هورمون
هوزان	هوزان
هوزانێ	هوزان
هوسا	هوسا
هولا	هولا
هولان	هولان
هولێن	هولن
هولەندا	هولندا
هوو	هو
هوور	هور
هووری	هوري
هوون	هوون
هوونن	هونن
هوین	هوين
هۆ	هو
هۆز	هوز
هۆزا	هوزا
هۆزان	هوزان
هۆزێن	هوزن
هۆسا	هوسا
هۆش	هوش
هۆشی	هوشي
هۆل	هول
هۆلا	هولا
هۆلێ	هول
هۆلێن	هولن
هۆلە	هول
هۆلەندا	هولندا
هۆڵا	هولا
هۆڵوکوست	هولوكوست
هۆڵێن	هولن
هۆڵەندا	هولندا
هۆی	هوي
هی	هي
هیز	هيض
هیشتا	هيشتا
هیمەت	هيمت
هیمەتا	هيمتا
هین	هين
هێت	هت
هێتە	هت
هێجەتا	هجتا
هێدى	هدى
هێدی	هدي
هێرش	هرش
هێرشا	هرشا
هێرشان	هرشان
هێرشی	هرشي
هێرشێ	هرش
هێرشێن	هرشن
هێرشە	هرش
هێز	هز
هێزا	هذا
هێزان	هذان
هێزانە	هذان
هێزن	هزن
هێزى	هذى
هێزی	هذي
هێزین	هذين
هێزێ	هز
هێزێن	هزن
هێزە	هز
هێش	هش
هێشتا	هشتا
هێل	هل
هێلا	هلا
هێلان	هلان
هێلن	هلن
هێلی	هلي
هێلێ	هل
هێلێن	هلن
هێلەکا	هلكا
هێما	هما
هێمن	همن
هێن	هن
هێندە	هند
هێندەی	هندي
هێنە	هن
هێڤی	هوي
هێڤێنێ	هون
هێیە	هي
هە	ه
هەبا	هبا
هەبان	هبان
هەبت	هبط
هەبن	هبن
هەبونا	هبونا
هەبوو	هبو
هەبوون	هبون
هەبوونا	هبونا
هەبوونێ	هبون
هەبوونە	هبون
هەبووە	هبو
هەبیت	هبيت
هەبێت	هبط
هەتا	هتا
هەتتا	هتتا
هەجین	هجين
هەدار	هدار
هەدارێ	هدار
هەدەر	هدر
هەر	هر
هەرا	هرا
هەرسێ	هرس
هەرمان	هرمان
هەرن	هرن
هەری	هري
هەرێ	هر
هەرێم	هرم
هەرێما	هرما
هەرێمان	هرمان
هەرێمى	هرمى
هەرێمی	هرمي
هەرێمێ	هرم
هەرە	هر
هەرەسێ	هرس
هەرەشێ	هرش
هەرەشێن	هرشن
هەرەشە	هرش
هەرەمێ	هرم
هەزار	هزار
هەست	هست
هەستا	هستا
هەستێ	هست
هەستێن	هستن
هەستە	هست
هەشت	هشت
هەشتێ	هشت
هەشتەم	هشتم
هەل	هل
هەلکەت	هلكت
هەلێت	هلت
هەم	هم
هەما	هما
هەمان	همان
هەمى	همى
هەمی	همي
هەمیا	هميا
هەمیێ	همي
هەمە	هم
هەمەر	همر
هەن	هن
هەند	هند
هەنێ	هن
هەنە	هن
هەوا	هوا
هەودان	هودان
هەول	هول
هەولا	هولا
هەولێ	هول
هەولێن	هولن
هەوڵ	هول
هەوڵێن	هولن
هەوێ	هو
هەوێن	هون
هەوە	هو
هەوەدا	هودا
هەوەنە	هون
هەوەینە	هوين
هەوەیێن	هوين
هەوەیە	هوي
هەڕفت	هرفت
هەڕەشە	هرش
هەڕەشەی	هرشي
هەڤ	هو
هەڤالەک	هوالك
هەڤالەکێ	هوالك
هەڤدا	هودا
هەڤدیتنێ	هوديتن
هەڤدە	هود
هەڤرا	هورا
هەڤرانە	هوران
هەڤلێن	هولن
هەڤڕا	هورا
هەی	هي
هەیا	هيا
هەیام	هيام
هەیفا	هيفا
هەین	هين
هەیهات	هيهات
هەیکەلێ	هيكل
هەیە	هي
و	و
وئێکەتی	وكتي
وئێکەتیێ	وكتي
وئەرکێ	ورك
وئەرکێن	وركن
وئەرەب	ورب
وئەزمانێ	وذمان
وا	وا
وادا	وادا
وادی	وادي
وار	وار
وارى	وارى
واری	واري
وارێ	وار
وارێن	وارن
واز	واز
واشنتۆن	واشنطون
واشنتۆنێ	واشنطون
واقع	واقع
واقعی	واقعي
واقعێ	واقع
وانەی	واني
وب	وب
وتا	وطا
وتار	وتار
وتارە	وتار
وتی	وتي
وتێدا	وطدا
وجهێن	وجهن
ودێ	ود
وریا	وريا
ورە	ور
ورەیا	وريا
وزیرێ	وزير
وزێ	وز
وزە	وز
وزەی	وذي
وزەیا	وذيا
وزەیێ	وذي
وشە	وش
وفی	وفي
ول	ول
ولا	ولا
ولاتێ	ولات
وما	وما
ومن	ومن
ون	ون
وهەتا	وهتا
ووتی	وتي
ووردی	وردي
ووزا	وذا
ووزەیا	وذيا
ووزەیێ	وذي
وول	ول
وکەرتێ	وكرت
وکەس	وكس
وکەڤنە	وكون
وڵات	ولات
وی	وي
وینە	وين
ویێ	وي
ویێن	وين
ویە	وي
وێ	و
وێب	وب
وێری	وري
وێرێ	ور
وێرەک	ورك
وێرەکن	وركن
وێرەکی	وركي
وێرەکیێ	وركي
وێلی	ولي
وێنێ	ون
وێنێن	ونن
وێنە	ون
وێنەى	ونى
وێنەی	وني
وێنەیان	ونيان
وێنەیێ	وني
وێنەیێن	ونين
وێنەیە	وني
وێیە	وي
وە	و
وەحید	وحيد
وەخت	وخط
وەختێ	وخط
وەدکەت	ودكت
وەر	ور
وەرن	ورن
وەریانێ	وريان
وەریسێ	وريث
وەرێسێ	ورس
وەرە	ور
وەرەمێن	ورمن
وەرەیا	وريا
وەزاری	وزاري
وەزرێ	وزر
وەزیر	وزير
وەزیرێ	وزير
وەزێرێن	وزرن
وەسا	وصا
وەسان	وصان
وەستا	وسطا
وەسف	وصف
وەسفی	وثفي
وەسیەتا	وصيتا
وەسەت	وسط
وەشین	وشين
وەغەر	وغر
وەغەرا	وغرا
وەغەرێ	وغر
وەفا	وفا
وەفایێ	وفاي
وەل	ول
وەلات	ولات
وەلاتێ	ولات
وەلاتە	ولات
وەلی	ولي
وەلید	وليد
وەلێ	ول
وەهم	وهم
وەهمی	وهمي
وەکر	وكر
وەکریە	وكري
وەکهەڤ	وكهو
وەکی	وكي
وەڵات	ولات
وەڵاتێ	ولات
وەی	وي
وەینە	وين
وەیە	وي
ى	ى
ڕا	رآ
ڕابیت	رابيت
ڕادەیێ	رادي
ڕازى	راضى
ڕازی	راضي
ڕاست	راست
ڕاستە	راست
ڕاهێنان	راهنان
ڕستە	رثت
ڕوح	روح
ڕوسیا	روسيا
ڕومانێ	رومان
ڕوو	رو
ڕوودان	رودان
ڕوودانێ	رودان
ڕووسی	روسي
ڕووسیا	روسيا
ڕووی	روي
ڕوویێ	روي
ڕۆل	رول
ڕۆلێ	رول
ڕۆمان	رومان
ڕۆمانێ	رومان
ڕۆهن	روهن
ڕێ	ر
ڕێتنا	رطنا
ڕێز	رز
ڕێزێ	رز
ڕێزێن	رزن
ڕێسا	رثا
ڕێک	رك
ڕێکا	ركا
ڕێکێ	رك
ڕێکێن	ركن
ڕێیا	ريا
ڕە	ر
ڕەئیا	ريا
ڕەئیسی	ريثي
ڕەت	رت
ڕەجەب	رجب
ڕەخنە	رخن
ڕەز	رز
ڕەسمێن	رثمن
ڕەسول	رسول
ڕەسوڵ	رسول
ڕەش	رش
ڕەشاش	رشاش
ڕەشید	رشيد
ڕەمەزان	رمضان
ڕەوا	روا
ڕەوتێ	روت
ڕەوش	روش
ڕەوشا	روشا
ڕەوشێ	روش
ڕەوشە	روش
ڕەڤی	روي
ڕەڤین	روين
ڕەڤینا	روينا
ڕەڤینە	روين
ڕەیان	ريان
ڤ	و
ڤالان	والآن
ڤالە	وال
ڤرێکەت	وركت
ڤۆلی	وولي
ڤی	وي
ڤیلا	ويلا
ڤینێ	وين
ڤێ	و
ڤێت	وط
ڤێجا	وجا
ڤێجارێ	وجار
ڤێری	وري
ڤێرێ	ور
ڤێرە	ور
ڤێلا	ولا
ڤێڕا	ورآ
ڤە	و
ڤەبڕ	وبر
ڤەدان	ودان
ڤەددەت	وددت
ڤەدکەت	ودكت
ڤەدیتن	وديتن
ڤەدەین	ودين
ڤەشێرن	وشرن
ڤەنە	ون
ڤەکر	وكر
ڤەکرن	وكرن
ڤەکرنا	وكرنا
ڤەکرنێ	وكرن
ڤەکری	وكري
ڤەکریە	وكري
ڤەکەم	وكم
ڤەکەن	وكن
ڤەیە	وي
ک	ك
کاتیۆشا	كاتيوشا
کاتە	كات
کادر	كادر
کادرێ	كادر
کار	كار
کارئینان	كارينان
کارئینانێ	كارينان
کارا	كارا
کارب	كارب
کارت	كارت
کارتا	كارتا
کارلۆ	كارلو
کارن	كارن
کارى	كارى
کاری	كاري
کاریان	كاريان
کاریت	كاريت
کارین	كارين
کارینە	كارين
کاریکاتۆر	كاريكاتور
کارێ	كار
کارێت	كارت
کارێن	كارن
کارە	كار
کارەب	كارب
کارەبێ	كارب
کازاخستان	كازاخستان
کازم	كاظم
کازمێ	كاظم
کاسا	كاسا
کاسۆلیک	كاثوليك
کاسێت	كاست
کافری	كافري
کافیە	كافي
کافێ	كاف
کامل	كامل
کامی	كامي
کامیرا	كاميرا
کامیرۆن	كاميرون
کانت	كانت
کانێ	كان
کت	كت
کتێب	كتب
کتێبا	كتبا
کتێبی	كتبي
کتێبێ	كتب
کتێبێن	كتبن
کر	كر
کرا	كرا
کراسێ	كراث
کرب	كرب
کربا	كربا
کربن	كربن
کربوون	كربون
کربوونە	كربون
کرم	كرم
کرن	كرن
کرنا	كرنا
کرنێ	كرن
کرنە	كرن
کرو	كرو
کرواتیا	كرواتيا
کرى	كرى
کری	كري
کریا	كريا
کریستیان	كريستيان
کریم	كريم
کرین	كرين
کرینا	كرينا
کرینە	كرين
کریە	كري
کرێ	كر
کرێت	كرت
کرێتە	كرت
کرێیا	كريا
کرە	كر
کرەڤە	كرو
کشەیێ	كشي
کف	كف
کفری	كفري
کلاسیکی	كلاسيكي
کلدانی	كلداني
کلم	كلم
کم	كم
کن	كن
کنفێ	كنف
کو	كو
کوبا	كوبا
کوت	كوت
کود	كود
کودان	كودان
کور	كور
کورا	كورا
کوران	كوران
کورت	كورت
کورتن	كورتن
کورتە	كورت
کورسیکا	كورسيكا
کورن	كورن
کوری	كوري
کوریا	كوريا
کورێ	كور
کورێن	كورن
کورە	كور
کوستاریکا	كوستاريكا
کوسرەت	كوثرت
کوم	كوم
کوما	كوما
کومان	كومان
کومێ	كوم
کومێن	كومن
کون	كون
کوو	كو
کوور	كور
کوورن	كورن
کوون	كون
کوڕ	كور
کوڕان	كوران
کوڕی	كوري
کوڕێ	كور
کوڕێن	كورن
کوێت	كوت
کوێتێ	كوت
کڕیت	كريت
کڕین	كرين
کڕینا	كرينا
کڕینە	كرين
کۆ	كو
کۆتا	كوتا
کۆدێ	كود
کۆریا	كوريا
کۆرێ	كور
کۆرە	كور
کۆستاریکا	كوستاريكا
کۆسرەت	كوثرت
کۆلۆمبیا	كولومبيا
کۆم	كوم
کۆما	كوما
کۆمان	كومان
کۆمیدیێ	كوميدي
کۆمێ	كوم
کۆمێن	كومن
کۆمە	كوم
کۆن	كون
کۆنێ	كون
کۆڕ	كور
کۆک	كوك
کۆیێ	كوي
کۆیە	كوي
کی	كي
کیرێ	كير
کیستێ	كيست
کیفی	كيفي
کیلو	كيلو
کیلۆ	كيلو
کیلۆمەتر	كيلومتر
کیمیاوی	كيمياوي
کین	كين
کینی	كيني
کینێ	كين
کینە	كين
کێ	ك
کێر	كر
کێرک	كرك
کێری	كري
کێش	كش
کێشا	كشا
کێشان	كشان
کێشێ	كش
کێشێن	كشن
کێشە	كش
کێشەک	كشك
کێشەی	كشي
کێشەیێ	كشي
کێشەیە	كشي
کێشەێن	كشن
کێل	كل
کێلبێن	كلبن
کێم	كم
کێمن	كمن
کێمی	كمي
کێمیا	كميا
کێمە	كم
کێیە	كي
کە	ك
کەبەد	كبد
کەت	كت
کەتن	كتن
کەتنێ	كتن
کەتنە	كتن
کەتی	كتي
کەتین	كتين
کەتینە	كتين
کەتیە	كتي
کەتە	كت
کەد	كد
کەدا	كدا
کەر	كر
کەرب	كرب
کەربا	كربا
کەربێن	كربن
کەرتێ	كرت
کەرتێن	كرتن
کەرستێ	كرست
کەرستێن	كرستن
کەرستە	كرست
کەریم	كريم
کەرێ	كر
کەرێن	كرن
کەرەستێ	كرست
کەرەستێن	كرستن
کەرەستە	كرست
کەرەم	كرم
کەرەکێ	كرك
کەزانێ	كزان
کەس	كث
کەسا	كسا
کەسان	كثان
کەسانە	كثان
کەسن	كثن
کەسى	كسى
کەسی	كثي
کەسێ	كث
کەسێن	كثن
کەسە	كث
کەسەر	كسر
کەش	كش
کەشێ	كش
کەعبێ	كعب
کەفت	كفت
کەفتم	كفتم
کەفتن	كفتن
کەفتنێ	كفتن
کەفتنە	كفتن
کەفتە	كفت
کەفیتە	كفيت
کەل	كل
کەلا	كلا
کەلها	كلها
کەلیا	كليا
کەلین	كلين
کەلێ	كل
کەلەک	كلك
کەم	كم
کەمال	كمال
کەمی	كمي
کەن	كن
کەنعان	كنعان
کەننا	كننا
کەنی	كني
کەنیێ	كني
کەنە	كن
کەنەدا	كندا
کەهرەب	كهرب
کەهرەبا	كهربا
کەهرەبێ	كهرب
کەهی	كهي
کەو	كو
کەوت	كوت
کەوسەر	كوثر
کەوێ	كو
کەڤتە	كوت
کەڤر	كور
کەڤرا	كورا
کەڤران	كوران
کەڤری	كوري
کەڤرێن	كورن
کەڤن	كون
کەڤنا	كونا
کەڤنە	كون
کەڤیت	كويت
کەڤیتێ	كويت
کەڤیتە	كويت
کەی	كي
کەیس	كيس
کەیسا	كيسا
کەیسی	كيسي
کەیسێ	كيس
کەیسێن	كيسن
کەیف	كيف
کەیفا	كيفا
کەیفێ	كيف
کەین	كين
کەینە	كين
کەیە	كي
ۆ	و
ی	ي
یا	يا
یادی	يادي
یاریێن	يارين
یاسین	ياسين
یدا	يدآ
ینک	ينك
ینکدا	ينكدا
ینکە	ينك
ینە	ين
یوسف	يوسف
یوسفی	يوسفي
یونان	يونان
یونانێ	يونان
یونس	يونس
یووسف	يوسف
یوونس	يونس
یڤێن	يون
یۆرۆ	يورو
یۆنان	يونان
یێ	ي
یێدى	يدى
یێل	يل
یێن	ين
یە	ي
یەحیا	يحيا
یەدەک	يدك
یەدەکێن	يدكن
یەزد	يضد
یەزدانێ	يضدان
یەمەن	يمن
یەمەنى	يمنى
یەمەنێ	يمن
یەنس	ينص
یەکتر	يكتر
یەکسان	يكثان
یەکەم	يكم
یەکەمی	يكمي
یەکەمین	يكمين
ێ	
ێن	ن
ێیە	ي
ێەباح	باح
ە	