آذربایجان	آذربایجان
آلت	آلت
آچار	آچار
آی	آی
ات	ات
ار	ار
اساس	اساس
اسم	اسم
اهالی	اهالی
اهالی درد	اهالی درد
اهل	اهل
اهل درد	اهل درد
او	او
اژدها	اژدها
بازار	بازار
بدیع	بدیع
بدیعی	بدیعی
بدیعیات	بدیعیات
برقرار	برقرار
بعث	بعث
بلاهای عشق	بلاهای عشق
بلای عشق	بلای عشق
بوسه	بوسه
بۆرج	برج
بۇسه	بوسه
تاریخی	تاریخی
تر	تر
تصریف	تصریف
تقویم	تقویم
جان	جان
جدا	جدا
جنوب	جنوب
جهان	جهان
جۆمه	جمعه
حیات	حیات
خرچنگ	خرچنگ
خزینه	خزینه
دارچین	دارچین
داغ	داغ
دشمن	دشمن
دقت	دقت
دور	دور
دوشمان	دشمن
دوشمن	دشمن
دولاب	دولاب
دیققت	دقت
دین	دین
رنده	رنده
رنگ	رنگ
رهبر	رهبر
روسیه	روسیه
ریاضیات	ریاضیات
زلزله	زلزله
سحرباز	سحرباز
سفربر	سفربر
سلجوق	سلجوق
سلجوقی	سلجوقی
سود	سود
شاعر	شاعر
شاعره	شاعره
شاهزاده	شاهزاده
شرق	شرق
شنبه	شنبه
شهلا	شهلا
شکاف	شکاف
شیراز	شیراز
شیرکت	شرکت
شیمال	شمال
صابون	صابون
صنعا	صنعا
ضربه	ضربه
طلبه	طلبه
طیاره	طیاره
ظرف	ظرف
ظفر	ظفر
عرق	عرق
عنایت	عنایت
غرب	غرب
فارس	فارس
فلسفه	فلسفه
فهم	فهم
فیروزه	فیروزه
فیلم	فیلم
قدیم	قدیم
لغت	لغت
لوغت	لغت
مؤجوزه	مؤجوزه
مئیمۇن	میمون
مبتدی	مبتدی
مبتلا	مبتلا
مدرسە	مدرسە
مرعش	مرعش
مضراب	مضراب
مطبخ	مطبخ
معجزه	معجزه
مقدس	مقدس
من	من
موبتلا	مبتلا
موجود	موجود
مکافات	مکافات
مکتب	مکتب
میراث	میراث
نخله	نخله
نخیل	نخیل
نقطه	نقطه
هفته	هفته
پری	پری
چای	چای
کاغذ	کاغذ
کاغیز	کاغذ
کتاب	کتاب
کتابخانه	کتابخانه
اتم	اتم
اجل	اجل
ارم	ارم
ازل	ازل
بتن	بتن
بدی	بدی
تک	تک
حجج	حجج
ختم	ختم
دیس	دیس
ذهن	ذهن
رزم	رزم
رعد	رعد
زره	زره
سس	سس
سنگ	سنگ
سیه	سیه
شجر	شجر
شوم	شوم
عذر	عذر
غله	غله
فنر	فنر
لنت	لنت
نسخ	نسخ
نوک	نوک
هجو	هجو
هلم	هلم
ولو	ولو
وی	وی
کاف	کاف
کدو	کدو
کسر	کسر
کمک	کمک
گل	گل
ایل	ایل
نفر	نفر
روس	روس
تاتار	تاتار
ژان	ژان
فیلیپ	فیلیپ
حال	حال
لال	لال
اثر	اثر
اکس	اکس
آرتا	آرتا
آشیل	آشیل
آنان	آنان
آیتی	آیتی
الهی	الهی
اونس	اونس
اوْل	اول
باقی	باقی
بایت	بایت
بختی	بختی
برید	برید
بلاد	بلاد
تانا	تانا
تروپ	تروپ
تصوف	تصوف
تفرش	تفرش
توجه	توجه
تکیه	تکیه
تینر	تینر
ثمره	ثمره
جرسی	جرسی
جنّت	جنت
جنید	جنید
حاضر	حاضر
حتی	حتی
حماس	حماس
خاطر	خاطر
دارد	دارد
داعی	داعی
دام	دام
دهشت	دهشت
دوار	دوار
روند	روند
ریکا	ریکا
زابل	زابل
زنان	زنان
زیره	زیره
سفیر	سفیر
سنان	سنان
سیلو	سیلو
سینک	سینک
شرحه	شرحه
شرعی	شرعی
شعیب	شعیب
شهیر	شهیر
شیشه	شیشه
شین	شین
صبور	صبور
صدقی	صدقی
طرف	طرف
طلحه	طلحه
عصمت	عصمت
علاج	علاج
غوری	غوری
فایل	فایل
فتاح	فتاح
فرخی	فرخی
فرعی	فرعی
فساد	فساد
فلاح	فلاح
فلان	فلان
فلوت	فلوت
فوکو	فوکو
فکرت	فکرت
قدغن	قدغن
قزاق	قزاق
قطعه	قطعه
قیصر	قیصر
لایه	لایه
لوتس	لوتس
لولو	لولو
لوچ	لوچ
ماتی	ماتی
ماهی	ماهی
مجار	مجار
مخمر	مخمر
مدار	مدار
مرجع	مرجع
مرین	مرین
مشخص	مشخص
مشرف	مشرف
مشفق	مشفق
معلا	معلا
منصف	منصف
میهن	میهن
نارو	نارو
ناپل	ناپل
نسبت	نسبت
نصری	نصری
نقاط	نقاط
نواب	نواب
نورد	نورد
نوْع	نوع
هاکس	هاکس
هرکس	هرکس
هودج	هودج
هوفر	هوفر
هیوم	هیوم
واعظ	واعظ
والن	والن
ونکی	ونکی
پاکت	پاکت
پنبه	پنبه
چهار	چهار
ژاکت	ژاکت
ژروم	ژروم
کاهن	کاهن
کسلر	کسلر
کلور	کلور
کور	کور
کپلر	کپلر
گرمی	گرمی
گمان	گمان
گون	گون
جی	جی
جو	جو
فیفا	فیفا
ادیب	ادیب
آتشین	آتشین
آفتاب	آفتاب
ابطحی	ابطحی
اخراج	اخراج
اخوان	اخوان
ارشاد	ارشاد
استیک	استیک
اسیری	اسیری
اصلاً	اصلاً
اقامت	اقامت
اینان	اینان
ایوری	ایوری
باربی	باربی
براند	براند
بهشتی	بهشتی
بهشهر	بهشهر
بوزید	بوزید
بکتاش	بکتاش
بیضاء	بیضاء
تافت	تافت
تاکسی	تاکسی
تایسن	تایسن
تحکیم	تحکیم
ترانس	ترانس
ترکیه	ترکیه
تصمیم	تصمیم
تعزیه	تعزیه
تلفات	تلفات
تکمیل	تکمیل
جریمه	جریمه
جمالی	جمالی
جوراب	جوراب
جیران	جیران
ای	ای
حریری	حریری
حصاری	حصاری
حقایق	حقایق
حلیمی	حلیمی
حکیم	حکیم
خودرو	خودرو
دزیره	دزیره
ده	ده
کی	کی
رابطه	رابطه
رامسر	رامسر
رزاقی	رزاقی
رستمی	رستمی
رنجبر	رنجبر
زیاده	زیاده
ساده	ساده
سرمست	سرمست
سماعی	سماعی
سندی	سندی
سوئد	سوئد
سیمان	سیمان
شازند	شازند
شجاعی	شجاعی
شرلوک	شرلوک
شهرکی	شهرکی
عابدی	عابدی
عفونت	عفونت
عمودی	عمودی
غفوری	غفوری
فاجعه	فاجعه
فرعون	فرعون
قاهره	قاهره
قواعد	قواعد
قیاسی	قیاسی
مؤلف	مؤلف
مارس	مارس
مافیا	مافیا
مجلسی	مجلسی
محبوس	محبوس
محفوظ	محفوظ
مربّع	مربع
معتضد	معتضد
مقیمی	مقیمی
ممنون	ممنون
منور	منور
مویرا	مویرا
نیکوس	نیکوس
هارلن	هارلن
هندسی	هندسی
هوایی	هوایی
واقعه	واقعه
پزشکی	پزشکی
ژیلبر	ژیلبر
کوشان	کوشان
گرداب	گرداب
زوریخ	زوریخ
سوئیس	سوئیس
متحده	متحده
ورونا	ورونا
شوروی	شوروی
ایران	ایران
محدود	محدود
تاریخ	تاریخ
حیاتی	حیاتی
یاشار	یاشار
آمریکن	آمریکن
آیلتون	آیلتون
اتانول	اتانول
اجدادی	اجدادی
افندی	افندی
الثانی	الثانی
اودسا	اودسا
اوزون	اوزون
ایوان	ایوان
باشگاه	باشگاه
بیازید	بیازید
بیانکو	بیانکو
بیگدلی	بیگدلی
تاتاری	تاتاری
تیلور	تیلور
جماهیر	جماهیر
حسنعلی	حسنعلی
دالیان	دالیان
لی	لی
دَیَری	دیری
رحمانی	رحمانی
رمضانی	رمضانی
رنسانس	رنسانس
سالومه	سالومه
سهرورد	سهرورد
سولانا	سولانا
سولون	سولون
شاهدان	شاهدان
شفیلد	شفیلد
شوچنکو	شوچنکو
عرفانی	عرفانی
فارسان	فارسان
فضولی	فضولی
قشقایی	قشقایی
قوم	قوم
لاذقیه	لاذقیه
لوییجی	لوییجی
ماسون	ماسون
محدوده	محدوده
مختاری	مختاری
لر	لر
ملویل	ملویل
موفقیت	موفقیت
مک	مک
کال	کال
نصرانی	نصرانی
نوروزی	نوروزی
نورپور	نورپور
نیتریک	نیتریک
هاکسلی	هاکسلی
هدایتی	هدایتی
هیز	هیز
له	له
هیچکاک	هیچکاک
پارما	پارما
پنالتی	پنالتی
پنجشیر	پنجشیر
کلدانی	کلدانی
کورانی	کورانی
کوستاس	کوستاس
کوهدشت	کوهدشت
کیخسرو	کیخسرو
گالیله	گالیله
یوْهان	یوهان
آبادان	آبادان
اردبیل	اردبیل
دیر	دیر
اوْغلو	اوغلو
دی	دی
آجی	آجی
آزادشهر	آزادشهر
آنا	آنا
دان	دان
آنکارا	آنکارا
ابراهام	ابراهام
ابوطالب	ابوطالب
استکهلم	استکهلم
حصار	حصار
التصاقی	التصاقی
تپه	تپه
اوکلند	اوکلند
مه	مه
جبهه	جبهه
جهت	جهت
حمله	حمله
دن	دن
خاصه	خاصه
سی	سی
دربی	دربی
شر	شر
دسته	دسته
نی	نی
رومولوس	رومولوس
سوماترا	سوماترا
سویه	سویه
شجره	شجره
شیروان	شیروان
صفحه	صفحه
طهماسبی	طهماسبی
عربستان	عربستان
غلامعلی	غلامعلی
فروکتوز	فروکتوز
فونیکس	فونیکس
قصبه	قصبه
مارکونی	مارکونی
مخصوصاً	مخصوصاً
سه	سه
دنیل	دنیل
نستعلیق	نستعلیق
هالیدی	هالیدی
هامبورگ	هامبورگ
همچنین	همچنین
پارسیان	پارسیان
پروستات	پروستات
پوتسدام	پوتسدام
پینوکیو	پینوکیو
چرنوبیل	چرنوبیل
کادیلاک	کادیلاک
کمبوجیه	کمبوجیه
کوچه	کوچه
لار	لار
بیلبائو	بیلبائو
اجتماعی	اجتماعی
سیاسی	سیاسی
آدام	آدام
آیین	آیین
استرالیا	استرالیا
الیزابت	الیزابت
اندرسون	اندرسون
اولجایتو	اولجایتو
بالتازار	بالتازار
بایکونور	بایکونور
بودجه	بودجه
خامنه	خامنه
دمکراتیک	دمکراتیک
رفراندوم	رفراندوم
ساعات	ساعات
سانتیاگو	سانتیاگو
سیلوستره	سیلوستره
صنایع	صنایع
طبقه	طبقه
علی	علی
حیدر	حیدر
فایرفاکس	فایرفاکس
فلورانس	فلورانس
مادّه	ماده
مرتبه	مرتبه
منطقه	منطقه
کلر	کلر
ماهون	ماهون
مین	مین
نظریه	نظریه
نهایت	نهایت
وست	وست
پارامونت	پارامونت
کامیاران	کامیاران
کرال	کرال
یوکوهاما	یوکوهاما
آرژانتین	آرژانتین
نمک	نمک
اسکاتلند	اسکاتلند
حسن	حسن
باتون	باتون
جین	جین
حسین	حسین
حوزه	حوزه
سینه	سینه
خلیفه	خلیفه
درجه	درجه
سینی	سینی
دقیقه	دقیقه
لیک	لیک
کاپریو	کاپریو
رابینسون	رابینسون
راضی	راضی
شهری	شهری
عبدالجبار	عبدالجبار
عبدالمالک	عبدالمالک
عمادالدین	عمادالدین
فانتاستیک	فانتاستیک
قوه	قوه
ماده	ماده
مجموعه	مجموعه
نصیرالدین	نصیرالدین
هولاکوخان	هولاکوخان
کلئوپاترا	کلئوپاترا
لینکلن	لینکلن
آسان	آسان
رک	رک
احمدی	احمدی
نژاد	نژاد
اعتباری	اعتباری
افسانه	افسانه
لاری	لاری
علاقه	علاقه
مرکوری	مرکوری
موزه	موزه
نیوفاندلند	نیوفاندلند
هم	هم
رای	رای
یهودی	یهودی
آباد	آباد
بین	بین
ترمودینامیک	ترمودینامیک
خاندانی	خاندانی
شیروانی	شیروانی
لوئیس	لوئیس
محلّه	محله
کوالالامپور	کوالالامپور
اراضی	اراضی
جک	جک
اوْن	اون
لیلک	لیلک
کیمی	کیمی
دو	دو
نتیجه	نتیجه
قانون	قانون
قرن	قرن
مثلاً	مثلاً
ناحیه	ناحیه
اویغور	اویغور
میلادی	میلادی
جر	جر
حر	حر
زه	زه
لت	لت
لش	لش
کز	کز
کو	کو
ارث	ارث
اسب	اسب
اکو	اکو
بهی	بهی
بچه	بچه
خشک	خشک
خون	خون
دم	دم
دوش	دوش
ذوب	ذوب
رنا	رنا
زال	زال
زان	زان
زهر	زهر
سبک	سبک
سن	سن
سهل	سهل
سیک	سیک
فرح	فرح
فسا	فسا
قشم	قشم
لنز	لنز
مدح	مدح
مسا	مسا
نسل	نسل
نقی	نقی
هتل	هتل
هلر	هلر
هوش	هوش
پسر	پسر
پیپ	پیپ
کرس	کرس
کیش	کیش
گوک	گوک
بابا	بابا
مال	مال
پی	پی
قدر	قدر
آمپر	آمپر
آیوا	آیوا
ارتش	ارتش
ارلی	ارلی
الی	الی
امجد	امجد
بار	بار
بایا	بایا
بدنه	بدنه
برتر	برتر
بستک	بستک
بسیط	بسیط
بیضی	بیضی
تایم	تایم
تایپ	تایپ
تحفه	تحفه
تلاش	تلاش
تنها	تنها
توبه	توبه
توتو	توتو
توْن	تون
توپ	توپ
جاوه	جاوه
جرگه	جرگه
جلفا	جلفا
جویل	جویل
حجاج	حجاج
حجاز	حجاز
خالی	خالی
دره	دره
درگه	درگه
دیسک	دیسک
ذکاء	ذکاء
روی	روی
ریشه	ریشه
ریمه	ریمه
زرند	زرند
زولا	زولا
زیبا	زیبا
سابق	سابق
سیول	سیول
شعور	شعور
صافی	صافی
صبحی	صبحی
صعود	صعود
عبدل	عبدل
عقیل	عقیل
عمال	عمال
غفور	غفور
غیاث	غیاث
فنون	فنون
فهمی	فهمی
فومن	فومن
فیتز	فیتز
قباد	قباد
قلات	قلات
قیاس	قیاس
لادی	لادی
مؤمن	مؤمن
مری	مری
مزون	مزون
مسلک	مسلک
ممکن	ممکن
مهنا	مهنا
نالی	نالی
نامی	نامی
نرون	نرون
نطنز	نطنز
نقدی	نقدی
نور	نور
هابل	هابل
هاله	هاله
ولتر	ولتر
ویدا	ویدا
پلاس	پلاس
پیوس	پیوس
کاتب	کاتب
کادو	کادو
کارد	کارد
کروم	کروم
کعبه	کعبه
کورس	کورس
کیفر	کیفر
گوگل	گوگل
یارو	یارو
یزدی	یزدی
ییل	ییل
شرقی	شرقی
سایی	سایی
احکام	احکام
استوا	استوا
بانک	بانک
برندی	برندی
بهادر	بهادر
بوران	بوران
تابلو	تابلو
توابع	توابع
توصیف	توصیف
تومور	تومور
جاذبه	جاذبه
جوزف	جوزف
جوکار	جوکار
جیانی	جیانی
حاتمی	حاتمی
حجازی	حجازی
حماسه	حماسه
حمیده	حمیده
حکایت	حکایت
داداش	داداش
دورود	دورود
دَیری	دیری
رحیمی	رحیمی
رودسر	رودسر
زلیخا	زلیخا
زنگنه	زنگنه
ساعدی	ساعدی
سالاد	سالاد
سرویس	سرویس
سعیدی	سعیدی
سفینه	سفینه
سوغات	سوغات
سیمرغ	سیمرغ
شانسی	شانسی
شهیدی	شهیدی
صابری	صابری
صداقت	صداقت
طالعی	طالعی
طاهری	طاهری
عطایی	عطایی
عیلام	عیلام
غزالی	غزالی
فریده	فریده
فوران	فوران
قطران	قطران
مأمور	مأمور
مایلی	مایلی
مجالس	مجالس
مدنی	مدنی
مرامی	مرامی
مرعشی	مرعشی
مسلکی	مسلکی
مشترک	مشترک
مشروع	مشروع
معصوم	معصوم
مهارت	مهارت
میلر	میلر
نینوا	نینوا
هانوی	هانوی
واکر	واکر
واگنر	واگنر
ووهان	ووهان
پوتین	پوتین
پیرس	پیرس
پیلوت	پیلوت
پیکان	پیکان
چلبی	چلبی
کلود	کلود
کوبا	کوبا
کوره	کوره
کوری	کوری
کومو	کومو
یاران	یاران
یاسوج	یاسوج
یوسف	یوسف
یوسفی	یوسفی
صوفیه	صوفیه
آن	آن
مرکزی	مرکزی
آشتیان	آشتیان
ابرکوه	ابرکوه
اخلاق	اخلاق
ادیتور	ادیتور
استادی	استادی
اسکینر	اسکینر
اشرفیه	اشرفیه
السلام	السلام
بارانی	بارانی
براهنی	براهنی
بیله	بیله
تهرانی	تهرانی
جعفری	جعفری
دهقانی	دهقانی
سرچشمه	سرچشمه
سنگلاخ	سنگلاخ
سودان	سودان
شعبانی	شعبانی
شیرعلی	شیرعلی
علیشاه	علیشاه
عمومیت	عمومیت
فارابی	فارابی
فریبرز	فریبرز
لوکاس	لوکاس
لیندا	لیندا
مبارکی	مبارکی
محاصره	محاصره
مدت	مدت
مرجانی	مرجانی
مریوان	مریوان
مسابقه	مسابقه
منازعه	منازعه
موریس	موریس
کین	کین
نظامی	نظامی
هشترود	هشترود
پادگان	پادگان
کارمین	کارمین
کازرون	کازرون
کچه	کچه
مکّه	مکه
سیاستی	سیاستی
آرمیتاژ	آرمیتاژ
اسکارلت	اسکارلت
اشتاینر	اشتاینر
ایندیرا	ایندیرا
بلومبرگ	بلومبرگ
بهمنیار	بهمنیار
تراکتور	تراکتور
ترک	ترک
پیر	پیر
جوردانو	جوردانو
دوبلین	دوبلین
زنگی	زنگی
سمبولیک	سمبولیک
سوادکوه	سوادکوه
عالم	عالم
عبدالحق	عبدالحق
عجب	عجب
علیزاده	علیزاده
قرارداد	قرارداد
لیسبون	لیسبون
مایورکا	مایورکا
منبع	منبع
نیشابور	نیشابور
والی	والی
پاسکوال	پاسکوال
کاپیتال	کاپیتال
کروزیرو	کروزیرو
گول	گول
یازی	یازی
سین	سین
وینستون	وینستون
آیی	آیی
شخص	شخص
آذری	آذری
آنارشیست	آنارشیست
استراتژی	استراتژی
اطراف	اطراف
بی	بی
تئوریسین	تئوریسین
تشکیلات	تشکیلات
تومیسلاو	تومیسلاو
جنازه	جنازه
حاجی	حاجی
خسته	خسته
چو	چو
شیعه	شیعه
عبدالله	عبدالله
عزت	عزت
الله	الله
علاالدین	علاالدین
فرماندهی	فرماندهی
فیروزکوه	فیروزکوه
قبیله	قبیله
قلعه	قلعه
ماکسیموس	ماکسیموس
محکمه	محکمه
مرحله	مرحله
مسیحی	مسیحی
نتانیاهو	نتانیاهو
والنتینا	والنتینا
والنتینو	والنتینو
پاشازاده	پاشازاده
پروسه	پروسه
یاری	یاری
آمریکا	آمریکا
الکساندر	الکساندر
انرژی	انرژی
اوّلین	اولین
چی	چی
دوست	دوست
صحنه	صحنه
عبدالمطلب	عبدالمطلب
عبدالهادی	عبدالهادی
سوز	سوز
قاپی	قاپی
مقاله	مقاله
گیتی	گیتی
پسند	پسند
کان	کان
عبارت	عبارت
خاقان	خاقان
سینا	سینا
نعمان	نعمان
زاده	زاده
موْسّسه	موسسه
اون	اون
شبکه	شبکه
کله	کله
دموکراسی	دموکراسی
نده	نده
ویل	ویل
وظیفه	وظیفه
محصول	محصول
محمد	محمد
برج	برج
عامل	عامل
ایذه	ایذه
بافر	بافر
بعضاً	بعضاً
سیسیل	سیسیل
تألیف	تألیف
باستان	باستان
لاتزیو	لاتزیو
بسته	بسته
شاه	شاه
بوز	بوز
آه	آه
نک	نک
گز	گز
یل	یل
آید	آید
اوش	اوش
برس	برس
بوس	بوس
بیم	بیم
تیس	تیس
خرم	خرم
خره	خره
خیر	خیر
ربع	ربع
ردا	ردا
ریا	ریا
ریش	ریش
شرر	شرر
شفق	شفق
شوت	شوت
صحت	صحت
طاق	طاق
ظلم	ظلم
عزل	عزل
عفو	عفو
فیث	فیث
قطع	قطع
لوت	لوت
مره	مره
مزا	مزا
مشق	مشق
هلی	هلی
هما	هما
پتک	پتک
پژو	پژو
کلن	کلن
کمر	کمر
کیر	کیر
کیک	کیک
گلی	گلی
آتن	آتن
سال	سال
پوْل	پول
دار	دار
آتنا	آتنا
آهنگ	آهنگ
آواز	آواز
ابله	ابله
اسکو	اسکو
الیه	الیه
ایر	ایر
بافت	بافت
برنو	برنو
بوْل	بول
بیرز	بیرز
بیست	بیست
تابو	تابو
جراح	جراح
جرمن	جرمن
حبشی	حبشی
حلقه	حلقه
حیله	حیله
خیام	خیام
دلیر	دلیر
رفیع	رفیع
روده	روده
سنجی	سنجی
سوژه	سوژه
سیده	سیده
سیرک	سیرک
شدید	شدید
شفاف	شفاف
شیره	شیره
شیوا	شیوا
عوام	عوام
فتوا	فتوا
فیات	فیات
فیجی	فیجی
قابل	قابل
قریب	قریب
قریش	قریش
قیسی	قیسی
لسان	لسان
مطلب	مطلب
میس	میس
نرگس	نرگس
نیتی	نیتی
هومن	هومن
واثق	واثق
ورلد	ورلد
پاس	پاس
پتیت	پتیت
چلیک	چلیک
چنار	چنار
کمیت	کمیت
کنان	کنان
کوبی	کوبی
کینز	کینز
کیو	کیو
یوکا	یوکا
اکبر	اکبر
دیلی	دیلی
حربی	حربی
عادت	عادت
اولا	اولا
آشوری	آشوری
آموزش	آموزش
اجنبی	اجنبی
اریک	اریک
اطاعت	اطاعت
اللهی	اللهی
اوّل	اول
اکستر	اکستر
باهنر	باهنر
بایدن	بایدن
بلقیس	بلقیس
بورن	بورن
تالیا	تالیا
تبریک	تبریک
تقدیر	تقدیر
تورات	تورات
جباری	جباری
حنظله	حنظله
حنیفه	حنیفه
خاتمی	خاتمی
خلدون	خلدون
دستان	دستان
دفعه	دفعه
دلالت	دلالت
دیکنز	دیکنز
راگبی	راگبی
رسامی	رسامی
رفتار	رفتار
روبات	روبات
ریاحی	ریاحی
زارعی	زارعی
سالاس	سالاس
سلامت	سلامت
سیاره	سیاره
شاهان	شاهان
شیخان	شیخان
صومعه	صومعه
طریقی	طریقی
عاملی	عاملی
عریضه	عریضه
عسگر	عسگر
فردین	فردین
فهرست	فهرست
قابوس	قابوس
قافیه	قافیه
لوتوس	لوتوس
مادام	مادام
ماری	ماری
مانور	مانور
ماهیت	ماهیت
متولی	متولی
مجسمه	مجسمه
مدیری	مدیری
مساعد	مساعد
مسکو	مسکو
مطهری	مطهری
معیار	معیار
مقطوع	مقطوع
مملکت	مملکت
منزوی	منزوی
مهندس	مهندس
ناروا	ناروا
نسرین	نسرین
نصیری	نصیری
هالو	هالو
هزینه	هزینه
پرودی	پرودی
پژمان	پژمان
گونش	گونش
گیتار	گیتار
ینگجه	ینگجه
تهران	تهران
آرتیست	آرتیست
احتمال	احتمال
ادریسی	ادریسی
ادیشن	ادیشن
استار	استار
استیشن	استیشن
اقتدار	اقتدار
املاکی	املاکی
اوریون	اوریون
باخ	باخ
بهادری	بهادری
تارتار	تارتار
حاجیان	حاجیان
حجم	حجم
راجرز	راجرز
زحمتکش	زحمتکش
جبه	جبه
سازمان	سازمان
سسیلیا	سسیلیا
سلطان	سلطان
سیدنی	سیدنی
نا	نا
شفچنکو	شفچنکو
قوت	قوت
مدیسن	مدیسن
ممفیس	ممفیس
منتظری	منتظری
منصوره	منصوره
مکتبی	مکتبی
هاردی	هاردی
وزیری	وزیری
ویتمور	ویتمور
پایینی	پایینی
پریشان	پریشان
پیروزی	پیروزی
کاشغری	کاشغری
کاکتوس	کاکتوس
گودرزی	گودرزی
یوجین	یوجین
تاشکند	تاشکند
سوسیال	سوسیال
دموکرات	دموکرات
آغاجاری	آغاجاری
آپاراتی	آپاراتی
استالین	استالین
استنلی	استنلی
اسپنسر	اسپنسر
الیویرا	الیویرا
اولیویه	اولیویه
تحقیقات	تحقیقات
تل	تل
جانسون	جانسون
جمهوریت	جمهوریت
جونینیو	جونینیو
خیرآباد	خیرآباد
روزنامه	روزنامه
رومانوس	رومانوس
سمرقند	سمرقند
سپیدرود	سپیدرود
فیلسوف	فیلسوف
مارتینی	مارتینی
محمدپور	محمدپور
مقصودلو	مقصودلو
ملکه	ملکه
نوْرمال	نورمال
هارمونی	هارمونی
هامفریز	هامفریز
هانوور	هانوور
هاوانا	هاوانا
هدیه	هدیه
هسته	هسته
هوستون	هوستون
وستفالی	وستفالی
وینسنت	وینسنت
ژانویهٔ	ژانویه
کاترین	کاترین
کلاسیک	کلاسیک
گله	گله
گلینه	گلینه
نیویورک	نیویورک
آمریکایی	آمریکایی
ارمنستان	ارمنستان
الکتریکی	الکتریکی
امیلیانو	امیلیانو
بیولوژیک	بیولوژیک
جمعیت	جمعیت
خسروشاهی	خسروشاهی
دیکتاتور	دیکتاتور
ساوجبلاغ	ساوجبلاغ
شاهی	شاهی
یا	یا
مارادونا	مارادونا
مرامنامه	مرامنامه
هلیکوپتر	هلیکوپتر
پترزبورگ	پترزبورگ
چنگیزخان	چنگیزخان
کلمه	کلمه
نیندا	نیندا
دوسلدورف	دوسلدورف
المپیاکوس	المپیاکوس
سوار	سوار
سولفات	سولفات
عالمی	عالمی
مواضع	مواضع
خان	خان
هرتابرلین	هرتابرلین
کنارین	کنارین
کول	کول
آستین	آستین
نیر	نیر
بازاری	بازاری
بوئین	بوئین
زهرا	زهرا
سری	سری
طریقتی	طریقتی
قال	قال
مقدونیه	مقدونیه
خیابانی	خیابانی
داستانی	داستانی
دایره	دایره
مارکوس	مارکوس
کار	کار
زینال	زینال
رشت	رشت
برق	برق
سریال	سریال
اساساً	اساساً
ساز	ساز
ماه	ماه
آج	آج
تب	تب
دد	دد
شط	شط
آتو	آتو
آخر	آخر
آلو	آلو
جشن	جشن
حذف	حذف
ددی	ددی
دلو	دلو
دمی	دمی
ریق	ریق
زیر	زیر
سکو	سکو
غذا	غذا
غضب	غضب
فلش	فلش
قطب	قطب
متل	متل
مثل	مثل
ناب	ناب
نجه	نجه
نقد	نقد
نیم	نیم
هرم	هرم
هور	هور
پدر	پدر
پنس	پنس
چشم	چشم
چله	چله
کبک	کبک
کنه	کنه
انار	انار
انگل	انگل
اوُل	اول
باله	باله
بشار	بشار
بندی	بندی
تایی	تایی
تیان	تیان
ثالث	ثالث
ثقفی	ثقفی
حبشه	حبشه
حساس	حساس
حیفا	حیفا
خطاط	خطاط
خیار	خیار
دیلم	دیلم
رازی	رازی
رزین	رزین
رود	رود
روکه	روکه
سارد	سارد
سبعه	سبعه
سبیل	سبیل
سروش	سروش
سیلی	سیلی
صندل	صندل
صیاد	صیاد
طوسی	طوسی
عقبه	عقبه
غفار	غفار
فروغ	فروغ
فلات	فلات
فلیپ	فلیپ
قدری	قدری
قرچک	قرچک
لوقا	لوقا
لیتر	لیتر
مایه	مایه
مدوز	مدوز
مرمر	مرمر
مقدم	مقدم
ملکم	ملکم
منطق	منطق
مولن	مولن
مونو	مونو
نوحه	نوحه
نورس	نورس
هرتا	هرتا
هریک	هریک
هنکس	هنکس
هوار	هوار
وجود	وجود
وقتی	وقتی
ونوس	ونوس
ویسی	ویسی
پرور	پرور
پین	پین
ژانر	ژانر
کلاس	کلاس
کمری	کمری
کمپو	کمپو
کوزه	کوزه
دمشق	دمشق
شناس	شناس
غربی	غربی
قمری	قمری
وردی	وردی
آرمین	آرمین
آزاده	آزاده
آساهی	آساهی
احمد	احمد
ادوار	ادوار
الوار	الوار
امانی	امانی
اوتو	اوتو
اکبری	اکبری
ایلیچ	ایلیچ
باغچه	باغچه
بخاری	بخاری
بیانی	بیانی
تصحیح	تصحیح
جبران	جبران
جدید	جدید
جزایر	جزایر
جلیلی	جلیلی
جنایت	جنایت
جواهر	جواهر
خندان	خندان
درگاه	درگاه
دهخدا	دهخدا
دهقان	دهقان
رادار	رادار
راستا	راستا
ربانی	ربانی
رجایی	رجایی
زردشت	زردشت
زندیه	زندیه
ساواک	ساواک
سبلان	سبلان
سلسله	سلسله
سلیمی	سلیمی
سنگال	سنگال
سیاحی	سیاحی
شفیعی	شفیعی
شوستر	شوستر
صورتی	صورتی
طبابت	طبابت
عادتا	عادتا
غریبی	غریبی
فاضلی	فاضلی
فرارا	فرارا
فرشید	فرشید
فلاکت	فلاکت
قاضی	قاضی
لامرد	لامرد
لطیفی	لطیفی
لوتر	لوتر
لوسیو	لوسیو
مظلوم	مظلوم
معاصر	معاصر
مقبول	مقبول
منظور	منظور
میناب	میناب
نفتچی	نفتچی
هاینس	هاینس
هلنا	هلنا
واین	واین
وْفات	وفات
ویسکی	ویسکی
پروست	پروست
پورشه	پورشه
پوریا	پوریا
چلسی	چلسی
کاشان	کاشان
کاشغر	کاشغر
کایزر	کایزر
کرمان	کرمان
کلینی	کلینی
یورگن	یورگن
اعصاب	اعصاب
ژنرال	ژنرال
وضعیت	وضعیت
آرا	آرا
آسفالت	آسفالت
آناتول	آناتول
ارجمند	ارجمند
اردوان	اردوان
اردکان	اردکان
اسپیرو	اسپیرو
الیوت	الیوت
امپولی	امپولی
اودیسه	اودیسه
اوستیا	اوستیا
بالفور	بالفور
برگزار	برگزار
تلاویو	تلاویو
حکایتِ	حکایت
خصوصیت	خصوصیت
دارایی	دارایی
رضاخان	رضاخان
رهبری	رهبری
طالبان	طالبان
عبرانی	عبرانی
فرکانس	فرکانس
لهستان	لهستان
لیندون	لیندون
مبارزه	مبارزه
محمود	محمود
مزه	مزه
معمولی	معمولی
مهندسی	مهندسی
مورگان	مورگان
نسیمی	نسیمی
نشریات	نشریات
وایلدر	وایلدر
ورامین	ورامین
پالمر	پالمر
پلاسما	پلاسما
ژنرالی	ژنرالی
کازینو	کازینو
کمپ	کمپ
بل	بل
یادگار	یادگار
یونیزه	یونیزه
فرانسه	فرانسه
ژانویه	ژانویه
آبخازیا	آبخازیا
آدریان	آدریان
بری	بری
تبریزی	تبریزی
دیکسون	دیکسون
رومانی	رومانی
ساندویچ	ساندویچ
ساوانا	ساوانا
قاره	قاره
قتل	قتل
عام	عام
قفقازیه	قفقازیه
مرغداری	مرغداری
مسئولیت	مسئولیت
مونترال	مونترال
لارن	لارن
میشائیل	میشائیل
هاوکینگ	هاوکینگ
ورزشگاه	ورزشگاه
ویکتور	ویکتور
کرایسلر	کرایسلر
گزمه	گزمه
گنجه	گنجه
اسکیت	اسکیت
برلین	برلین
سیاهی	سیاهی
شرایط	شرایط
صحیفه	صحیفه
عباس	عباس
فضل	فضل
مراغه	مراغه
وسیله	وسیله
پالادیوم	پالادیوم
کاوازاکی	کاوازاکی
کیپ	کیپ
گیلان	گیلان
ادبیات	ادبیات
ارمنی	ارمنی
برنامه	برنامه
سولفور	سولفور
راک	راک
ساسانی	ساسانی
سوسیالیزم	سوسیالیزم
سیستم	سیستم
عبدالحلیم	عبدالحلیم
کارلسروهه	کارلسروهه
باش	باش
مشغول	مشغول
لارا	لارا
حاکمیّت	حاکمیت
حسام	حسام
رسول	رسول
فردوسی	فردوسی
ملاعبدالله	ملاعبدالله
بوْدجه	بودجه
کلیسا	کلیسا
مدرسه	مدرسه
پارتی	پارتی
اصل	اصل
عرب	عرب
بندر	بندر
مشهد	مشهد
آمار	آمار
بابک	بابک
امیلیا	امیلیا
بریتانیا	بریتانیا
قبول	قبول
آبا	آبا
بحر	بحر
بنک	بنک
بوم	بوم
بکت	بکت
تاپ	تاپ
ترم	ترم
تهم	تهم
خری	خری
درب	درب
دوا	دوا
ذکا	ذکا
رضی	رضی
سدر	سدر
شرم	شرم
قبر	قبر
لول	لول
مرز	مرز
میو	میو
هار	هار
پشت	پشت
پپه	پپه
چهل	چهل
کود	کود
چاپ	چاپ
آتشی	آتشی
آرین	آرین
اشیا	اشیا
اژدر	اژدر
بانه	بانه
بخار	بخار
بنده	بنده
بوْش	بوش
تاخت	تاخت
تاری	تاری
توْی	توی
تیمز	تیمز
جاوا	جاوا
جنین	جنین
حداد	حداد
حلیم	حلیم
خانم	خانم
دارو	دارو
داکا	داکا
دوبی	دوبی
ذهنی	ذهنی
راوی	راوی
رقیه	رقیه
روبل	روبل
روح	روح
روم	روم
زینت	زینت
ساند	ساند
سیرو	سیرو
شرور	شرور
شوقی	شوقی
شیلر	شیلر
صمدی	صمدی
طویل	طویل
غانم	غانم
غزال	غزال
فرضی	فرضی
فریز	فریز
فوتو	فوتو
فونت	فونت
قائل	قائل
قاپ	قاپ
قلمی	قلمی
لینک	لینک
مبین	مبین
مجله	مجله
مرمت	مرمت
مصدق	مصدق
مهری	مهری
مواد	مواد
نزار	نزار
نیشی	نیشی
نیون	نیون
پاکو	پاکو
پرنس	پرنس
پنجه	پنجه
کاین	کاین
کرمی	کرمی
کوتس	کوتس
کیلو	کیلو
گیرم	گیرم
شیلی	شیلی
لستر	لستر
اشعار	اشعار
اصغری	اصغری
الماس	الماس
ایلی	ایلی
باروت	باروت
بندری	بندری
ترجیح	ترجیح
تفلیس	تفلیس
تلخاب	تلخاب
جالوت	جالوت
جهالت	جهالت
حمایت	حمایت
داربی	داربی
دانا	دانا
دودلی	دودلی
دوْست	دوست
دیابت	دیابت
زاهدی	زاهدی
زمانه	زمانه
سایکس	سایکس
سعدون	سعدون
شماره	شماره
شهادت	شهادت
صالحی	صالحی
صنعت	صنعت
عدلیه	عدلیه
عمارت	عمارت
لاهور	لاهور
محسنی	محسنی
مرثیه	مرثیه
مرسوم	مرسوم
مساله	مساله
معرفت	معرفت
منفعت	منفعت
میترا	میترا
نستور	نستور
هایکو	هایکو
هنری	هنری
پاندا	پاندا
پنجره	پنجره
چاپار	چاپار
کروز	کروز
کنگره	کنگره
مدینه	مدینه
کیوتو	کیوتو
آوریل	آوریل
آتش	آتش
کس	کس
آلیسیا	آلیسیا
آندورا	آندورا
استیلی	استیلی
اکران	اکران
بلفاست	بلفاست
بهرامی	بهرامی
دالاس	دالاس
دربند	دربند
درمانی	درمانی
دستجرد	دستجرد
رابرتز	رابرتز
زاپاتا	زاپاتا
زعفران	زعفران
سرداری	سرداری
سزارین	سزارین
سلسیوس	سلسیوس
شاهپور	شاهپور
شدت	شدت
شکسپیر	شکسپیر
فرانکس	فرانکس
فونتیک	فونتیک
فیوضات	فیوضات
لاریسا	لاریسا
لودویک	لودویک
محمودی	محمودی
مرزبان	مرزبان
مقایسه	مقایسه
میلان	میلان
نخجوان	نخجوان
پارانا	پارانا
پاستور	پاستور
پاکدشت	پاکدشت
پروپان	پروپان
کاستنر	کاستنر
کلانتر	کلانتر
گلوریا	گلوریا
ابوظبی	ابوظبی
ملبورن	ملبورن
آلباسته	آلباسته
آناتومی	آناتومی
احمدشاه	احمدشاه
استریت	استریت
اسکانیا	اسکانیا
اصفهانی	اصفهانی
اکسفورد	اکسفورد
ترانسفر	ترانسفر
جوانشیر	جوانشیر
درین	درین
دنیلسون	دنیلسون
رنگارنگ	رنگارنگ
سانتافه	سانتافه
سنترال	سنترال
سیلیکون	سیلیکون
شیوه	شیوه
قارچ	قارچ
لندن	لندن
مانچینی	مانچینی
مندلسون	مندلسون
موْلکول	مولکول
میکاییل	میکاییل
هانیبال	هانیبال
ویتوریو	ویتوریو
وینچنزو	وینچنزو
کشاورزی	کشاورزی
آلپ	آلپ
والنسیا	والنسیا
آل	آل
ابراهیم	ابراهیم
احمدزاده	احمدزاده
ترجمه	ترجمه
کند	کند
حادثه	حادثه
سانتیمتر	سانتیمتر
سیاهه	سیاهه
سیخ	سیخ
شعری	شعری
علیمردان	علیمردان
قائم	قائم
شهر	شهر
مدیترانه	مدیترانه
کوئین	کوئین
نیوکاسل	نیوکاسل
کاردینال	کاردینال
یاروسلاو	یاروسلاو
کاری	کاری
بیزانس	بیزانس
تاج	تاج
زین	زین
سرکرده	سرکرده
عبدالناصر	عبدالناصر
فیروزآباد	فیروزآباد
ویکی	ویکی
سنت	سنت
آنتونیو	آنتونیو
فرانکفورت	فرانکفورت
ندا	ندا
فوریه	فوریه
موسیقی	موسیقی
آخوندزاده	آخوندزاده
ملا	ملا
اهواز	اهواز
تبریز	تبریز
بلژیک	بلژیک
روستا	روستا
هد	هد
گن	گن
ارس	ارس
ارگ	ارگ
اسی	اسی
الو	الو
تپی	تپی
حقی	حقی
حله	حله
دفع	دفع
ری	ری
ریف	ریف
فرر	فرر
فعل	فعل
قیس	قیس
وبا	وبا
ورم	ورم
وصف	وصف
ولت	ولت
کتل	کتل
کوخ	کوخ
گرد	گرد
حلب	حلب
ولز	ولز
آف	آف
فرانس	فرانس
فرانسوا	فرانسوا
آرنت	آرنت
آریا	آریا
آزار	آزار
آمون	آمون
ایرن	ایرن
باده	باده
برات	برات
برست	برست
بشری	بشری
بیشه	بیشه
تولی	تولی
جنگی	جنگی
جوجه	جوجه
حرام	حرام
داده	داده
داش	داش
دیزل	دیزل
دیزه	دیزه
رمان	رمان
روزی	روزی
ریسی	ریسی
رینر	رینر
سنبل	سنبل
شیرو	شیرو
عاصی	عاصی
قاز	قاز
لند	لند
لوکی	لوکی
مارچ	مارچ
ماله	ماله
مجاز	مجاز
مصر	مصر
مطرح	مطرح
معمر	معمر
مورد	مورد
موسس	موسس
مولا	مولا
نقاش	نقاش
نقشی	نقشی
نویس	نویس
هزار	هزار
واقف	واقف
ورقه	ورقه
ویت	ویت
پریش	پریش
پویا	پویا
پیرو	پیرو
پیکو	پیکو
چاره	چاره
کتان	کتان
کرون	کرون
کلاب	کلاب
کنون	کنون
کولر	کولر
گریس	گریس
گنبد	گنبد
گوشه	گوشه
یارد	یارد
اختر	اختر
آباده	آباده
آقاسی	آقاسی
اتهام	اتهام
اشغال	اشغال
افیون	افیون
اهرام	اهرام
اوبری	اوبری
اولیا	اولیا
باتری	باتری
باکری	باکری
برنت	برنت
توصیه	توصیه
توکلی	توکلی
حاشیه	حاشیه
حسابی	حسابی
حقوقی	حقوقی
خالق	خالق
خلیجی	خلیجی
دینار	دینار
ساران	ساران
شعیری	شعیری
شناسی	شناسی
شکرین	شکرین
شیمون	شیمون
صرّاف	صراف
طبیب	طبیب
طراحی	طراحی
عراقی	عراقی
علمی	علمی
فلیپه	فلیپه
قیامی	قیامی
لیمون	لیمون
محیطی	محیطی
مردان	مردان
مقدمه	مقدمه
مقصود	مقصود
ممالک	ممالک
منامه	منامه
مندرس	مندرس
موضوع	موضوع
نشریه	نشریه
هیلمن	هیلمن
وارد	وارد
پایان	پایان
چایی	چایی
کارور	کارور
کمال	کمال
کمیته	کمیته
کیوان	کیوان
گلزار	گلزار
سوریه	سوریه
آدامز	آدامز
آلماتی	آلماتی
آیدین	آیدین
استارت	استارت
استون	استون
استیفن	استیفن
اسمیت	اسمیت
اسوالد	اسوالد
اعتراف	اعتراف
امتیاز	امتیاز
امیری	امیری
انسانی	انسانی
ایمانی	ایمانی
برکلی	برکلی
بهزادی	بهزادی
تحصیل	تحصیل
دامغان	دامغان
دیویس	دیویس
شمالی	شمالی
شیبانی	شیبانی
فرخزاد	فرخزاد
قندهار	قندهار
لودویگ	لودویگ
ماریا	ماریا
محمدیه	محمدیه
مقصودی	مقصودی
مورفی	مورفی
نیکیتا	نیکیتا
پلیکان	پلیکان
کامیون	کامیون
کلرادو	کلرادو
کپیتال	کپیتال
بولتون	بولتون
آرنولد	آرنولد
آنتونی	آنتونی
باقرخان	باقرخان
تاسمانی	تاسمانی
توماسون	توماسون
جغرافیا	جغرافیا
روتردام	روتردام
سوانسون	سوانسون
صدراعظم	صدراعظم
قرارگاه	قرارگاه
نوْامبر	نوامبر
معلومات	معلومات
آدریاتیک	آدریاتیک
آروماتیک	آروماتیک
آنتونیوس	آنتونیوس
اکونومیک	اکونومیک
سل	سل
بیولوژی	بیولوژی
تامپسون	تامپسون
دومینیکن	دومینیکن
طرفین	طرفین
اصغر	اصغر
فینال	فینال
قروه	قروه
لاس	لاس
مارکسیست	مارکسیست
ماستریخت	ماستریخت
محمدخانی	محمدخانی
محمدصادق	محمدصادق
ممه	ممه
پاختاکور	پاختاکور
پناه	پناه
کوردوبا	کوردوبا
عبدالرشید	عبدالرشید
لطیف	لطیف
مظفرالدین	مظفرالدین
میدان	میدان
پلوتونیوم	پلوتونیوم
جمیل	جمیل
اوغلو	اوغلو
دیوانی	دیوانی
ماشین	ماشین
سازی	سازی
ژورنالیست	ژورنالیست
آنتروپولوژی	آنتروپولوژی
داستان	داستان
هر	هر
بعضی	بعضی
عمان	عمان
پلیس	پلیس
هملت	هملت
آلمان	آلمان
قبه	قبه
آکادمیک	آکادمیک
دف	دف
آرک	آرک
آهو	آهو
بتا	بتا
بسی	بسی
تلر	تلر
دعا	دعا
رحم	رحم
سکه	سکه
صبر	صبر
صدا	صدا
فرض	فرض
قصه	قصه
لام	لام
مرد	مرد
منا	منا
موش	موش
ناو	ناو
نحو	نحو
هدی	هدی
همه	همه
هند	هند
هگل	هگل
وصل	وصل
وند	وند
پس	پس
پیچ	پیچ
گنه	گنه
چین	چین
تبت	تبت
اسلو	اسلو
اوْخ	اوخ
باهر	باهر
بدوی	بدوی
بویی	بویی
تاچر	تاچر
ترقی	ترقی
تسوج	تسوج
تیم	تیم
جوهر	جوهر
جویی	جویی
حالت	حالت
حدود	حدود
خزعل	خزعل
خنجر	خنجر
خویی	خویی
دقتی	دقتی
دوما	دوما
دیار	دیار
دیتا	دیتا
رشدی	رشدی
ریسک	ریسک
ساتن	ساتن
سلاح	سلاح
سلبی	سلبی
سهیل	سهیل
سیفی	سیفی
شاخه	شاخه
شامل	شامل
شهرت	شهرت
شیخی	شیخی
شیری	شیری
صراف	صراف
عابد	عابد
علاء	علاء
عموم	عموم
فری	فری
قدرت	قدرت
قریه	قریه
قولی	قولی
لنون	لنون
لیزی	لیزی
مازه	مازه
متین	متین
مثبت	مثبت
مصعب	مصعب
منزل	منزل
موصل	موصل
نایب	نایب
ندیم	ندیم
نوبر	نوبر
هریت	هریت
هیثم	هیثم
وعده	وعده
پایا	پایا
چیرو	چیرو
چینو	چینو
کامو	کامو
کونه	کونه
کوچک	کوچک
کندی	کندی
ناتو	ناتو
نون	نون
آبادی	آبادی
آلفا	آلفا
آنزیم	آنزیم
اقلیت	اقلیت
انبار	انبار
اَسکی	اسکی
بخارا	بخارا
حسینه	حسینه
خسروی	خسروی
خلاصه	خلاصه
داخلی	داخلی
دفتری	دفتری
ذخیره	ذخیره
راسل	راسل
قارّه	قاره
قناعت	قناعت
مسکون	مسکون
مسینا	مسینا
مشورت	مشورت
معتصم	معتصم
منصوب	منصوب
منظره	منظره
مهدوی	مهدوی
مینسک	مینسک
میچل	میچل
نادری	نادری
نیازی	نیازی
هاملت	هاملت
پردیس	پردیس
پیشوا	پیشوا
ژاکوب	ژاکوب
ژولیت	ژولیت
کاستا	کاستا
کرست	کرست
کوران	کوران
عادی	عادی
آستانه	آستانه
اشکانی	اشکانی
امارات	امارات
انگلیس	انگلیس
بودایی	بودایی
تایسون	تایسون
تورنتو	تورنتو
رودریک	رودریک
زنجیره	زنجیره
سیا	سیا
فلاویو	فلاویو
فوْریه	فوریه
مدنیت	مدنیت
مورالس	مورالس
نیل	نیل
نوترون	نوترون
هخامنش	هخامنش
کاینات	کاینات
کریسمس	کریسمس
کشاورز	کشاورز
کوهسار	کوهسار
یونان	یونان
آمودریا	آمودریا
آنتالیا	آنتالیا
اطلاعات	اطلاعات
افغانی	افغانی
امرالله	امرالله
باجی	باجی
بوستون	بوستون
تنظیمات	تنظیمات
حمدالله	حمدالله
داوکینز	داوکینز
شهریار	شهریار
شهریاری	شهریاری
فرانسوی	فرانسوی
منچستر	منچستر
نامعلوم	نامعلوم
هاریسون	هاریسون
هیمالیا	هیمالیا
گنج	گنج
یاکوبسن	یاکوبسن
یهودیان	یهودیان
گه	گه
استانبول	استانبول
لا	لا
جایزه	جایزه
جعفرزاده	جعفرزاده
سانتاندر	سانتاندر
سمپدوریا	سمپدوریا
می	می
عبدالرضا	عبدالرضا
فدراسیون	فدراسیون
لهجه	لهجه
پالمیراس	پالمیراس
الکساندرو	الکساندرو
عبدالعظیم	عبدالعظیم
لوزالمعده	لوزالمعده
محمودآباد	محمودآباد
اسلام	اسلام
کورینتیانس	کورینتیانس
آنجلس	آنجلس
لوس	لوس
واسطه	واسطه
شیب	شیب
مربی	مربی
سایت	سایت
سد	سد
طه	طه
نم	نم
امن	امن
اوج	اوج
باج	باج
برم	برم
بیو	بیو
جنگ	جنگ
ذکر	ذکر
رند	رند
ریل	ریل
ریه	ریه
عطا	عطا
غرق	غرق
لیث	لیث
لیس	لیس
مرا	مرا
ناز	ناز
هیس	هیس
چیو	چیو
کاش	کاش
کدر	کدر
کلو	کلو
گره	گره
است	است
ارشد	ارشد
اموی	اموی
برنا	برنا
بنفش	بنفش
بهره	بهره
بوده	بوده
تروا	تروا
توسط	توسط
حضور	حضور
خمسه	خمسه
داری	داری
دامن	دامن
دنیا	دنیا
دوحه	دوحه
رادی	رادی
روشن	روشن
رینی	رینی
زرگر	زرگر
ساقی	ساقی
سوما	سوما
سیاح	سیاح
سیام	سیام
شانی	شانی
شرکت	شرکت
صحبت	صحبت
طوطی	طوطی
غالب	غالب
فانی	فانی
قویا	قویا
لودر	لودر
مانش	مانش
ماوس	ماوس
مخفی	مخفی
مطلق	مطلق
مغرب	مغرب
نسیم	نسیم
نینو	نینو
هاول	هاول
هایل	هایل
هوتن	هوتن
وایز	وایز
پترا	پترا
کیان	کیان
امان	امان
لیون	لیون
آلتو	آلتو
آلکسی	آلکسی
ادبی	ادبی
اروپا	اروپا
الموت	الموت
انجام	انجام
بنزین	بنزین
بوخوم	بوخوم
تجرید	تجرید
توفان	توفان
حمیدی	حمیدی
حیران	حیران
داراب	داراب
دروید	دروید
زیمنس	زیمنس
سهراب	سهراب
سیمین	سیمین
شومان	شومان
طوفان	طوفان
عایشه	عایشه
عنوان	عنوان
غلامی	غلامی
فاوست	فاوست
فاکتی	فاکتی
فرضیه	فرضیه
مالکی	مالکی
مجتمع	مجتمع
مرادی	مرادی
مسموم	مسموم
نجران	نجران
هندسه	هندسه
وادار	وادار
وثیقه	وثیقه
پیران	پیران
کراچی	کراچی
کمینه	کمینه
کوهلر	کوهلر
گیلاس	گیلاس
آغاجری	آغاجری
اخباری	اخباری
اصفهان	اصفهان
اکسپرس	اکسپرس
بخارست	بخارست
برانکو	برانکو
بیانات	بیانات
دارفور	دارفور
ریتمیک	ریتمیک
ساکسون	ساکسون
شاهرود	شاهرود
شهبازی	شهبازی
شوماخر	شوماخر
فوریهٔ	فوریه
فیودور	فیودور
مورسیا	مورسیا
مولکول	مولکول
میکاسا	میکاسا
هورمون	هورمون
پروانه	پروانه
چکی	چکی
کلارک	کلارک
کلینیک	کلینیک
یدالله	یدالله
یزدگرد	یزدگرد
یونسکو	یونسکو
اصیل	اصیل
بطلمیوس	بطلمیوس
دانشگاه	دانشگاه
شکیل	شکیل
شیر	شیر
لورنتزو	لورنتزو
مارگارت	مارگارت
میلیوْن	میلیون
نورتون	نورتون
هریسون	هریسون
ویلسون	ویلسون
کاتالان	کاتالان
کمبریج	کمبریج
علم	علم
بیرلیگی	بیرلیگی
محله	محله
مسئله	مسئله
مساحت	مساحت
مقصدی	مقصدی
مینیاتور	مینیاتور
خورم	خورم
صفوی	صفوی
قاب	قاب
معلوم	معلوم
مخصوص	مخصوص
نه	نه
دیلن	دیلن
رادیواکتیو	رادیواکتیو
والیبال	والیبال
ساییم	ساییم
برند	برند
عراق	عراق
وادی	وادی
دزفول	دزفول
زرداب	زرداب
ادل	ادل
بتس	بتس
بدل	بدل
بید	بید
توش	توش
دما	دما
دیز	دیز
سجع	سجع
شده	شده
صبا	صبا
عدن	عدن
عدی	عدی
فست	فست
فلز	فلز
لات	لات
لطف	لطف
لکی	لکی
مرو	مرو
مرگ	مرگ
هیچ	هیچ
وقف	وقف
چرخ	چرخ
چکه	چکه
کوچ	کوچ
گلر	گلر
آتشه	آتشه
آریو	آریو
بتون	بتون
بلی	بلی
بهشت	بهشت
بیکن	بیکن
تاکی	تاکی
تصور	تصور
تونل	تونل
ثروت	ثروت
جهنم	جهنم
جودت	جودت
خلجی	خلجی
دایی	دایی
رحمن	رحمن
رژیم	رژیم
ریو	ریو
ساکی	ساکی
سفره	سفره
شعر	شعر
شکری	شکری
عبری	عبری
عسکر	عسکر
غدیر	غدیر
فریر	فریر
لاسی	لاسی
محکم	محکم
مظفر	مظفر
مور	مور
موفق	موفق
میله	میله
نگار	نگار
نیست	نیست
هلمز	هلمز
ورنا	ورنا
وین	وین
کاشی	کاشی
کهنه	کهنه
گلیم	گلیم
گوجه	گوجه
گوهر	گوهر
لیدز	لیدز
کارل	کارل
آرویو	آرویو
اسارت	اسارت
استاد	استاد
افغان	افغان
البرز	البرز
اورست	اورست
تحریف	تحریف
جوْرج	جورج
خلیلی	خلیلی
دستور	دستور
رسّام	رسام
ریشار	ریشار
زیتون	زیتون
سلوکی	سلوکی
شقاقی	شقاقی
صدری	صدری
عالیه	عالیه
عزیزی	عزیزی
قریشی	قریشی
لطیفه	لطیفه
مانیل	مانیل
متیوز	متیوز
مجاهد	مجاهد
مجتهد	مجتهد
مجیدی	مجیدی
معارف	معارف
مودنا	مودنا
مینور	مینور
نایبی	نایبی
هادی	هادی
هاردن	هاردن
ورسای	ورسای
پاشا	پاشا
پلانک	پلانک
پوستر	پوستر
پیروز	پیروز
کارون	کارون
کوبه	کوبه
یعنی	یعنی
آدلاید	آدلاید
آرتور	آرتور
البته	البته
باتلر	باتلر
باغبان	باغبان
بانکوک	بانکوک
براندو	براندو
بیرونی	بیرونی
جاکومو	جاکومو
خیابان	خیابان
دیندار	دیندار
رابینز	رابینز
زنجان	زنجان
زنجانی	زنجانی
سیاست	سیاست
شبستری	شبستری
فرزانه	فرزانه
مستوفی	مستوفی
منصوری	منصوری
ناراضی	ناراضی
ونکوور	ونکوور
گلستان	گلستان
یرواند	یرواند
القاعده	القاعده
اوراسیا	اوراسیا
باستانی	باستانی
جشنواره	جشنواره
رونالدو	رونالدو
سیردریا	سیردریا
محمدخان	محمدخان
میخاییل	میخاییل
هلسینکی	هلسینکی
واتسون	واتسون
پتروویچ	پتروویچ
آکسفورد	آکسفورد
ادمیلسون	ادمیلسون
خورشیدی	خورشیدی
طباطبایی	طباطبایی
عبدالعلی	عبدالعلی
محمدسعید	محمدسعید
هاشیموتو	هاشیموتو
این	این
نعمت	نعمت
سایلی	سایلی
یونیورسال	یونیورسال
بستان	بستان
مجید	مجید
زیمبابوه	زیمبابوه
ملانصرالدین	ملانصرالدین
اسکی	اسکی
ساری	ساری
دژ	دژ
رپ	رپ
قر	قر
چت	چت
بشر	بشر
تفت	تفت
تیو	تیو
جذب	جذب
جیر	جیر
حجت	حجت
خور	خور
زاد	زاد
سار	سار
سرخ	سرخ
غیر	غیر
قید	قید
نیا	نیا
ولا	ولا
پدی	پدی
گهر	گهر
اردو	اردو
اوپن	اوپن
اَله	اله
بلوچ	بلوچ
بوبو	بوبو
بیدل	بیدل
توْپ	توپ
تیله	تیله
تیکه	تیکه
خارا	خارا
خیری	خیری
داعش	داعش
دجله	دجله
درای	درای
رغبت	رغبت
رونق	رونق
زارع	زارع
ساله	ساله
ساید	ساید
شاکر	شاکر
شجاع	شجاع
شکاک	شکاک
عشقی	عشقی
فیدل	فیدل
مدرس	مدرس
ملّی	ملّی
مهسا	مهسا
مونا	مونا
میشا	میشا
ناسا	ناسا
ناظر	ناظر
نشاط	نشاط
نصیر	نصیر
وحدت	وحدت
پارت	پارت
پیله	پیله
کارت	کارت
کلام	کلام
آپولو	آپولو
بلایا	بلایا
بنیتو	بنیتو
بیروت	بیروت
تارزن	تارزن
تبعید	تبعید
تغییر	تغییر
تلمبه	تلمبه
توتون	توتون
جامعه	جامعه
جاوید	جاوید
جیمز	جیمز
حمدان	حمدان
حکیمی	حکیمی
خانی	خانی
خسارت	خسارت
خطیبی	خطیبی
دایما	دایما
دلتا	دلتا
دنیس	دنیس
دینی	دینی
شالکه	شالکه
شطرنج	شطرنج
شموشک	شموشک
غازان	غازان
غریبه	غریبه
فضایی	فضایی
فیلد	فیلد
لوزان	لوزان
ماجرا	ماجرا
معدنی	معدنی
نادیا	نادیا
هاون	هاون
پارسا	پارسا
چروکی	چروکی
کرونا	کرونا
گنجوی	گنجوی
تورین	تورین
آندرسن	آندرسن
ائتلاف	ائتلاف
اَحاطه	احاطه
بارکلی	بارکلی
برزیل	برزیل
دماوند	دماوند
دوشنبه	دوشنبه
راکفلر	راکفلر
سلنیوم	سلنیوم
شارون	شارون
شرایطی	شرایطی
فلسطین	فلسطین
قزوین	قزوین
لوچانو	لوچانو
لیبرمن	لیبرمن
مارچلو	مارچلو
معماری	معماری
منظومه	منظومه
میرزا	میرزا
همدان	همدان
وایمار	وایمار
کورتیز	کورتیز
آشتیانی	آشتیانی
استراحت	استراحت
افتخاری	افتخاری
اودینزه	اودینزه
ایستگاه	ایستگاه
بیلیارد	بیلیارد
دیاربکر	دیاربکر
سالومون	سالومون
سمفونیک	سمفونیک
سوسیداد	سوسیداد
شاهنامه	شاهنامه
میلیون	میلیون
کازیمیر	کازیمیر
اوکلاهما	اوکلاهما
ایرانیان	ایرانیان
جامی	جامی
داغی	داغی
ساندرلند	ساندرلند
سانسکریت	سانسکریت
طبیعت	طبیعت
ناکایاما	ناکایاما
پتروسیان	پتروسیان
جرج	جرج
عبدالخالق	عبدالخالق
عبدالوهاب	عبدالوهاب
میدلزبورو	میدلزبورو
ویکتوریا	ویکتوریا
کاریکاتور	کاریکاتور
گرگین	گرگین
السالوادور	السالوادور
آکادمی	آکادمی
خب	خب
تونس	تونس
مسیله	مسیله
بازیکن	بازیکن
رب	رب
ظن	ظن
آخن	آخن
آوج	آوج
بزه	بزه
خضر	خضر
خنگ	خنگ
زار	زار
شوش	شوش
قصد	قصد
لیر	لیر
موز	موز
پره	پره
چیپ	چیپ
یلو	یلو
آماج	آماج
آموس	آموس
اردن	اردن
انیس	انیس
اول	اول
بارد	بارد
بران	بران
بربر	بربر
بریل	بریل
بوچر	بوچر
بویر	بویر
بیژن	بیژن
تنگه	تنگه
حنفی	حنفی
خمیر	خمیر
خیال	خیال
دیون	دیون
ریدر	ریدر
ساره	ساره
شایق	شایق
شکلی	شکلی
عهده	عهده
قدیر	قدیر
لرتا	لرتا
لوور	لوور
مریض	مریض
میدل	میدل
نجات	نجات
نغمه	نغمه
نیچه	نیچه
هاری	هاری
والد	والد
وسطی	وسطی
پایک	پایک
پرده	پرده
پلنگ	پلنگ
پوند	پوند
کمیل	کمیل
بصره	بصره
آقایی	آقایی
ارزاق	ارزاق
الوان	الوان
بهنام	بهنام
تخریب	تخریب
جاسوس	جاسوس
جورج	جورج
خارکف	خارکف
دیزنی	دیزنی
رایت	رایت
رساله	رساله
زنجیر	زنجیر
زیدان	زیدان
عاشور	عاشور
فولام	فولام
قربان	قربان
قنبری	قنبری
ماندی	ماندی
ماهان	ماهان
ناهار	ناهار
نوْبل	نوبل
هاکان	هاکان
ونسان	ونسان
وویجر	وویجر
پناهی	پناهی
کرتیس	کرتیس
کورال	کورال
کیانگ	کیانگ
مارسی	مارسی
مونیخ	مونیخ
مکزیک	مکزیک
اتفاقی	اتفاقی
ارزروم	ارزروم
بلکبرن	بلکبرن
روزولت	روزولت
فرهادی	فرهادی
لبنان	لبنان
مبارکه	مبارکه
متفرقه	متفرقه
مصلحتی	مصلحتی
مقدونی	مقدونی
ناتوان	ناتوان
نلسون	نلسون
هولاکو	هولاکو
ویتالی	ویتالی
پاتریس	پاتریس
پرتغال	پرتغال
پروتون	پروتون
پلاتین	پلاتین
کاسانو	کاسانو
کلمبوس	کلمبوس
کیمیا	کیمیا
فوتبال	فوتبال
اردوغان	اردوغان
اسراییل	اسراییل
انیمیشن	انیمیشن
ایسلند	ایسلند
جن	جن
بسکتبال	بسکتبال
جفرسون	جفرسون
فراهانی	فراهانی
منشأ	منشأ
نصرالله	نصرالله
نماینده	نماینده
ورونیکا	ورونیکا
افراسیاب	افراسیاب
دانمارک	دانمارک
دپورتیوو	دپورتیوو
صدرالدین	صدرالدین
فیض	فیض
میروسلاو	میروسلاو
بیمارستان	بیمارستان
حبیب	حبیب
زوُر	زور
عبدالحسین	عبدالحسین
عبدالفتاح	عبدالفتاح
عبداللطیف	عبداللطیف
میتسوبیشی	میتسوبیشی
نیجریه	نیجریه
شهاب	شهاب
عرفه	عرفه
سانفرانسیسکو	سانفرانسیسکو
تام	تام
بایرام	بایرام
هک	هک
وا	وا
ادب	ادب
ادو	ادو
بلد	بلد
حزب	حزب
زرد	زرد
سعی	سعی
شفا	شفا
عرض	عرض
عید	عید
غزه	غزه
لیف	لیف
متی	متی
مگر	مگر
نجم	نجم
نری	نری
نوه	نوه
هوس	هوس
پل	پل
اسنو	اسنو
اندر	اندر
بتیس	بتیس
برکه	برکه
بریس	بریس
خراج	خراج
دیدی	دیدی
روزن	روزن
رومر	رومر
زیمر	زیمر
سایه	سایه
شکست	شکست
شیدا	شیدا
طلبی	طلبی
عذاب	عذاب
مار	مار
متر	متر
مجدی	مجدی
معنی	معنی
میان	میان
میکس	میکس
ناظم	ناظم
نفت	نفت
نقشه	نقشه
نلسن	نلسن
نیوز	نیوز
هایک	هایک
کافی	کافی
کشیش	کشیش
استلا	استلا
اندره	اندره
باقری	باقری
بلوف	بلوف
تحقیر	تحقیر
تحقیق	تحقیق
حواله	حواله
حیوان	حیوان
راشدی	راشدی
رایدر	رایدر
رعایت	رعایت
زمینه	زمینه
سلولز	سلولز
عسکری	عسکری
عقیده	عقیده
فراست	فراست
قونیه	قونیه
مختلف	مختلف
معلمی	معلمی
ممتاز	ممتاز
مکانی	مکانی
هامان	هامان
ویلسن	ویلسن
کاووس	کاووس
کمالی	کمالی
کورسو	کورسو
یامچی	یامچی
اردلان	اردلان
افشار	افشار
الحسین	الحسین
الریان	الریان
اوتاوا	اوتاوا
بوستان	بوستان
تورینو	تورینو
تویوتا	تویوتا
دومنیک	دومنیک
سلماسی	سلماسی
سیرجان	سیرجان
شریعتی	شریعتی
فاکتور	فاکتور
ماریوس	ماریوس
مالدیو	مالدیو
مانفرد	مانفرد
میدانی	میدانی
نوادا	نوادا
هائیتی	هائیتی
همدانی	همدانی
ویرجیل	ویرجیل
کاروان	کاروان
خاقانی	خاقانی
خانواده	خانواده
رضا	رضا
عهدنامه	عهدنامه
غلبه	غلبه
مارشال	مارشال
مریخ	مریخ
مورتیمر	مورتیمر
نامیبیا	نامیبیا
کارائیب	کارائیب
ینجه	ینجه
اسماعیلی	اسماعیلی
پاتولوژی	پاتولوژی
پاریس	پاریس
پروْفسور	پروفسور
پورتسموث	پورتسموث
یحیی	یحیی
ژوئیه	ژوئیه
ولورهمپتون	ولورهمپتون
کانزاس	کانزاس
ترتر	ترتر
بایرن	بایرن
بوکان	بوکان
تلمسان	تلمسان
تز	تز
حد	حد
نت	نت
زی	زی
ادا	ادا
بوْ	بو
جار	جار
دود	دود
ذکی	ذکی
رمی	رمی
شول	شول
لقب	لقب
وحی	وحی
کات	کات
آثار	آثار
آینا	آینا
اوین	اوین
باکس	باکس
بودی	بودی
بورس	بورس
تامس	تامس
تانی	تانی
توده	توده
جانا	جانا
خدمت	خدمت
خندق	خندق
رفیق	رفیق
زاید	زاید
سنجر	سنجر
شپرد	شپرد
صدام	صدام
فعلی	فعلی
فواد	فواد
فیاض	فیاض
قران	قران
لنین	لنین
نعیم	نعیم
نوید	نوید
نیزه	نیزه
هرمز	هرمز
هونگ	هونگ
ونیز	ونیز
پاپی	پاپی
پول	پول
کابل	کابل
کویت	کویت
کینگ	کینگ
آلایی	آلایی
اشکان	اشکان
الیزا	الیزا
امینه	امینه
برایت	برایت
تایمز	تایمز
شریفی	شریفی
عرفان	عرفان
فورد	فورد
ملودی	ملودی
مولوی	مولوی
نمونه	نمونه
هریس	هریس
هکتار	هکتار
پاول	پاول
کتیبه	کتیبه
کیفیت	کیفیت
ایستاد	ایستاد
ایوانف	ایوانف
باکستر	باکستر
بحرانی	بحرانی
بورژوا	بورژوا
تره	تره
تیموری	تیموری
تیپ	تیپ
جوزفین	جوزفین
روبینز	روبینز
زادگان	زادگان
فریدمن	فریدمن
قاجار	قاجار
لینوکس	لینوکس
چارلز	چارلز
بانی	بانی
به	به
جهانگیر	جهانگیر
حرفه	حرفه
فابیانو	فابیانو
مالاریا	مالاریا
هالیوود	هالیوود
کانادا	کانادا
بریستول	بریستول
آتلانتا	آتلانتا
ایتالیا	ایتالیا
کامپیوتر	کامپیوتر
کیلومتر	کیلومتر
برازیلیا	برازیلیا
سیستماتیک	سیستماتیک
عبدالسلام	عبدالسلام
نجو	نجو
قم	قم
ید	ید
بقا	بقا
بله	بله
جفر	جفر
حمص	حمص
شفر	شفر
صفا	صفا
فخر	فخر
قرب	قرب
ملت	ملت
هفت	هفت
هنر	هنر
چمن	چمن
گور	گور
آلن	آلن
بالی	بالی
برکت	برکت
تانک	تانک
ترسا	ترسا
جدول	جدول
جنیس	جنیس
جوزی	جوزی
خوسه	خوسه
دیرک	دیرک
رامی	رامی
رشته	رشته
ریال	ریال
ریوس	ریوس
سرخه	سرخه
سفید	سفید
شرحی	شرحی
صورت	صورت
لطفی	لطفی
لوند	لوند
لوکس	لوکس
لیگا	لیگا
مجمع	مجمع
معبد	معبد
منیر	منیر
نیکو	نیکو
همتی	همتی
ورد	ورد
پیری	پیری
گوام	گوام
گیره	گیره
علیا	علیا
رقصی	رقصی
اربیل	اربیل
العرب	العرب
اکتبر	اکتبر
بحران	بحران
تایپه	تایپه
تدبیر	تدبیر
ترومن	ترومن
تصویب	تصویب
دارسی	دارسی
دانته	دانته
دیوار	دیوار
رولان	رولان
سلتیک	سلتیک
سیاوش	سیاوش
مفتاح	مفتاح
پایین	پایین
کاظمی	کاظمی
کافکا	کافکا
کیانی	کیانی
آشکارا	آشکارا
آنلاین	آنلاین
بغدادی	بغدادی
توریسم	توریسم
خورشید	خورشید
دستگاه	دستگاه
سابینا	سابینا
طرفدار	طرفدار
فاشیست	فاشیست
فالکون	فالکون
قزوینی	قزوینی
مولینا	مولینا
پهلوان	پهلوان
یمن	یمن
آفریقا	آفریقا
آلزایمر	آلزایمر
استرادا	استرادا
ایستوود	ایستوود
اینشتین	اینشتین
برناردو	برناردو
عزالدین	عزالدین
مارتین	مارتین
مدیسون	مدیسون
واترلو	واترلو
کاترینا	کاترینا
اینتراخت	اینتراخت
بلدیه	بلدیه
اروندکنار	اروندکنار
سیف	سیف
رئیس	رئیس
و	و
ته	ته
حج	حج
شد	شد
انس	انس
بنز	بنز
بیک	بیک
تاب	تاب
جبر	جبر
حلّ	حل
دست	دست
دیه	دیه
عصب	عصب
فرش	فرش
قدس	قدس
نهر	نهر
پکن	پکن
تخت	تخت
آئین	آئین
اکرم	اکرم
اینک	اینک
حسرت	حسرت
سوری	سوری
شوجی	شوجی
علیه	علیه
لوله	لوله
مانا	مانا
متان	متان
مرده	مرده
ملکی	ملکی
نجفی	نجفی
هورا	هورا
پرو	پرو
پوشک	پوشک
پیزا	پیزا
پیکت	پیکت
کران	کران
سفلی	سفلی
اسلاو	اسلاو
انصار	انصار
تحویل	تحویل
تعطیل	تعطیل
تفسیر	تفسیر
توتال	توتال
جلالی	جلالی
جونز	جونز
رحمتی	رحمتی
رقیبی	رقیبی
سامرا	سامرا
شرودر	شرودر
فایزی	فایزی
قاموس	قاموس
مارال	مارال
معبدی	معبدی
میمون	میمون
نشنال	نشنال
هواوی	هواوی
هیتلر	هیتلر
ولیدی	ولیدی
پروین	پروین
پولاک	پولاک
کوبان	کوبان
تعلیمی	تعلیمی
داستین	داستین
سلوکوس	سلوکوس
طرابلس	طرابلس
فینیکس	فینیکس
لیبریا	لیبریا
ماهشهر	ماهشهر
مینیرو	مینیرو
نهاوند	نهاوند
کامیلو	کامیلو
افلاطون	افلاطون
انطاکیه	انطاکیه
دایموند	دایموند
هندریکس	هندریکس
پیترسون	پیترسون
الساندرو	الساندرو
زور	زور
یوهانسون	یوهانسون
عبدالرزاق	عبدالرزاق
اندیمشک	اندیمشک
بش	بش
بم	بم
آیه	آیه
بست	بست
توز	توز
طرح	طرح
فلک	فلک
فوق	فوق
قلب	قلب
محل	محل
مست	مست
پست	پست
چاه	چاه
کسی	کسی
کفر	کفر
گوی	گوی
ینس	ینس
اذیت	اذیت
اصول	اصول
اندو	اندو
بینی	بینی
تنیس	تنیس
جسور	جسور
حکمت	حکمت
خطیب	خطیب
دینو	دینو
رباط	رباط
زحمت	زحمت
سرور	سرور
سوله	سوله
عاصم	عاصم
عروض	عروض
عضله	عضله
قادر	قادر
قالی	قالی
لیدر	لیدر
همزه	همزه
وینر	وینر
کاوه	کاوه
کلی	کلی
اتیلن	اتیلن
اثبات	اثبات
اسکای	اسکای
امنیت	امنیت
ایلام	ایلام
ایوبی	ایوبی
بهلول	بهلول
تحریک	تحریک
تشویق	تشویق
تنظیم	تنظیم
توحید	توحید
تیپیک	تیپیک
جلایر	جلایر
حبیبی	حبیبی
درانی	درانی
سدریک	سدریک
علامه	علامه
مربوط	مربوط
مضمون	مضمون
میگرن	میگرن
کایرا	کایرا
اکثراً	اکثراً
برادلی	برادلی
خبردار	خبردار
دهستان	دهستان
قیصریه	قیصریه
معاویه	معاویه
معجزات	معجزات
وبستر	وبستر
گیلانی	گیلانی
بنیامین	بنیامین
خواننده	خواننده
عادتاً	عادتا
نادرشاه	نادرشاه
کانتون	کانتون
اسپینوزا	اسپینوزا
حضرت	حضرت
عبدالغنی	عبدالغنی
مونتسکیو	مونتسکیو
پروفسور	پروفسور
بو	بو
فر	فر
شار	شار
عقل	عقل
قند	قند
موت	موت
ولد	ولد
کرد	کرد
گرم	گرم
عصر	عصر
داخل	داخل
راند	راند
ستون	ستون
قرمز	قرمز
قوام	قوام
لاما	لاما
مالت	مالت
میری	میری
پلات	پلات
چاوز	چاوز
کالا	کالا
کویل	کویل
گروس	گروس
یار	یار
آرمان	آرمان
بخشی	بخشی
برهان	برهان
تاجیک	تاجیک
تبدیل	تبدیل
تجارت	تجارت
تعمیر	تعمیر
تی	تی
رضوان	رضوان
شهرام	شهرام
صمیمی	صمیمی
فاروق	فاروق
فاولر	فاولر
فراری	فراری
فرزاد	فرزاد
قاسمی	قاسمی
مقتدی	مقتدی
هانری	هانری
کلکته	کلکته
اوترخت	اوترخت
توریست	توریست
دربندی	دربندی
رودبار	رودبار
سوزانا	سوزانا
میامی	میامی
نیکولو	نیکولو
ژاکلین	ژاکلین
لورکوزن	لورکوزن
ولفگانگ	ولفگانگ
کربلایی	کربلایی
آلخاندرو	آلخاندرو
اوبرایان	اوبرایان
عبدالملک	عبدالملک
غنی	غنی
همیلتون	همیلتون
بارسلونا	بارسلونا
سوسیالیستی	سوسیالیستی
آلبانی	آلبانی
لب	لب
هل	هل
آتی	آتی
آرش	آرش
بلخ	بلخ
تست	تست
رزن	رزن
سیل	سیل
فار	فار
لاد	لاد
نار	نار
آریل	آریل
برای	برای
بردی	بردی
بور	بور
رویه	رویه
شفیع	شفیع
طراح	طراح
فینی	فینی
مایل	مایل
مدرن	مدرن
هوپر	هوپر
کاسا	کاسا
کشور	کشور
ایلیا	ایلیا
تصنیف	تصنیف
تولوز	تولوز
جسارت	جسارت
حرارت	حرارت
خیانت	خیانت
رضایی	رضایی
ریحان	ریحان
شاعری	شاعری
شاهرخ	شاهرخ
طاعون	طاعون
طریقت	طریقت
مرسدس	مرسدس
مقامی	مقامی
ملیحه	ملیحه
میانه	میانه
میکرو	میکرو
هلموت	هلموت
هوندا	هوندا
ویران	ویران
پلوتو	پلوتو
پیترز	پیترز
کسروی	کسروی
ابوبکر	ابوبکر
اینکار	اینکار
بایزید	بایزید
بروکسل	بروکسل
سامسون	سامسون
مادلین	مادلین
مارلون	مارلون
مارلین	مارلین
متحدهٔ	متحده
کریستف	کریستف
کشفیات	کشفیات
کلودیا	کلودیا
کمپانی	کمپانی
دسامبر	دسامبر
استقلال	استقلال
اسدآباد	اسدآباد
برتراند	برتراند
سیلوستر	سیلوستر
معمولاً	معمولاً
پارلمان	پارلمان
لیتوانی	لیتوانی
ایالت	ایالت
قوری	قوری
نیوپورت	نیوپورت
پیرانشهر	پیرانشهر
کامچاتکا	کامچاتکا
جا	جا
زو	زو
ول	ول
احد	احد
باز	باز
دوی	دوی
رده	رده
رزا	رزا
رقم	رقم
سرژ	سرژ
سما	سما
سیم	سیم
قوز	قوز
قوچ	قوچ
میز	میز
آرسن	آرسن
آنجل	آنجل
اوان	اوان
ثریا	ثریا
جبار	جبار
حاتم	حاتم
حمدی	حمدی
خوآن	خوآن
دلیل	دلیل
دورو	دورو
زبیر	زبیر
عبده	عبده
علوم	علوم
مورس	مورس
نیلی	نیلی
هویت	هویت
وود	وود
کولی	کولی
یقین	یقین
الهام	الهام
امینی	امینی
بالله	بالله
باکون	باکون
بهانه	بهانه
تحلیل	تحلیل
جماعت	جماعت
جهانی	جهانی
حسنلی	حسنلی
خارجی	خارجی
رحمان	رحمان
روایت	روایت
ریشتر	ریشتر
سرحدی	سرحدی
سکینه	سکینه
طویله	طویله
عبادت	عبادت
علامت	علامت
علمیه	علمیه
متوکل	متوکل
مراکش	مراکش
آلبرتا	آلبرتا
احتیاط	احتیاط
المهدی	المهدی
الکسیس	الکسیس
انصاری	انصاری
ایستان	ایستان
خصوصاً	خصوصاً
خوشبخت	خوشبخت
داروین	داروین
قربانی	قربانی
کامران	کامران
بالابان	بالابان
بولیوار	بولیوار
دیاموند	دیاموند
آهن	آهن
ستارخان	ستارخان
مولداوی	مولداوی
مونیکا	مونیکا
پاسیفیک	پاسیفیک
یوونتوس	یوونتوس
بوداپست	بوداپست
اسکندریه	اسکندریه
شمس	شمس
لومباردو	لومباردو
هیروشیما	هیروشیما
انوشیروان	انوشیروان
کریستیانو	کریستیانو
لیبی	لیبی
جت	جت
جلد	جلد
جوش	جوش
حرب	حرب
دات	دات
زنگ	زنگ
زید	زید
سوق	سوق
شرف	شرف
عهد	عهد
میا	میا
میت	میت
نکا	نکا
همت	همت
ودا	ودا
چول	چول
کسل	کسل
گری	گری
مکه	مکه
آرزو	آرزو
بازی	بازی
تماس	تماس
دریا	دریا
طلعت	طلعت
عطیه	عطیه
مارا	مارا
نیجر	نیجر
آژاکس	آژاکس
اوزان	اوزان
اوستا	اوستا
براین	براین
دیدیه	دیدیه
رامین	رامین
سنندج	سنندج
شیطان	شیطان
مجنون	مجنون
نیسان	نیسان
هارلی	هارلی
یانکی	یانکی
آذرشهر	آذرشهر
استثنا	استثنا
اوباما	اوباما
اوْدسا	اودسا
اکثریت	اکثریت
تخمینا	تخمینا
دایانا	دایانا
رابسون	رابسون
مدنیّت	مدنیت
مقاومت	مقاومت
همایون	همایون
ژولیوس	ژولیوس
کلودیو	کلودیو
کویینز	کویینز
اسرائیل	اسرائیل
حقیقتاً	حقیقتاً
مغناطیس	مغناطیس
مکانیکی	مکانیکی
نیکلسون	نیکلسون
سپتامبر	سپتامبر
ترکمانچای	ترکمانچای
سالواتوره	سالواتوره
کالیفرنیا	کالیفرنیا
بد	بد
شن	شن
بزک	بزک
بلر	بلر
بنا	بنا
جبل	جبل
دله	دله
زاک	زاک
صنم	صنم
ضرب	ضرب
فرخ	فرخ
فقه	فقه
قاف	قاف
وله	وله
ویو	ویو
ژیل	ژیل
اهلی	اهلی
بارو	بارو
بانو	بانو
خائن	خائن
دارا	دارا
دوان	دوان
رومی	رومی
زاهد	زاهد
زینب	زینب
ساکس	ساکس
سرنا	سرنا
شور	شور
شوکت	شوکت
غلام	غلام
فاتح	فاتح
لونی	لونی
لوپس	لوپس
متره	متره
مهر	مهر
موشک	موشک
هیئت	هیئت
پاتر	پاتر
چاپی	چاپی
کانت	کانت
آکتور	آکتور
اعمال	اعمال
الفتح	الفتح
حاکمی	حاکمی
حسنلو	حسنلو
دانوب	دانوب
سفیان	سفیان
سیامک	سیامک
قصیده	قصیده
مثنوی	مثنوی
مرجان	مرجان
هیون	هیون
پیانو	پیانو
کهریز	کهریز
آلونسو	آلونسو
اردشیر	اردشیر
بلانکو	بلانکو
فرغانه	فرغانه
فرمانی	فرمانی
ماشینی	ماشینی
ویتنام	ویتنام
یونانی	یونانی
ساخالین	ساخالین
واتیکان	واتیکان
چارلتون	چارلتون
کوانتوم	کوانتوم
بندرعباس	بندرعباس
شاهین	شاهین
پرینستون	پرینستون
جمال	جمال
آنجلو	آنجلو
آنت	آنت
تاک	تاک
جمی	جمی
حرف	حرف
سبز	سبز
لرد	لرد
مدل	مدل
نای	نای
وفا	وفا
کید	کید
گاز	گاز
اکسل	اکسل
ایرج	ایرج
تورن	تورن
دونی	دونی
راحت	راحت
رسام	رسام
روسا	روسا
شعبه	شعبه
طالع	طالع
طاها	طاها
لینا	لینا
والا	والا
پایی	پایی
کیم	کیم
یوان	یوان
التون	التون
انسان	انسان
تثبیت	تثبیت
تومان	تومان
رسماً	رسماً
روبنس	روبنس
سرباز	سرباز
سعادت	سعادت
سفیری	سفیری
شاملو	شاملو
شریعت	شریعت
صباحی	صباحی
ضروری	ضروری
فورمن	فورمن
مردیت	مردیت
ژنتیک	ژنتیک
کانلی	کانلی
یهودا	یهودا
آرارات	آرارات
آرسنیک	آرسنیک
امیلیو	امیلیو
ایزابل	ایزابل
خانقاه	خانقاه
رزماری	رزماری
سانسور	سانسور
طهماسب	طهماسب
ماسیمو	ماسیمو
منوچهر	منوچهر
پوشکین	پوشکین
اسدالله	اسدالله
الجزایر	الجزایر
تاتنهام	تاتنهام
تبلیغات	تبلیغات
شهریور	شهریور
ماریانا	ماریانا
یورک	یورک
آیت	آیت
ریچموند	ریچموند
فروردین	فروردین
تراکتورسازی	تراکتورسازی
لاتین	لاتین
کولین	کولین
آس	آس
الم	الم
حکم	حکم
خام	خام
رنو	رنو
سکس	سکس
شرط	شرط
صفر	صفر
قلی	قلی
نیت	نیت
چچن	چچن
اصلا	اصلا
اعظم	اعظم
برود	برود
بهار	بهار
جناب	جناب
داور	داور
راکی	راکی
سوال	سوال
عبید	عبید
فرات	فرات
نفوذ	نفوذ
نوین	نوین
وودی	وودی
آبان	آبان
آتیلا	آتیلا
باراک	باراک
بهمن	بهمن
بوردو	بوردو
تجهیز	تجهیز
حرکات	حرکات
راینر	راینر
سیبری	سیبری
شخصاً	شخصاً
عمران	عمران
فاطمی	فاطمی
فعّال	فعال
محبوب	محبوب
مرمره	مرمره
پتروف	پتروف
کلوین	کلوین
خرمدره	خرمدره
زامبیا	زامبیا
زنگبار	زنگبار
سلطانی	سلطانی
سومالی	سومالی
قانونا	قانونا
نیکلای	نیکلای
کورتنی	کورتنی
حمیدرضا	حمیدرضا
رستوران	رستوران
قیمت	قیمت
متالوژی	متالوژی
میانمار	میانمار
والنتین	والنتین
وودوارد	وودوارد
ویتوریا	ویتوریا
کاپیتان	کاپیتان
نورالدین	نورالدین
جغرافیایی	جغرافیایی
جلال	جلال
تکنیک	تکنیک
گر	گر
داس	داس
دیم	دیم
اتان	اتان
بدنی	بدنی
جنوا	جنوا
خلیج	خلیج
دارن	دارن
دیزی	دیزی
ربیع	ربیع
زیان	زیان
طیبی	طیبی
علوی	علوی
قایل	قایل
قیام	قیام
نشان	نشان
نظام	نظام
نیاز	نیاز
آرامی	آرامی
المان	المان
صحابه	صحابه
نوشهر	نوشهر
هوشنگ	هوشنگ
کتابی	کتابی
دانیلو	دانیلو
سیمونه	سیمونه
مهربان	مهربان
پایتخت	پایتخت
کارتاژ	کارتاژ
انتونیو	انتونیو
دینامیک	دینامیک
لنکستر	لنکستر
کلمبیا	کلمبیا
مجارستان	مجارستان
پارکینسون	پارکینسون
چک	چک
سالیان	سالیان
آیا	آیا
بان	بان
تکه	تکه
تین	تین
جام	جام
ذره	ذره
راش	راش
فوت	فوت
لای	لای
هجر	هجر
کرت	کرت
میش	میش
آذر	آذر
اریش	اریش
برون	برون
بیگم	بیگم
درسی	درسی
شوشه	شوشه
عقلی	عقلی
فراز	فراز
فقیه	فقیه
لیسی	لیسی
مجلس	مجلس
مشعل	مشعل
مورز	مورز
نصیب	نصیب
واقع	واقع
پگاه	پگاه
آزادی	آزادی
آنیتا	آنیتا
ایست	ایست
بوتان	بوتان
رجینا	رجینا
غزنوی	غزنوی
موسوی	موسوی
هوبرت	هوبرت
الهلال	الهلال
باغ	باغ
بورانی	بورانی
جکسون	جکسون
خوارزم	خوارزم
سرمایه	سرمایه
ژورنال	ژورنال
اکولوژی	اکولوژی
تکنیکال	تکنیکال
آمستردام	آمستردام
رادرفورد	رادرفورد
پارتیزان	پارتیزان
فرق	فرق
صنعتی	صنعتی
پرسپولیس	پرسپولیس
اهر	اهر
فلوریدا	فلوریدا
رش	رش
زر	زر
الف	الف
تدی	تدی
داد	داد
رسم	رسم
سو	سو
شال	شال
قیر	قیر
ویر	ویر
کام	کام
بازل	بازل
باور	باور
برنز	برنز
تخلص	تخلص
حمام	حمام
دیوی	دیوی
رحمت	رحمت
شورت	شورت
لانس	لانس
مترو	مترو
هال	هال
واحد	واحد
کلید	کلید
آخوند	آخوند
اوغلی	اوغلی
بادام	بادام
تضییق	تضییق
تهدید	تهدید
زمینی	زمینی
سالار	سالار
فرشاد	فرشاد
مصلحت	مصلحت
منظوم	منظوم
کرامر	کرامر
کریمه	کریمه
اشتراک	اشتراک
الصباح	الصباح
بختیار	بختیار
بلاروس	بلاروس
بهرنگی	بهرنگی
حسینیه	حسینیه
ساندرو	ساندرو
کوی	کوی
ویلفرد	ویلفرد
ویندوز	ویندوز
چاپلین	چاپلین
فخرالدین	فخرالدین
پاراگوئه	پاراگوئه
اوْلا	اولا
صفی	صفی
نل	نل
برو	برو
خود	خود
سیر	سیر
صرب	صرب
قدم	قدم
لیچ	لیچ
نیس	نیس
پور	پور
پیل	پیل
آرال	آرال
آوری	آوری
اسدی	اسدی
امّا	امّا
اوره	اوره
بتسی	بتسی
بلیس	بلیس
تریس	تریس
جمله	جمله
رالی	رالی
سعدی	سعدی
عملی	عملی
لولا	لولا
ماکو	ماکو
هومر	هومر
پلان	پلان
کوفی	کوفی
استفن	استفن
اسلحه	اسلحه
اشمیت	اشمیت
عصیان	عصیان
فلورا	فلورا
لتونی	لتونی
مرحوم	مرحوم
مستقل	مستقل
چندلر	چندلر
آمازون	آمازون
اخلاقی	اخلاقی
انقلاب	انقلاب
حاکمیت	حاکمیت
فردریش	فردریش
مسلمان	مسلمان
گنجعلی	گنجعلی
بوفالو	بوفالو
بیوشیمی	بیوشیمی
دیجیتال	دیجیتال
سلیمانی	سلیمانی
صنعتکار	صنعتکار
هرناندز	هرناندز
کلینتون	کلینتون
چهاردانگه	چهاردانگه
آش	آش
قی	قی
آسا	آسا
ترا	ترا
رام	رام
سهو	سهو
هول	هول
کوه	کوه
ایزو	ایزو
بوکس	بوکس
خیبر	خیبر
داود	داود
رستم	رستم
ظریف	ظریف
فطرت	فطرت
فوزی	فوزی
مسکن	مسکن
میرا	میرا
مینا	مینا
نیلز	نیلز
کشفی	کشفی
گویش	گویش
یارا	یارا
الوند	الوند
اینتر	اینتر
تئوری	تئوری
ثانیه	ثانیه
سرعین	سرعین
موقتی	موقتی
ناصری	ناصری
پاییز	پاییز
تقریبا	تقریبا
حقیقتی	حقیقتی
سیلویو	سیلویو
سینما	سینما
عاشورا	عاشورا
لیلیان	لیلیان
مصنوعی	مصنوعی
نیکسون	نیکسون
ولیعهد	ولیعهد
اورانوس	اورانوس
رفسنجان	رفسنجان
پلاستیک	پلاستیک
کاراکتر	کاراکتر
بویراحمد	بویراحمد
عبیدالله	عبیدالله
موزامبیک	موزامبیک
آق	آق
غم	غم
لک	لک
پک	پک
چه	چه
کل	کل
سر	سر
اره	اره
اپل	اپل
تله	تله
دَب	دب
ردّ	رد
فضا	فضا
نصر	نصر
پاک	پاک
بیگی	بیگی
تولا	تولا
راشل	راشل
زیاد	زیاد
سراب	سراب
شخصه	شخصه
ضیاء	ضیاء
معلم	معلم
کالی	کالی
کوچی	کوچی
آیزاک	آیزاک
اساسا	اساسا
املاک	املاک
انجمن	انجمن
جنرال	جنرال
صفویه	صفویه
معیشت	معیشت
هانسن	هانسن
پالاس	پالاس
توکیو	توکیو
امریکا	امریکا
دمیرچی	دمیرچی
لیندزی	لیندزی
بختیاری	بختیاری
پارسونز	پارسونز
یونیون	یونیون
ابوالفضل	ابوالفضل
تار	تار
روا	روا
فرج	فرج
لکن	لکن
مکی	مکی
هوا	هوا
پرس	پرس
آوار	آوار
ایمن	ایمن
تیر	تیر
روسو	روسو
روضه	روضه
سوخو	سوخو
عبدی	عبدی
فایز	فایز
متحد	متحد
میرز	میرز
هلال	هلال
چکمه	چکمه
باربر	باربر
تحریر	تحریر
تروی	تروی
دنیلز	دنیلز
نیوتن	نیوتن
هاشمی	هاشمی
ویستا	ویستا
رادیکال	رادیکال
فولکلور	فولکلور
پادشاهی	پادشاهی
ابوالحسن	ابوالحسن
سالوادور	سالوادور
تکزاس	تکزاس
ره	ره
زد	زد
طب	طب
اژه	اژه
سوم	سوم
طنز	طنز
هضم	هضم
وات	وات
وقت	وقت
کرم	کرم
آموز	آموز
تخته	تخته
روژه	روژه
ماسی	ماسی
نبیل	نبیل
نصرت	نصرت
وطنی	وطنی
پوست	پوست
کبیر	کبیر
آسیا	آسیا
اتحاد	اتحاد
حیدری	حیدری
دیگری	دیگری
مالیه	مالیه
مکتوم	مکتوم
کنعان	کنعان
برابر	برابر
جغرافی	جغرافی
فورستر	فورستر
مارینا	مارینا
افسردگی	افسردگی
آندرانیک	آندرانیک
برده	برده
شه	شه
امل	امل
متن	متن
کلم	کلم
آرام	آرام
بارک	بارک
بودا	بودا
بیزی	بیزی
تکان	تکان
ساحل	ساحل
محلی	محلی
مسیح	مسیح
ناکس	ناکس
هارا	هارا
هرات	هرات
هلند	هلند
چینی	چینی
کالج	کالج
آلما	آلما
اسحاق	اسحاق
خمینی	خمینی
داماش	داماش
سادات	سادات
شاپور	شاپور
شبستر	شبستر
شعبان	شعبان
عملیات	عملیات
انتشارات	انتشارات
پیشه	پیشه
ایستی	ایستی
رقص	رقص
هچ	هچ
کت	کت
آدم	آدم
قوس	قوس
پرت	پرت
پرل	پرل
کاپ	کاپ
صبری	صبری
طالب	طالب
ناجی	ناجی
یوفا	یوفا
اشاره	اشاره
ایجاد	ایجاد
تقلید	تقلید
مایرز	مایرز
ارنستو	ارنستو
بالتیک	بالتیک
تراویس	تراویس
سیلویا	سیلویا
زن	زن
هانوفر	هانوفر
هیلتون	هیلتون
والترز	والترز
اروگوئه	اروگوئه
خوزه	خوزه
لوسیانو	لوسیانو
کریستوف	کریستوف
جاماییکا	جاماییکا
لوکوموتیو	لوکوموتیو
کنستانتین	کنستانتین
سوی	سوی
موس	موس
برمن	برمن
راکت	راکت
رزرو	رزرو
سلول	سلول
مثلا	مثلا
مسلم	مسلم
پولک	پولک
انزلی	انزلی
ترقّی	ترقی
داوری	داوری
رادنی	رادنی
سامان	سامان
شافعی	شافعی
عایله	عایله
ناظری	ناظری
اریتره	اریتره
اوهارا	اوهارا
ماتیوس	ماتیوس
مکانیک	مکانیک
والتون	والتون
کامبوج	کامبوج
آلفونسو	آلفونسو
سالیوان	سالیوان
پروتئین	پروتئین
کارلسون	کارلسون
صلاح	صلاح
قمر	قمر
کش	کش
جود	جود
روش	روش
لان	لان
هدر	هدر
هود	هود
استر	استر
جهاد	جهاد
رضوی	رضوی
ریاض	ریاض
شمال	شمال
عامر	عامر
لیدی	لیدی
مالک	مالک
مکان	مکان
میوه	میوه
کامل	کامل
کوثر	کوثر
کوله	کوله
آیفون	آیفون
ترامپ	ترامپ
جوردن	جوردن
رومرو	رومرو
زمانی	زمانی
سلطنت	سلطنت
چرچیل	چرچیل
کومار	کومار
یگانه	یگانه
آلمانی	آلمانی
شیرازی	شیرازی
مولانا	مولانا
هپاتیت	هپاتیت
پیغمبر	پیغمبر
کریستن	کریستن
بولونیا	بولونیا
تولستوی	تولستوی
حسینعلی	حسینعلی
ناتالیا	ناتالیا
هندوراس	هندوراس
دورتموند	دورتموند
مقبره	مقبره
ویلیامسون	ویلیامسون
عضو	عضو
تن	تن
شل	شل
آرت	آرت
امت	امت
تنگ	تنگ
سطح	سطح
لاک	لاک
آمین	آمین
ایوب	ایوب
باسک	باسک
باقر	باقر
برین	برین
تارا	تارا
خیزی	خیزی
روحی	روحی
سلام	سلام
عظیم	عظیم
عمرو	عمرو
لیست	لیست
مربع	مربع
مغول	مغول
میکل	میکل
یاغی	یاغی
دوغان	دوغان
رناتو	رناتو
زکریا	زکریا
سونیا	سونیا
سیاحت	سیاحت
مسئول	مسئول
معمار	معمار
پیمان	پیمان
کامپو	کامپو
انریکو	انریکو
مشروطیت	مشروطیت
اورلاندو	اورلاندو
موتورولا	موتورولا
هایدلبرگ	هایدلبرگ
عبدالمجید	عبدالمجید
استیل	استیل
آذین	آذین
جمعیتی	جمعیتی
پر	پر
ژن	ژن
خال	خال
فصل	فصل
فیش	فیش
اراک	اراک
بشیر	بشیر
تازه	تازه
حافظ	حافظ
رینو	رینو
ستار	ستار
مقام	مقام
میثم	میثم
هشام	هشام
چشمه	چشمه
آگوست	آگوست
ارسطو	ارسطو
جورجو	جورجو
رقابت	رقابت
شوشتر	شوشتر
صادقی	صادقی
قاچاق	قاچاق
پروژه	پروژه
ایوانز	ایوانز
ساندرا	ساندرا
علیشیر	علیشیر
اندروید	اندروید
استادیوم	استادیوم
ابوالقاسم	ابوالقاسم
عبدالکریم	عبدالکریم
دب	دب
الا	الا
دوو	دوو
رکس	رکس
آران	آران
بابل	بابل
تختی	تختی
تمام	تمام
تکاب	تکاب
روبر	روبر
زمین	زمین
ساوه	ساوه
مزار	مزار
میکا	میکا
نجیب	نجیب
نیما	نیما
یزید	یزید
اتفاق	اتفاق
احسان	احسان
خولیو	خولیو
دبلیو	دبلیو
صاحبی	صاحبی
نوریس	نوریس
کانال	کانال
ایالات	ایالات
تالبوت	تالبوت
رواندا	رواندا
ناپولی	ناپولی
آندره	آندره
الکترومغناطیس	الکترومغناطیس
لن	لن
صاف	صاف
قصر	قصر
هوو	هوو
ابرو	ابرو
بیمه	بیمه
توری	توری
تیلر	تیلر
ران	ران
ساشا	ساشا
شامی	شامی
فایق	فایق
محبت	محبت
العین	العین
خدیجه	خدیجه
ستاری	ستاری
قرین	قرین
مادّی	مادی
مجتبی	مجتبی
مروان	مروان
ویروس	ویروس
پرایس	پرایس
پرنسس	پرنسس
کلارا	کلارا
آرسنال	آرسنال
آلوارو	آلوارو
انریکه	انریکه
بندیکت	بندیکت
تماماً	تماماً
دالتون	دالتون
رولاند	رولاند
آتاتورک	آتاتورک
الکترون	الکترون
دیمیتری	دیمیتری
طرفداری	طرفداری
غلامرضا	غلامرضا
محمدیار	محمدیار
ونزوئلا	ونزوئلا
رابرتسون	رابرتسون
فرانکلین	فرانکلین
آلاباما	آلاباما
کرک	کرک
کیف	کیف
بناب	بناب
تایر	تایر
تمیز	تمیز
دیری	دیری
سجاد	سجاد
سوزی	سوزی
غریب	غریب
فاضل	فاضل
فوری	فوری
ماهر	ماهر
ملون	ملون
گویا	گویا
اداره	اداره
اعلام	اعلام
تگزاس	تگزاس
جرارد	جرارد
محروم	محروم
پیوتر	پیوتر
علاوه	علاوه
احتیاج	احتیاج
ارسلان	ارسلان
استونی	استونی
باکتری	باکتری
هیلاری	هیلاری
پاسکال	پاسکال
راندولف	راندولف
ماریانو	ماریانو
غلامحسین	غلامحسین
تایوان	تایوان
جلیل	جلیل
آبه	آبه
توی	توی
شوط	شوط
نظم	نظم
چوک	چوک
آلبر	آلبر
آنخل	آنخل
بایر	بایر
جاسم	جاسم
خطاب	خطاب
رانی	رانی
ریتر	ریتر
عماد	عماد
قبله	قبله
نقده	نقده
نهنگ	نهنگ
هجوم	هجوم
گرده	گرده
افشین	افشین
برنار	برنار
دیلمی	دیلمی
سیروس	سیروس
فرمان	فرمان
نپتون	نپتون
هوراس	هوراس
واردی	واردی
آلمیدا	آلمیدا
آنتوان	آنتوان
سامانی	سامانی
ماکسیم	ماکسیم
پادشاه	پادشاه
استفانو	استفانو
فو	فو
آری	آری
سرو	سرو
فال	فال
ژنو	ژنو
اد	اد
ثابت	ثابت
ماند	ماند
مثال	مثال
نویل	نویل
پیام	پیام
آندرس	آندرس
ایزاک	ایزاک
جریان	جریان
رمضان	رمضان
سیاتل	سیاتل
فیروز	فیروز
مهران	مهران
واکسن	واکسن
اولریش	اولریش
طبیعتی	طبیعتی
عثمانی	عثمانی
اینترنت	اینترنت
مزرعه	مزرعه
عجم	عجم
لیز	لیز
کوت	کوت
باکو	باکو
بینه	بینه
خانه	خانه
سایر	سایر
شرطی	شرطی
عمار	عمار
مازو	مازو
یونس	یونس
استان	استان
تلطیف	تلطیف
مکنزی	مکنزی
آنالیز	آنالیز
مجبوری	مجبوری
نیلسون	نیلسون
واسیلی	واسیلی
تدریجاً	تدریجاً
اورانیوم	اورانیوم
نیترات	نیترات
ما	ما
پن	پن
امی	امی
بلا	بلا
ترس	ترس
جزا	جزا
ضبط	ضبط
هدف	هدف
پیک	پیک
بلال	بلال
جانت	جانت
روسی	روسی
سومر	سومر
ژوزه	ژوزه
مارکز	مارکز
محمّد	محمد
هنریک	هنریک
چنگیز	چنگیز
مالاوی	مالاوی
کندوان	کندوان
استفاده	استفاده
بروکلین	بروکلین
خوزستان	خوزستان
لاکرونیا	لاکرونیا
پرزیدنتی	پرزیدنتی
ناصرالدین	ناصرالدین
مو	مو
علا	علا
هات	هات
پوپ	پوپ
گیل	گیل
رقاص	رقاص
شادی	شادی
طاهر	طاهر
قوْل	قول
مایو	مایو
مذهب	مذهب
ادریس	ادریس
بهزاد	بهزاد
زاویه	زاویه
نساجی	نساجی
کانون	کانون
مهرداد	مهرداد
وابسته	وابسته
هیوندای	هیوندای
آلساندرو	آلساندرو
ترینیداد	ترینیداد
تیتانیوم	تیتانیوم
ناسیونال	ناسیونال
ایدئولوژی	ایدئولوژی
عبدالرحیم	عبدالرحیم
اینترنشنال	اینترنشنال
مایکروسافت	مایکروسافت
یک	یک
شری	شری
بیات	بیات
سکوت	سکوت
غارت	غارت
ماجد	ماجد
مریل	مریل
نیکل	نیکل
گلین	گلین
اسامه	اسامه
بانکی	بانکی
جمشید	جمشید
مرحمت	مرحمت
مشهدی	مشهدی
هاینز	هاینز
چاینا	چاینا
ساندرز	ساندرز
بیسمارک	بیسمارک
دونالد	دونالد
آب	آب
رن	رن
شی	شی
مل	مل
راد	راد
سنا	سنا
ولف	ولف
بلوم	بلوم
بلوک	بلوک
تکنو	تکنو
شراب	شراب
غازی	غازی
مریم	مریم
وحید	وحید
کنار	کنار
اونیل	اونیل
بهروز	بهروز
دوریس	دوریس
سوفیا	سوفیا
عدنان	عدنان
مطبوع	مطبوع
نولان	نولان
والری	والری
انتونی	انتونی
قو	قو
فانتزی	فانتزی
موناکو	موناکو
ناتاشا	ناتاشا
فدراتیو	فدراتیو
پریا	پریا
جنی	جنی
دوم	دوم
رشد	رشد
پای	پای
یاس	یاس
ادعا	ادعا
اشرف	اشرف
حقوق	حقوق
شباب	شباب
قرآن	قرآن
معده	معده
مودی	مودی
ایمان	ایمان
سوْنا	سونا
فاطمه	فاطمه
مراجعت	مراجعت
هرودوت	هرودوت
موریتانی	موریتانی
بیوتیک	بیوتیک
نوح	نوح
آنری	آنری
آیدا	آیدا
بعضا	بعضا
خسرو	خسرو
فوکس	فوکس
نپال	نپال
واله	واله
کلوب	کلوب
بیرون	بیرون
نفرین	نفرین
کلاوس	کلاوس
یاسین	یاسین
اعتراض	اعتراض
فدریکو	فدریکو
کریشنا	کریشنا
اورشلیم	اورشلیم
نصرالدین	نصرالدین
پیتسبورگ	پیتسبورگ
دیش	دیش
نقل	نقل
پتی	پتی
ژول	ژول
خلاص	خلاص
لاله	لاله
مانی	مانی
مینو	مینو
نازی	نازی
یاسر	یاسر
تعریف	تعریف
شخصیت	شخصیت
پینتو	پینتو
سیستان	سیستان
شاهیٛن	شاهین
الجزیره	الجزیره
عبدالقادر	عبدالقادر
صدر	صدر
صرف	صرف
لون	لون
بیوک	بیوک
رفعت	رفعت
شارپ	شارپ
شورا	شورا
طرفه	طرفه
تصادف	تصادف
دوران	دوران
زرینه	زرینه
سوارز	سوارز
میسون	میسون
کشکول	کشکول
یوهانس	یوهانس
مادرید	مادرید
آناتولی	آناتولی
اردبیلی	اردبیلی
فیتزجرالد	فیتزجرالد
بس	بس
خلج	خلج
غزل	غزل
نبی	نبی
رمزی	رمزی
رودی	رودی
صباح	صباح
مورو	مورو
آغاسی	آغاسی
داریو	داریو
منهتن	منهتن
نازیک	نازیک
کرکوک	کرکوک
کشمیر	کشمیر
هافبک	هافبک
اسکندر	اسکندر
آندریاس	آندریاس
اسماعیلیه	اسماعیلیه
لور	لور
چکن	چکن
ثبوت	ثبوت
داون	داون
عارف	عارف
مارش	مارش
هیوز	هیوز
پارس	پارس
پرسی	پرسی
تنه	تنه
که	که
لیبرال	لیبرال
پرزیدنت	پرزیدنت
ریچاردسون	ریچاردسون
عبدالرحمان	عبدالرحمان
توت	توت
فقط	فقط
نثر	نثر
نفس	نفس
کیس	کیس
اطلس	اطلس
سرین	سرین
ماوا	ماوا
ماین	ماین
میل	میل
نینا	نینا
هانی	هانی
کارا	کارا
الشباب	الشباب
جولیوس	جولیوس
داوسون	داوسون
سبب	سبب
سرا	سرا
ماک	ماک
کون	کون
شرلی	شرلی
صحرا	صحرا
فتحی	فتحی
قهوه	قهوه
تعلیم	تعلیم
قفقاز	قفقاز
هارپر	هارپر
پدیده	پدیده
فرهنگی	فرهنگی
محمدزاده	محمدزاده
شاد	شاد
نوا	نوا
کیل	کیل
ساعت	ساعت
صابر	صابر
لیلا	لیلا
معنا	معنا
جزیره	جزیره
رشیدی	رشیدی
لورنس	لورنس
وکیلی	وکیلی
ادیسون	ادیسون
اشتفان	اشتفان
جنکینز	جنکینز
مالکوم	مالکوم
پاناما	پاناما
اتلتیکو	اتلتیکو
جم	جم
اسد	اسد
قلم	قلم
کره	کره
بارت	بارت
جیوه	جیوه
سمیر	سمیر
معدن	معدن
اولین	اولین
سردار	سردار
فلوید	فلوید
بغداد	بغداد
جیبوتی	جیبوتی
فدرال	فدرال
آدریانو	آدریانو
تقی	تقی
عشق	عشق
مهم	مهم
گوز	گوز
رومن	رومن
سنقر	سنقر
سیّد	سید
عینی	عینی
محرم	محرم
مسجد	مسجد
ایمنی	ایمنی
ریاضی	ریاضی
طایفه	طایفه
فریزر	فریزر
هکتور	هکتور
الوحده	الوحده
نورمال	نورمال
حتا	حتا
عدد	عدد
نام	نام
الان	الان
جامع	جامع
حدیث	حدیث
رندی	رندی
گونی	گونی
توران	توران
مختار	مختار
کربلا	کربلا
ناتالی	ناتالی
مارتینو	مارتینو
پاتریشیا	پاتریشیا
کر	کر
درو	درو
عمل	عمل
ویس	ویس
کتی	کتی
یاد	یاد
جده	جده
امید	امید
ترمه	ترمه
شرمن	شرمن
یاسا	یاسا
خاندان	خاندان
تولید	تولید
رم	رم
دال	دال
ایکس	ایکس
بند	بند
جابر	جابر
هانا	هانا
حقیقت	حقیقت
خرداد	خرداد
محکوم	محکوم
بولیوی	بولیوی
لورنزو	لورنزو
قهرمانی	قهرمانی
ویتامین	ویتامین
تانزانیا	تانزانیا
فین	فین
لیو	لیو
کرج	کرج
کسب	کسب
دایم	دایم
ساتو	ساتو
صلیب	صلیب
طارق	طارق
گینه	گینه
خرمشهر	خرمشهر
رومانو	رومانو
عبدالحمید	عبدالحمید
باره	باره
شلی	شلی
ایده	ایده
بینا	بینا
جمعه	جمعه
حالا	حالا
دویل	دویل
لغات	لغات
الکسی	الکسی
توفیق	توفیق
مارکس	مارکس
معروف	معروف
کریمی	کریمی
ایرانی	ایرانی
بریتیش	بریتیش
دنباله	دنباله
نریمان	نریمان
ماد	ماد
نظر	نظر
جواب	جواب
داشی	داشی
لوسی	لوسی
تعقیب	تعقیب
اورتون	اورتون
اکوادور	اکوادور
اوخ	اوخ
بکر	بکر
جمع	جمع
جنت	جنت
پیت	پیت
چال	چال
لیلی	لیلی
هاشم	هاشم
ورشو	ورشو
کاظم	کاظم
کوفه	کوفه
آنتون	آنتون
اعدام	اعدام
راندی	راندی
بالکان	بالکان
زند	زند
چان	چان
تسلیم	تسلیم
مکتوب	مکتوب
پرویز	پرویز
اتیوپی	اتیوپی
کاسترو	کاسترو
ماکسیمیلیان	ماکسیمیلیان
آنی	آنی
باک	باک
خلق	خلق
پود	پود
تینا	تینا
سجاس	سجاس
آنجلا	آنجلا
جراحی	جراحی
حقیقی	حقیقی
خورخه	خورخه
میلز	میلز
کنراد	کُنراد
سایمون	سایمون
سیمونز	سیمونز
هوکایدو	هوکایدو
آتلانتیک	آتلانتیک
موبایل	موبایل
فرید	فرید
فارسی	فارسی
تامسون	تامسون
دومینیک	دومینیک
لیورپول	لیورپول
امامزاده	امامزاده
آلکالوئید	آلکالوئید
آشور	آشور
زمان	زمان
سودا	سودا
ضعیف	ضعیف
اهمیت	اهمیت
دایمی	دایمی
سرجیو	سرجیو
عسگری	عسگری
محمدی	محمدی
وسترن	وسترن
آندرسون	آندرسون
هومبولت	هومبولت
تو	تو
رو	رو
الک	الک
بدر	بدر
ثبت	ثبت
روبی	روبی
صدیق	صدیق
نامه	نامه
ژوزف	ژوزف
مرداد	مرداد
اندونزی	اندونزی
شهرستان	شهرستان
دبی	دبی
دلا	دلا
ضرر	ضرر
فان	فان
باغی	باغی
راین	راین
لینچ	لینچ
تخمین	تخمین
حکومت	حکومت
داوود	داوود
موتور	موتور
هدایت	هدایت
سیمپسون	سیمپسون
فیلادلفیا	فیلادلفیا
چری	چری
خورد	خورد
رقیب	رقیب
مانع	مانع
نوری	نوری
ملیسا	ملیسا
هافمن	هافمن
فرانچسکو	فرانچسکو
آوا	آوا
رجب	رجب
قوش	قوش
پرز	پرز
کای	کای
گاه	گاه
سنین	سنین
اسفند	اسفند
جوزپه	جوزپه
سلماس	سلماس
قراری	قراری
روحانی	روحانی
آند	آند
اتو	اتو
بنه	بنه
سور	سور
تزار	تزار
سیاه	سیاه
اروین	اروین
ترکیب	ترکیب
درویش	درویش
سپاسی	سپاسی
هاوس	هاوس
جووانی	جووانی
آذربایجانی	آذربایجانی
بخش	بخش
برن	برن
بزرگ	بزرگ
دولو	دولو
بوریس	بوریس
بوشهر	بوشهر
رئیسی	رئیسی
دانیال	دانیال
کالینز	کالینز
چم	چم
جهد	جهد
پله	پله
کنی	کنی
حامد	حامد
بیجار	بیجار
تبلیغ	تبلیغ
تربیت	تربیت
روبین	روبین
قشلاق	قشلاق
مارسل	مارسل
لاهیجان	لاهیجان
جکی	جکی
چاد	چاد
حاکم	حاکم
چینه	چینه
احاطه	احاطه
سعودی	سعودی
مرتضی	مرتضی
ابومسلم	ابومسلم
ساوالان	ساوالان
نوتردام	نوتردام
پات	پات
روان	روان
مقصد	مقصد
اوانز	اوانز
زیارت	زیارت
نظارت	نظارت
اسلامی	اسلامی
فرانکو	فرانکو
لیل	لیل
دستک	دستک
دهلی	دهلی
وزیر	وزیر
درحال	درحال
سانچز	سانچز
کاتلین	کاتلین
انور	انور
پابلو	پابلو
کامیل	کامیل
اور	اور
ایو	ایو
سنه	سنه
ضیا	ضیا
توره	توره
دکتر	دکتر
سورن	سورن
مردم	مردم
رامون	رامون
فاستر	فاستر
وارنر	وارنر
فریدون	فریدون
کاستاریکا	کاستاریکا
فخری	فخری
لقبی	لقبی
خاویر	خاویر
فرهاد	فرهاد
ایروان	ایروان
اردیبهشت	اردیبهشت
فارماکولوژی	فارماکولوژی
بت	بت
درد	درد
نان	نان
ثانی	ثانی
جویس	جویس
بمبئی	بمبئی
بَی	بی
داریوش	داریوش
کلیفورد	کلیفورد
ابراهیمی	ابراهیمی
بک	بک
سند	سند
قوا	قوا
قوی	قوی
یون	یون
اکثر	اکثر
بیان	بیان
سهند	سهند
نوروز	نوروز
پولیس	پولیس
کارلو	کارلو
امرسون	امرسون
فیلیپه	فیلیپه
قانونی	قانونی
مالایا	مالایا
پیج	پیج
رایس	رایس
فیصل	فیصل
حسینی	حسینی
رویال	رویال
مذهبی	مذهبی
ماتیاس	ماتیاس
مسیحیت	مسیحیت
النصر	النصر
تدقیق	تدقیق
ابی	ابی
خطی	خطی
رحیم	رحیم
کوهی	کوهی
الیور	الیور
فیزیک	فیزیک
مکزیکو	مکزیکو
خاتون	خاتون
هوارد	هوارد
جیک	جیک
سحر	سحر
مایر	مایر
مرند	مرند
مودّت	مودت
مارسلو	مارسلو
با	با
وبر	وبر
لیزا	لیزا
هجری	هجری
تأسیس	تأسیس
هولمز	هولمز
کریستی	کریستی
فیلیپین	فیلیپین
نو	نو
آلی	آلی
شام	شام
ملی	ملی
اوون	اوون
جونی	جونی
عدالت	عدالت
کوروش	کوروش
آقا	آقا
دنور	دنور
سالم	سالم
فولر	فولر
سلمان	سلمان
ملوان	ملوان
تون	تون
شرح	شرح
ویک	ویک
ترکی	ترکی
بهرام	بهرام
هاپکینز	هاپکینز
نجف	نجف
سرحد	سرحد
صاحب	صاحب
هلاک	هلاک
آلا	آلا
تور	تور
لیگ	لیگ
راشد	راشد
قدیمی	قدیمی
رودولف	رودولف
فردیناند	فردیناند
آلکس	آلکس
صوفی	صوفی
مولر	مولر
امیلی	امیلی
ریموند	ریموند
قهرمان	قهرمان
خالقی	خالقی
سعد	سعد
سنی	سنی
باند	باند
نفره	نفره
تنقید	تنقید
گلکسی	گلکسی
فنلاند	فنلاند
حمد	حمد
شکر	شکر
اشلی	اشلی
نظری	نظری
آنتیک	آنتیک
فابیو	فابیو
جاستین	جاستین
فجر	فجر
چون	چون
رونی	رونی
نیکی	نیکی
یوزف	یوزف
آندری	آندری
منسوب	منسوب
ادواردو	ادواردو
ترور	ترور
درام	درام
ولید	ولید
فلیکس	فلیکس
میلاد	میلاد
فرانتس	فرانتس
راب	راب
مادی	مادی
ژرمن	ژرمن
نیکلاس	نیکلاس
صمد	صمد
سوره	سوره
میکی	میکی
وولف	وولف
یوری	یوری
مارتن	مارتن
را	را
یزد	یزد
سوسن	سوسن
شهرک	شهرک
فرناندز	فرناندز
مریلند	مریلند
کارولین	کارولین
دول	دول
لوی	لوی
ژاک	ژاک
همان	همان
معنوی	معنوی
هاینریش	هاینریش
ژرژ	ژرژ
آرون	آرون
امام	امام
باشی	باشی
سونا	سونا
آدولف	آدولف
الیاس	الیاس
جسیکا	جسیکا
فوتسال	فوتسال
سباستین	سباستین
خط	خط
اورال	اورال
ماتیو	ماتیو
ریچاردز	ریچاردز
آلکساندر	آلکساندر
امر	امر
بوید	بوید
مرکز	مرکز
فریرا	فریرا
بول	بول
خوش	خوش
دوره	دوره
رشید	رشید
مشروطه	مشروطه
حل	حل
حمزه	حمزه
دعوت	دعوت
سلیم	سلیم
لوری	لوری
گونه	گونه
تدریس	تدریس
سیلور	سیلور
آستارا	آستارا
جیووانی	جیووانی
جاش	جاش
آلیس	آلیس
عربی	عربی
مارتا	مارتا
نیومن	نیومن
اوْ	او
سفر	سفر
جردن	جردن
توسعه	توسعه
عاید	عاید
تصدیق	تصدیق
استفان	استفان
اولیور	اولیور
سم	سم
بود	بود
هویزه	هویزه
منه	منه
خواجه	خواجه
نیکولا	نیکولا
کاتولیک	کاتولیک
رز	رز
بلکه	بلکه
منفی	منفی
بارسلون	بارسلون
شهرداری	شهرداری
جرالد	جرالد
پولاد	پولاد
بدن	بدن
برد	برد
فتح	فتح
ترتیب	ترتیب
لغو	لغو
فاکس	فاکس
بال	بال
وطن	وطن
جواد	جواد
نایل	نایل
ایساک	ایساک
فرهنگ	فرهنگ
شو	شو
مراد	مراد
رادیو	رادیو
یعقوب	یعقوب
علیرضا	علیرضا
لنکران	لنکران
لورا	لورا
نیکول	نیکول
هارون	هارون
ویدئو	ویدئو
دانی	دانی
سزار	سزار
شریف	شریف
آشکار	آشکار
خاص	خاص
منی	منی
قاسم	قاسم
سایپا	سایپا
عوض	عوض
عادل	عادل
تیموتی	تیموتی
کالین	کالین
آبراهام	آبراهام
تا	تا
کوهن	کوهن
عثمان	عثمان
دری	دری
سنتر	سنتر
تکرار	تکرار
حتّی	حتی
مودت	مودت
مالزی	مالزی
تقریباً	تقریباً
تد	تد
باری	باری
الکترونیک	الکترونیک
فهد	فهد
راجر	راجر
ستاره	ستاره
بوتسوانا	بوتسوانا
بر	بر
راه	راه
جودی	جودی
فعال	فعال
والاس	والاس
جیب	جیب
قلمه	قلمه
لورن	لورن
مس	مس
اوْتو	اوتو
بوسنی	بوسنی
دیوان	دیوان
مبارک	مبارک
آلبرتو	آلبرتو
بایرامی	بایرامی
مات	مات
شارل	شارل
صادق	صادق
متیو	متیو
نیوزیلند	نیوزیلند
فردی	فردی
تایلند	تایلند
عبدالرحمن	عبدالرحمن
طارم	طارم
درک	درک
سعود	سعود
نورمن	نورمن
حصر	حصر
شهره	شهره
رابین	رابین
فلسفی	فلسفی
منصور	منصور
پورتو	پورتو
جمهوری	جمهوری
دقیق	دقیق
آمونیوم	آمونیوم
هیوستون	هیوستون
امیل	امیل
مکعب	مکعب
کانی	کانی
لارنس	لارنس
میلیارد	میلیارد
داو	داو
محو	محو
مارتینز	مارتینز
روز	روز
ملک	ملک
حسنی	حسنی
تمثیل	تمثیل
جلب	جلب
چاک	چاک
آرنا	آرنا
کارن	کارن
یاکوب	یاکوب
بیت	بیت
جمعی	جمعی
معین	معین
هیو	هیو
شخصی	شخصی
ماکس	ماکس
ویلی	ویلی
وایادولید	وایادولید
پت	پت
روبن	روبن
اولاد	اولاد
تاثیر	تاثیر
مسعود	مسعود
دولت	دولت
تکلیف	تکلیف
رونالد	رونالد
لیتیوم	لیتیوم
دیترویت	دیترویت
قول	قول
موسی	موسی
همیشه	همیشه
ادموند	ادموند
سامی	سامی
صالح	صالح
مطبوعات	مطبوعات
اسکار	اسکار
لوپز	لوپز
محسن	محسن
رنه	رنه
ناصر	ناصر
کریستال	کریستال
بوش	بوش
پدرو	پدرو
تأمین	تأمین
اسیر	اسیر
برپا	برپا
فیلیپس	فیلیپس
مازندران	مازندران
ضد	ضد
کری	کری
لویس	لویس
فرناندو	فرناندو
درمان	درمان
فولاد	فولاد
دیو	دیو
جعفر	جعفر
دوام	دوام
عملیاتی	عملیاتی
غنا	غنا
هلن	هلن
حمید	حمید
تطبیق	تطبیق
لوک	لوک
تامی	تامی
جوان	جوان
بالتیمور	بالتیمور
جولی	جولی
فیشر	فیشر
دفن	دفن
بروم	بروم
کوپر	کوپر
متال	متال
شیرین	شیرین
پترولیوم	پترولیوم
بالا	بالا
بنین	بنین
دوک	دوک
نادر	نادر
ایفا	ایفا
ایضاح	ایضاح
محمدرضا	محمدرضا
راس	راس
اوزو	اوزو
حلال	حلال
جفری	جفری
سوپر	سوپر
قرار	قرار
برونو	برونو
بهبهان	بهبهان
ابهر	ابهر
کنیا	کنیا
عبدالعزیز	عبدالعزیز
نوع	نوع
رومانتیک	رومانتیک
ویلا	ویلا
زبان	زبان
مت	مت
تیمور	تیمور
نانسی	نانسی
کریستیان	کریستیان
عزیز	عزیز
فن	فن
فی	فی
خوی	خوی
فیزیکی	فیزیکی
دنی	دنی
تسلا	تسلا
ماریو	ماریو
آزادگان	آزادگان
بوُ	بو
قرق	قرق
پیس	پیس
دایر	دایر
برنارد	برنارد
جیسون	جیسون
خصوصی	خصوصی
حبس	حبس
قطر	قطر
ریکاردو	ریکاردو
بیزیم	بیزیم
وال	وال
کشف	کشف
جانی	جانی
پهلوی	پهلوی
کامرون	کامرون
بریان	بریان
آلومینیوم	آلومینیوم
دیک	دیک
شمسی	شمسی
عباسی	عباسی
پال	پال
عیسی	عیسی
خلیل	خلیل
نیک	نیک
اصلی	اصلی
اندی	اندی
هربرت	هربرت
بحث	بحث
جاز	جاز
لویی	لویی
فرانسیسکو	فرانسیسکو
خلف	خلف
الکس	الکس
قاری	قاری
یوهان	یوهان
سوزان	سوزان
سیمون	سیمون
اوکراین	اوکراین
نیکولاس	نیکولاس
تأثیر	تأثیر
تقدیم	تقدیم
کارتر	کارتر
مارکو	مارکو
مجبور	مجبور
از	از
خالد	خالد
نیتروژن	نیتروژن
ولی	ولی
سلیمان	سلیمان
استنفورد	استنفورد
درج	درج
ویلهلم	ویلهلم
هارولد	هارولد
روبرتو	روبرتو
هاوارد	هاوارد
آغا	آغا
ریتم	ریتم
شهید	شهید
ابو	ابو
طلب	طلب
کارول	کارول
حومه	حومه
دشت	دشت
عمومی	عمومی
سوسیالیست	سوسیالیست
کوک	کوک
چارلی	چارلی
مهاباد	مهاباد
وستفالن	وستفالن
ون	وِن
عرضه	عرضه
لوئیز	لوئیز
رد	رد
تئودور	تئودور
خوان	خوان
استات	استات
بلوز	بلوز
جاناتان	جاناتان
کن	کن
محض	محض
عبد	عبد
فعالیت	فعالیت
آرادان	آرادان
اریکسون	اریکسون
کیت	کیت
باب	باب
سام	سام
بنی	بنی
خبر	خبر
فیزیولوژی	فیزیولوژی
جنیفر	جنیفر
هانس	هانس
موهوم	موهوم
رید	رید
میشل	میشل
جری	جری
الن	الن
عمله	عمله
جور	جور
ادوین	ادوین
تخمیناً	تخمینا
یونایتد	یونایتد
حاج	حاج
دون	دون
عکس	عکس
دوبلور	دوبلور
ارنست	ارنست
سوت	سوت
وْ	و
کریم	کریم
امین	امین
مالی	مالی
رالف	رالف
تصویر	تصویر
پتر	پتر
جدی	جدی
عین	عین
بروس	بروس
برایان	برایان
جولیا	جولیا
جف	جف
راست	راست
قره	قره
آلفرد	آلفرد
خدابنده	خدابنده
سرطان	سرطان
کریستوفر	کریستوفر
خزر	خزر
اوْت	اوت
مغلوب	مغلوب
وکیل	وکیل
باربارا	باربارا
گوْل	گول
اگر	اگر
سارا	سارا
هیدروژن	هیدروژن
فیل	فیل
جولای	جولای
باد	باد
دموکراتیک	دموکراتیک
بنجامین	بنجامین
هاوایی	هاوایی
هیل	هیل
اما	اما
نیمه	نیمه
حرکت	حرکت
مهدی	مهدی
آسام	آسام
لیسانس	لیسانس
سعید	سعید
لایق	لایق
هارد	هارد
اسماعیل	اسماعیل
فرد	فرد
سانتوس	سانتوس
استیون	استیون
کریستین	کریستین
اسکات	اسکات
تابعه	تابعه
وقفی	وقفی
فردریک	فردریک
کارلوس	کارلوس
سردشت	سردشت
طیب	طیب
استیو	استیو
جونیور	جونیور
فتحعلی	فتحعلی
نقش	نقش
امیر	امیر
یورو	یورو
ابن	ابن
تکنولوژی	تکنولوژی
جون	جون
کوین	کوین
آلبرت	آلبرت
تونی	تونی
مصطفی	مصطفی
دراماتیک	دراماتیک
وان	وان
جیمی	جیمی
سونی	سونی
اعلان	اعلان
الکتریک	الکتریک
سید	سید
اتر	اتر
پارک	پارک
موزیک	موزیک
فرانسیس	فرانسیس
آزاد	آزاد
ساریٛ	ساری
پاتریک	پاتریک
سویا	سویا
یاقوت	یاقوت
اعانه	اعانه
شیمی	شیمی
یوز	یوز
گلن	گلن
سیلوا	سیلوا
هاروارد	هاروارد
والتر	والتر
ویلیامز	ویلیامز
شیخ	شیخ
کریس	کریس
تعیین	تعیین
سامسونگ	سامسونگ
مانکن	مانکن
مایک	مایک
جیم	جیم
مشهور	مشهور
نوامبر	نوامبر
آرکانزاس	آرکانزاس
جنوبی	جنوبی
تامین	تامین
در	در
نشر	نشر
بیل	بیل
عمر	عمر
تاسیس	تاسیس
آز	آز
تابع	تابع
دانیل	دانیل
اوت	اوت
براون	براون
تلویزیون	تلویزیون
مایع	مایع
حساب	حساب
تئاتر	تئاتر
نیو	نیو
سناریو	سناریو
موسّسه	موسسه
دَسته	دسته
بورکینافاسو	بورکینافاسو
دل	دل
طبیعی	طبیعی
فوتبالیست	فوتبالیست
ایرلند	ایرلند
نوکیا	نوکیا
موزیسین	موزیسین
مونتانا	مونتانا
آمور	آمور
همین	همین
فرانک	فرانک
مول	مول
برک	برک
مارک	مارک
آلاسکا	آلاسکا
سان	سان
نوبل	نوبل
روبرت	روبرت
یوتا	یوتا
دیوید	دیوید
نفوس	نفوس
تشکیل	تشکیل
ژولای	ژولای
پیتر	پیتر
ادوارد	ادوارد
سهامی	سهامی
عالی	عالی
دیگر	دیگر
دیاری	دیاری
آلبوم	آلبوم
اله	اله
مایکل	مایکل
نیومکزیکو	نیومکزیکو
ماساچوست	ماساچوست
اسید	اسید
پرم	پرم
تنسی	تنسی
پاپ	پاپ
وب	وب
نیوجرسی	نیوجرسی
توماس	توماس
ریچارد	ریچارد
رابرت	رابرت
آندرا	آندرا
کارولینا	کارولینا
گریگوری	گریگوری
پنجابی	پنجابی
جورجیا	جورجیا
آریزونا	آریزونا
بن	بن
پنجاب	پنجاب
فعالیّت	فعالیت
داکوتا	داکوتا
گروه	گروه
ایندیانا	ایندیانا
اوهایو	اوهایو
پنسیلوانیا	پنسیلوانیا
ژوئن	ژوئن
کنتاکی	کنتاکی
آیووا	آیووا
ولادیمیر	ولادیمیر
تامیل	تامیل
ویلیام	ویلیام
سناتور	سناتور
ویرجینیا	ویرجینیا
شیمیایی	شیمیایی
درس	درس
وفات	وفات
کنده	کنده
تیمی	تیمی
سَویه	سویه