آب	آب
آبا	آبا
آباد	آباد
آبادان	آبادان
آبادی	آبادی
آبان	آبان
آبراهام	آبراهام
آبشار	آبشار
آبکنار	آبکنار
آبگرم	آبگرم
آتش	آتش
آتشکده	آتشکده
آثار	آثار
آثاری	آثاری
آخر	آخر
آخرسر	آخرسر
آخری	آخری
آخرین	آخرین
آدام	آدام
آدرس	آدرس
آدم	آدم
آدمی	آدمی
آذر	آذر
آذربایجان	آذربایجان
آذرشهر	آذرشهر
آرام	آرام
آرامش	آرامش
آرامگاه	آرامگاه
آران	آران
آرش	آرش
آرژانتین	آرژانتین
آرکانزاس	آرکانزاس
آریا	آریا
آریایی	آریایی
آریزونا	آریزونا
آزاد	آزاد
آزادشهر	آزادشهر
آزادگان	آزادگان
آزادی	آزادی
آزار	آزار
آسان	آسان
آستارا	آستارا
آستانه	آستانه
آسفالت	آسفالت
آسم	آسم
آسمان	آسمان
آسیا	آسیا
آسیاب	آسیاب
آسیایی	آسیایی
آشفته	آشفته
آشنا	آشنا
آشنایی	آشنایی
آشکار	آشکار
آغاز	آغاز
آغداشلو	آغداشلو
آغوز	آغوز
آفت	آفت
آفتاب	آفتاب
آفرید	آفرید
آفریقا	آفریقا
آفریقایی	آفریقایی
آقا	آقا
آل	آل
آلاباما	آلاباما
آلاسکا	آلاسکا
آلبوم	آلبوم
آلمان	آلمان
آلمانی	آلمانی
آلوچه	آلوچه
آماده	آماده
آمار	آمار
آماردان	آماردان
آمد	آمد
آمریکا	آمریکا
آمریکایی	آمریکایی
آمفی	آمفی
آمل	آمل
آموزش	آموزش
آموزشگاه	آموزشگاه
آمون	آمون
آن	آن
آنا	آنا
آناناس	آناناس
آنجا	آنجا
آنجلس	آنجلس
آندره	آندره
آنلاین	آنلاین
آنها	آنها
آنچه	آنچه
آهن	آهن
آهنگ	آهنگ
آهنگساز	آهنگساز
آواز	آواز
آوازه	آوازه
آوریل	آوریل
آپادانا	آپادانا
آگاه	آگاه
آگوست	آگوست
آی	آی
آیا	آیا
آیت	آیت
آینده	آینده
آینه	آینه
آیه	آیه
ائتلاف	ائتلاف
ابا	ابا
ابتدا	ابتدا
ابتلا	ابتلا
ابتهاج	ابتهاج
ابداع	ابداع
ابر	ابر
ابراز	ابراز
ابراهیم	ابراهیم
ابریشم	ابریشم
ابزار	ابزار
ابعاد	ابعاد
ابن	ابن
ابهر	ابهر
ابوالحسن	ابوالحسن
ابوالقاسم	ابوالقاسم
ابوذر	ابوذر
ابوطالب	ابوطالب
ابوموسی	ابوموسی
ابی	ابی
اتاق	اتاق
اتحاد	اتحاد
اتصال	اتصال
اتفاق	اتفاق
اتهام	اتهام
اتو	اتو
اثر	اثر
اجازه	اجازه
اجباری	اجباری
اجتماع	اجتماع
اجتماعی	اجتماعی
اجرا	اجرا
اجرایی	اجرایی
احترام	احترام
احتمال	احتمال
احتمالا	احتمالا
احداث	احداث
احساس	احساس
احسان	احسان
احمد	احمد
احمدخان	احمدخان
احمدی	احمدی
احوال	احوال
اخبار	اخبار
اختراع	اختراع
اختصار	اختصار
اختصاص	اختصاص
اختلاف	اختلاف
اختلافات	اختلافات
اخته	اخته
اختیار	اختیار
اختیارات	اختیارات
اخذ	اخذ
اخوان	اخوان
اخیر	اخیر
اداره	اداره
اداری	اداری
ادامه	ادامه
ادب	ادب
ادبی	ادبی
ادبیات	ادبیات
ادعا	ادعا
ادغام	ادغام
ادوارد	ادوارد
ارائه	ارائه
اراک	اراک
ارباب	ارباب
ارتباط	ارتباط
ارتش	ارتش
ارتفاع	ارتفاع
ارتفاعات	ارتفاعات
ارتقا	ارتقا
ارجاع	ارجاع
ارجمند	ارجمند
اردبیل	اردبیل
اردبیلی	اردبیلی
اردشیر	اردشیر
اردشیری	اردشیری
اردک	اردک
اردکان	اردکان
اردیبهشت	اردیبهشت
ارزش	ارزش
ارشاد	ارشاد
ارشد	ارشد
ارم	ارم
ارنست	ارنست
اره	اره
ارومیه	ارومیه
اروپا	اروپا
اروپایی	اروپایی
ارکستر	ارکستر
ارگ	ارگ
از	از
ازدواج	ازدواج
اساس	اساس
اسالم	اسالم
اسب	اسب
اسباب	اسباب
است	است
استاد	استاد
استان	استان
استاندارد	استاندارد
استبداد	استبداد
استثمار	استثمار
استخدام	استخدام
استخر	استخر
استراتژی	استراتژی
استراسبرگ	استراسبرگ
استعداد	استعداد
استعفا	استعفا
استعمار	استعمار
استفاده	استفاده
استقبال	استقبال
استقلال	استقلال
استیشن	استیشن
اسحاق	اسحاق
اسدالله	اسدالله
اسدی	اسدی
اسرار	اسرار
اسفار	اسفار
اسفناج	اسفناج
اسفند	اسفند
اسلام	اسلام
اسلامی	اسلامی
اسلحه	اسلحه
اسم	اسم
اسماعیل	اسماعیل
اسناد	اسناد
اسپانیا	اسپانیا
اسپانیایی	اسپانیایی
اسپهبدان	اسپهبدان
اسکات	اسکات
اسکاتلند	اسکاتلند
اسکان	اسکان
اسکاندیناوی	اسکاندیناوی
اسکندر	اسکندر
اسکو	اسکو
اسیر	اسیر
اشاره	اشاره
اشتباه	اشتباه
اشتراک	اشتراک
اشتهارد	اشتهارد
اشراف	اشراف
اشرف	اشرف
اشرفیه	اشرفیه
اشعار	اشعار
اشغال	اشغال
اشک	اشک
اشکال	اشکال
اشکور	اشکور
اشیا	اشیا
اشیاء	اشیاء
اصرار	اصرار
اصطلاح	اصطلاح
اصغر	اصغر
اصفهان	اصفهان
اصل	اصل
اصلاح	اصلاح
اصلاحات	اصلاحات
اصلی	اصلی
اصول	اصول
اصیل	اصیل
اضافه	اضافه
اطاعت	اطاعت
اطراف	اطراف
اطلاع	اطلاع
اطلاعات	اطلاعات
اعتبار	اعتبار
اعتراض	اعتراض
اعتراف	اعتراف
اعتصاب	اعتصاب
اعتقاد	اعتقاد
اعتماد	اعتماد
اعدام	اعدام
اعراب	اعراب
اعزام	اعزام
اعصاب	اعصاب
اعضا	اعضا
اعظم	اعظم
اعلام	اعلام
اعمال	اعمال
اعیان	اعیان
اغلب	اغلب
افتتاح	افتتاح
افتخار	افتخار
افتخاری	افتخاری
افرا	افرا
افراد	افراد
افراشته	افراشته
افزار	افزار
افزایش	افزایش
افسانه	افسانه
افشار	افشار
افغانستان	افغانستان
افکار	افکار
اقتدار	اقتدار
اقتصاد	اقتصاد
اقدامات	اقدامات
اقسام	اقسام
اقلیت	اقلیت
اقوام	اقوام
اقیانوس	اقیانوس
الان	الان
البته	البته
البرز	البرز
الحاق	الحاق
الله	الله
المان	المان
اله	اله
الهام	الهام
الهدی	الهدی
الکتریکی	الکتریکی
الی	الی
اما	اما
امارات	امارات
امام	امام
امامزاده	امامزاده
امان	امان
امانی	امانی
امتیاز	امتیاز
امرا	امرا
امروز	امروز
امروزه	امروزه
امریکا	امریکا
امضا	امضا
املش	املش
امنیت	امنیت
امواج	امواج
اموال	اموال
امور	امور
امّا	امّا
امپراتور	امپراتور
امپراتوری	امپراتوری
امکان	امکان
امکانات	امکانات
امی	امی
امید	امید
امیر	امیر
امیرکبیر	امیرکبیر
امین	امین
امینی	امینی
انار	انار
انبار	انبار
انبوه	انبوه
انتخاب	انتخاب
انتخابات	انتخابات
انتخاباتی	انتخاباتی
انتشار	انتشار
انتشارات	انتشارات
انتظار	انتظار
انتقاد	انتقاد
انتقال	انتقال
انتقام	انتقام
انجام	انجام
انجمن	انجمن
انجیر	انجیر
اندازه	اندازه
اندی	اندی
اندیشه	اندیشه
انرژی	انرژی
انزلی	انزلی
انسان	انسان
انسانی	انسانی
انشایی	انشایی
انصاری	انصاری
انقلاب	انقلاب
انواع	انواع
انگلستان	انگلستان
انگلیسی	انگلیسی
انگور	انگور
انگیز	انگیز
انگیزه	انگیزه
اهالی	اهالی
اهدا	اهدا
اهر	اهر
اهل	اهل
اهلی	اهلی
اهمیت	اهمیت
اهواز	اهواز
او	او
اواخر	اواخر
اواسط	اواسط
اوایل	اوایل
اوج	اوج
اورال	اورال
اوره	اوره
اوستایی	اوستایی
اوضاع	اوضاع
اول	اول
اولین	اولین
اولیه	اولیه
اون	اون
اونِ	اون
اوّل	اول
اِشکور	اشکور
اکبر	اکبر
اکبریه	اکبریه
اکتبر	اکتبر
اکثر	اکثر
اکثرا	اکثرا
اکران	اکران
اکنون	اکنون
اگر	اگر
اگه	اگه
ای	ای
ایالات	ایالات
ایالت	ایالت
ایام	ایام
ایتالیا	ایتالیا
ایجاد	ایجاد
ایده	ایده
ایران	ایران
ایرانشهر	ایرانشهر
ایرانی	ایرانی
ایرانیان	ایرانیان
ایرج	ایرج
ایستگاه	ایستگاه
ایسم	ایسم
ایشان	ایشان
ایشون	ایشون
ایلام	ایلام
ایلیا	ایلیا
این	این
اینترنت	اینترنت
اینکه	اینکه
ایوان	ایوان
ایکس	ایکس
با	با
باب	باب
بابا	بابا
بابل	بابل
بابلسر	بابلسر
بابِل	بابل
بابک	بابک
باتلر	باتلر
باد	باد
بادام	بادام
بار	بار
باران	باران
بارسلونا	بارسلونا
باره	باره
بارها	بارها
باری	باری
باز	باز
بازار	بازار
بازداشت	بازداشت
بازدید	بازدید
بازرگانی	بازرگانی
بازسازی	بازسازی
بازنشسته	بازنشسته
بازی	بازی
بازیکنان	بازیکنان
بازیگر	بازیگر
بازیگران	بازیگران
بازیگری	بازیگری
باستان	باستان
باستانشناسان	باستانشناسان
باستانی	باستانی
باسواد	باسواد
باشد	باشد
باشند	باشند
باشگاه	باشگاه
باشی	باشی
باعث	باعث
باغ	باغ
باغستان	باغستان
باغچه	باغچه
باغی	باغی
بافت	بافت
بافی	بافی
باقر	باقر
باقری	باقری
باقلا	باقلا
باقی	باقی
بال	بال
بالا	بالا
بالاتجن	بالاتجن
بالاخره	بالاخره
بالتیک	بالتیک
بالغ	بالغ
بام	بام
بان	بان
باند	باند
بانه	بانه
بانو	بانو
بانوان	بانوان
بانک	بانک
بانی	بانی
باور	باور
باید	باید
ببرد	ببرد
ببست	ببست
ببو	ببو
بجا	بجا
بحث	بحث
بحران	بحران
بحساب	بحساب
بخار	بخار
بخارا	بخارا
بخاطر	بخاطر
بختیاری	بختیاری
بخش	بخش
بخشی	بخشی
بخواند	بخواند
بد	بد
بداری	بداری
بدارید	بدارید
بدر	بدر
بدست	بدست
بدلیل	بدلیل
بدن	بدن
بدنه	بدنه
بده	بده
بدون	بدون
بدی	بدی
بدید	بدید
بر	بر
برابر	برابر
برابری	برابری
براری	براری
برای	برای
برتر	برتر
برج	برج
برجسته	برجسته
برخلاف	برخلاف
برخورد	برخورد
برخوردار	برخوردار
برخی	برخی
برد	برد
برداری	برداری
برداشت	برداشت
بردسکن	بردسکن
بردن	بردن
برده	برده
بردگان	بردگان
بررسی	بررسی
برطرف	برطرف
برعهده	برعهده
برعکس	برعکس
برف	برف
برق	برق
برقرار	برقرار
برمن	برمن
برنامه	برنامه
برنج	برنج
برنجی	برنجی
برنده	برنده
برنز	برنز
بره	بره
بروجرد	بروجرد
بروجن	بروجن
برون	برون
برپا	برپا
برگ	برگ
برگان	برگان
برگرد	برگرد
برگزار	برگزار
برگزیده	برگزیده
بریتانیا	بریتانیا
بزا	بزا
بزرگ	بزرگ
بزن	بزن
بزه	بزه
بس	بس
بست	بست
بستان	بستان
بستن	بستن
بسته	بسته
بستَ	بست
بستگی	بستگی
بستی	بستی
بسر	بسر
بسکتبال	بسکتبال
بسیار	بسیار
بسیاری	بسیاری
بشار	بشار
بشر	بشر
بشمار	بشمار
بشه	بشه
بشو	بشو
بصورت	بصورت
بطور	بطور
بعثت	بعثت
بعد	بعد
بعدا	بعدا
بعداز	بعداز
بعضی	بعضی
بعنوان	بعنوان
بغداد	بغداد
بقایا	بقایا
بقعه	بقعه
بقیه	بقیه
بل	بل
بلافاصله	بلافاصله
بلند	بلند
بلندی	بلندی
بلوار	بلوار
بلوط	بلوط
بلوچستان	بلوچستان
بلکه	بلکه
بم	بم
بمرد	بمرد
بمو	بمو
بن	بن
بنا	بنا
بناب	بناب
بنالم	بنالم
بنام	بنام
بند	بند
بندر	بندر
بنده	بنده
بندی	بندی
بنفش	بنفش
بنفشه	بنفشه
بنه	بنه
بنگاه	بنگاه
بنیاد	بنیاد
به	به
بهار	بهار
بهارستان	بهارستان
بهانه	بهانه
بهبهان	بهبهان
بهترین	بهترین
بهداشت	بهداشت
بهرام	بهرام
بهره	بهره
بهزاد	بهزاد
بهشت	بهشت
بهشتی	بهشتی
بهشهر	بهشهر
بهمن	بهمن
بهنام	بهنام
بو	بو
بوئین	بوئین
بوبو	بوبو
بوته	بوته
بوجود	بوجود
بود	بود
بودجه	بودجه
بودن	بودن
بودند	بودند
بوده	بوده
بورد	بورد
بورس	بورس
بوز	بوز
بوستان	بوستان
بوشهر	بوشهر
بولوار	بولوار
بوم	بوم
بومی	بومی
بوکان	بوکان
بویراحمد	بویراحمد
بِه	به
بپا	بپا
بچه	بچه
بکار	بکار
بکت	بکت
بکر	بکر
بگو	بگو
بی	بی
بیا	بیا
بیابان	بیابان
بیابانی	بیابانی
بیان	بیان
بیانی	بیانی
بیت	بیت
بیجار	بیجار
بید	بید
بیرون	بیرون
بیرونی	بیرونی
بیست	بیست
بیستم	بیستم
بیش	بیش
بیشتر	بیشتر
بیشترین	بیشترین
بیشه	بیشه
بیل	بیل
بیمار	بیمار
بیمارستان	بیمارستان
بیماری	بیماری
بین	بین
بینی	بینی
بیژن	بیژن
بیک	بیک
بیگی	بیگی
تأثیر	تأثیر
تأسیس	تأسیس
تئاتر	تئاتر
تا	تا
تابستان	تابستان
تابع	تابع
تابوت	تابوت
تاثیر	تاثیر
تاج	تاج
تاجر	تاجر
تار	تار
تاراج	تاراج
تارم	تارم
تاریخ	تاریخ
تاریخچه	تاریخچه
تاریک	تاریک
تازه	تازه
تاسیس	تاسیس
تالار	تالار
تالش	تالش
تام	تام
تامین	تامین
تب	تب
تبار	تبار
تبدیل	تبدیل
تبری	تبری
تبریز	تبریز
تبلیغ	تبلیغ
تجارت	تجارت
تجاری	تجاری
تجاوز	تجاوز
تجدید	تجدید
تجربه	تجربه
تجریش	تجریش
تجن	تجن
تجهیزات	تجهیزات
تحت	تحت
تحریک	تحریک
تحصیل	تحصیل
تحصیلات	تحصیلات
تحقیق	تحقیق
تحقیقات	تحقیقات
تحلیل	تحلیل
تحمل	تحمل
تحول	تحول
تحولات	تحولات
تحویل	تحویل
تخت	تخت
تخته	تخته
تختی	تختی
تخریب	تخریب
تخلیه	تخلیه
تخمین	تخمین
تدریس	تدریس
تر	تر
تراب	تراب
ترانه	ترانه
تربت	تربت
تربیت	تربیت
ترتیب	ترتیب
ترجمه	ترجمه
ترس	ترس
ترش	ترش
ترقی	ترقی
تره	تره
ترور	ترور
ترک	ترک
ترکمن	ترکمن
ترکیب	ترکیب
ترکیه	ترکیه
تزئینات	تزئینات
تزار	تزار
تست	تست
تسلط	تسلط
تسلیم	تسلیم
تشخیص	تشخیص
تشنج	تشنج
تشویق	تشویق
تشکیل	تشکیل
تشییع	تشییع
تصاحب	تصاحب
تصرف	تصرف
تصمیم	تصمیم
تصویب	تصویب
تصویر	تصویر
تظاهرات	تظاهرات
تعداد	تعداد
تعریف	تعریف
تعزیه	تعزیه
تعطیل	تعطیل
تعلق	تعلق
تعلیم	تعلیم
تعمیر	تعمیر
تعیین	تعیین
تغییر	تغییر
تغییرات	تغییرات
تفاوت	تفاوت
تفت	تفت
تفرش	تفرش
تفسیر	تفسیر
تفکر	تفکر
تفکرات	تفکرات
تقاضا	تقاضا
تقدیر	تقدیر
تقریبا	تقریبا
تقریباً	تقریباً
تقسیم	تقسیم
تقسیمات	تقسیمات
تقلید	تقلید
تقویت	تقویت
تقویم	تقویم
تقی	تقی
تل	تل
تلاش	تلاش
تلخ	تلخ
تلفات	تلفات
تلفظ	تلفظ
تلفن	تلفن
تله	تله
تلویزیون	تلویزیون
تلگراف	تلگراف
تماس	تماس
تماشا	تماشا
تماشاخانه	تماشاخانه
تماشاگه	تماشاگه
تمام	تمام
تمدن	تمدن
تمرکز	تمرکز
تن	تن
تنبک	تنبک
تنظیم	تنظیم
تنه	تنه
تنها	تنها
تنوع	تنوع
تنکابن	تنکابن
تنگ	تنگ
تنگه	تنگه
ته	ته
تهاجم	تهاجم
تهدید	تهدید
تهران	تهران
تهیه	تهیه
تو	تو
توابع	توابع
توافق	توافق
توان	توان
توت	توت
توتون	توتون
توجه	توجه
توحید	توحید
تور	تور
توران	توران
توره	توره
توزیع	توزیع
توس	توس
توسط	توسط
توسعه	توسعه
توسکا	توسکا
توفیق	توفیق
توقف	توقف
تولد	تولد
تولید	تولید
توماس	توماس
تومان	تومان
تونی	تونی
توکلی	توکلی
تَه	ته
تِه	ته
تپه	تپه
تک	تک
تکاب	تکاب
تکثیر	تکثیر
تکنولوژی	تکنولوژی
تکیه	تکیه
تگزاس	تگزاس
تی	تی
تیر	تیر
تیره	تیره
تیز	تیز
تیغ	تیغ
تیلور	تیلور
تیم	تیم
تیمور	تیمور
تیمَ	تیم
ثابت	ثابت
ثانیه	ثانیه
ثبت	ثبت
ثروت	ثروت
ثروتمند	ثروتمند
ثریا	ثریا
جا	جا
جابجا	جابجا
جاده	جاده
جاذبه	جاذبه
جار	جار
جاسم	جاسم
جالب	جالب
جام	جام
جامع	جامع
جامعه	جامعه
جان	جان
جانب	جانب
جاندار	جاندار
جانسون	جانسون
جانشین	جانشین
جانور	جانور
جایزه	جایزه
جایگاه	جایگاه
جایگزین	جایگزین
جبال	جبال
جبهه	جبهه
جدول	جدول
جدی	جدی
جدید	جدید
جذب	جذب
جرم	جرم
جرگه	جرگه
جرگهٰ	جرگه
جریان	جریان
جریب	جریب
جز	جز
جزء	جزء
جزایر	جزایر
جزو	جزو
جزیره	جزیره
جسد	جسد
جسم	جسم
جشن	جشن
جشنواره	جشنواره
جعفر	جعفر
جعفری	جعفری
جغرافیایی	جغرافیایی
جفت	جفت
جلال	جلال
جلب	جلب
جلد	جلد
جلسه	جلسه
جلفا	جلفا
جلو	جلو
جلوه	جلوه
جلوگیری	جلوگیری
جلگه	جلگه
جم	جم
جمال	جمال
جمشید	جمشید
جمع	جمع
جمعا	جمعا
جمعه	جمعه
جمعی	جمعی
جمعیت	جمعیت
جمعیتی	جمعیتی
جمله	جمله
جمهوری	جمهوری
جناح	جناح
جنازه	جنازه
جنایت	جنایت
جنبش	جنبش
جنت	جنت
جنتی	جنتی
جنجال	جنجال
جنس	جنس
جنوب	جنوب
جنوبی	جنوبی
جنگ	جنگ
جنگجو	جنگجو
جنگل	جنگل
جنگی	جنگی
جهان	جهان
جهانشاه	جهانشاه
جهانی	جهانی
جهت	جهت
جهرم	جهرم
جو	جو
جواد	جواد
جوار	جوار
جوان	جوان
جوانان	جوانان
جوانه	جوانه
جوانی	جوانی
جواهرات	جواهرات
جور	جور
جوش	جوش
جولای	جولای
جویبار	جویبار
جک	جک
جی	جی
جیر	جیر
جیرفت	جیرفت
جیمز	جیمز
حاج	حاج
حاجی	حاجی
حادثه	حادثه
حاشیه	حاشیه
حاصل	حاصل
حاصلخیز	حاصلخیز
حاضر	حاضر
حافظ	حافظ
حافظه	حافظه
حال	حال
حالت	حالت
حامد	حامد
حاوی	حاوی
حاکم	حاکم
حاکمه	حاکمه
حبس	حبس
حبوبات	حبوبات
حبیب	حبیب
حتا	حتا
حتما	حتما
حتی	حتی
حجم	حجم
حد	حد
حدود	حدود
حرف	حرف
حرفه	حرفه
حرکت	حرکت
حزب	حزب
حزین	حزین
حس	حس
حساب	حساب
حسابی	حسابی
حسب	حسب
حسن	حسن
حسنه	حسنه
حسنی	حسنی
حسین	حسین
حسینی	حسینی
حشر	حشر
حشره	حشره
حشمت	حشمت
حصار	حصار
حصیر	حصیر
حضرت	حضرت
حضور	حضور
حفاظت	حفاظت
حفظ	حفظ
حق	حق
حقه	حقه
حقوق	حقوق
حقوقی	حقوقی
حقیقت	حقیقت
حل	حل
حلاج	حلاج
حلقه	حلقه
حماسه	حماسه
حماسی	حماسی
حمام	حمام
حمایت	حمایت
حمزه	حمزه
حمل	حمل
حمله	حمله
حمید	حمید
حمیدی	حمیدی
حوادث	حوادث
حوزه	حوزه
حوض	حوض
حومه	حومه
حکومت	حکومت
حکیم	حکیم
حیات	حیات
حیاط	حیاط
حیدر	حیدر
حیدری	حیدری
حیران	حیران
حیوان	حیوان
خاتم	خاتم
خاتمه	خاتمه
خاتون	خاتون
خارج	خارج
خارجه	خارجه
خارجی	خارجی
خاست	خاست
خاستن	خاستن
خاستی	خاستی
خاستید	خاستید
خاش	خاش
خاص	خاص
خاصه	خاصه
خاصیت	خاصیت
خاطر	خاطر
خاطرات	خاطرات
خال	خال
خاله	خاله
خالی	خالی
خام	خام
خان	خان
خاندان	خاندان
خانم	خانم
خانه	خانه
خانواده	خانواده
خانوادگی	خانوادگی
خانوار	خانوار
خانگی	خانگی
خانی	خانی
خاوران	خاوران
خاوری	خاوری
خاک	خاک
خاکه	خاکه
خاکی	خاکی
خب	خب
خبر	خبر
خدا	خدا
خدمات	خدمات
خدمت	خدمت
خر	خر
خرابکاری	خرابکاری
خراسان	خراسان
خربزه	خربزه
خرج	خرج
خرداد	خرداد
خرف	خرف
خرم	خرم
خرما	خرما
خرمشهر	خرمشهر
خرید	خرید
خزانه	خزانه
خزر	خزر
خسته	خسته
خسرو	خسرو
خشت	خشت
خشن	خشن
خشونت	خشونت
خشک	خشک
خصوص	خصوص
خصوصی	خصوصی
خط	خط
خطا	خطا
خطبه	خطبه
خطر	خطر
خطی	خطی
خلاصه	خلاصه
خلاف	خلاف
خلافت	خلافت
خلج	خلج
خلخال	خلخال
خلق	خلق
خلیج	خلیج
خلیفه	خلیفه
خلیل	خلیل
خمین	خمین
خمینی	خمینی
خنده	خنده
خنک	خنک
خو	خو
خواب	خواب
خواجه	خواجه
خواستی	خواستی
خواص	خواص
خوان	خوان
خواندن	خواندن
خوانده	خوانده
خواندی	خواندی
خواننده	خواننده
خوانندگان	خوانندگان
خوانندگی	خوانندگی
خواه	خواه
خواهان	خواهان
خواهد	خواهد
خواهر	خواهر
خوب	خوب
خوبی	خوبی
خود	خود
خودرو	خودرو
خودش	خودش
خودشان	خودشان
خودکار	خودکار
خودکشی	خودکشی
خور	خور
خوراک	خوراک
خورد	خورد
خوردن	خوردن
خورده	خورده
خورشید	خورشید
خورشیدی	خورشیدی
خوره	خوره
خوزستان	خوزستان
خوزه	خوزه
خوش	خوش
خوشه	خوشه
خون	خون
خوک	خوک
خوی	خوی
خویش	خویش
خیابان	خیابان
خیار	خیار
خیال	خیال
خیام	خیام
خیل	خیل
خیلی	خیلی
داخل	داخل
داخلی	داخلی
داد	داد
داده	داده
دادگاه	دادگاه
دار	دار
دارا	دارا
داراب	داراب
دارای	دارای
دارد	دارد
دارستان	دارستان
دارم	دارم
دارن	دارن
دارکوب	دارکوب
داری	داری
دارید	دارید
داریوش	داریوش
داستان	داستان
داشت	داشت
داشتن	داشتن
داشته	داشته
داشتی	داشتی
داعش	داعش
داعی	داعی
داغ	داغ
دال	دال
دام	دام
داماش	داماش
دامان	دامان
دامداری	دامداری
دامغان	دامغان
دامنه	دامنه
دان	دان
دانا	دانا
دانستن	دانستن
دانش	دانش
دانشجو	دانشجو
دانشجویان	دانشجویان
دانشجویی	دانشجویی
دانشمند	دانشمند
دانشمندان	دانشمندان
دانشنامه	دانشنامه
دانشکده	دانشکده
دانشگاه	دانشگاه
دانمارک	دانمارک
دانه	دانه
داوطلب	داوطلب
داوود	داوود
دایی	دایی
دبستان	دبستان
دبیر	دبیر
دبیرستان	دبیرستان
دخالت	دخالت
دختر	دختر
در	در
درآمد	درآمد
دراز	دراز
درازا	درازا
درازی	درازی
درام	درام
دربار	دربار
درباره	درباره
دربند	دربند
درجه	درجه
درخت	درخت
درختی	درختی
درخشان	درخشان
درخواست	درخواست
درد	درد
درزی	درزی
درس	درس
درست	درست
درصد	درصد
درم	درم
درمان	درمان
درمانی	درمانی
دره	دره
دروازه	دروازه
درواقع	درواقع
درون	درون
درویش	درویش
درک	درک
درگاه	درگاه
درگذشت	درگذشت
درگیری	درگیری
دری	دری
دریا	دریا
دریافت	دریافت
دریاچه	دریاچه
دریایی	دریایی
درید	درید
دریدی	دریدی
دزفول	دزفول
دسامبر	دسامبر
دست	دست
دستان	دستان
دستاورد	دستاورد
دسترسی	دسترسی
دسته	دسته
دستور	دستور
دستگاه	دستگاه
دستگیر	دستگیر
دستی	دستی
دشت	دشت
دشتی	دشتی
دشمن	دشمن
دعائی	دعائی
دعایی	دعایی
دعوت	دعوت
دفاع	دفاع
دفتر	دفتر
دفن	دفن
دقت	دقت
دقیق	دقیق
دقیقه	دقیقه
دل	دل
دلار	دلار
دلایل	دلایل
دله	دله
دلیجان	دلیجان
دلیل	دلیل
دم	دم
دما	دما
دماوند	دماوند
دموکرات	دموکرات
دموکراتیک	دموکراتیک
دموکراسی	دموکراسی
دنا	دنا
دنبال	دنبال
دندان	دندان
دنده	دنده
دنیا	دنیا
ده	ده
دهان	دهان
دهانه	دهانه
دهخدا	دهخدا
دهد	دهد
دهستان	دهستان
دهلران	دهلران
دهم	دهم
دهن	دهن
دهنده	دهنده
دهنه	دهنه
دهه	دهه
دههٔ	دهه
دهکده	دهکده
دو	دو
دواب	دواب
دوار	دوار
دوازده	دوازده
دوازدهم	دوازدهم
دوام	دوام
دوباره	دوباره
دود	دود
دوده	دوده
دور	دور
دوران	دوران
دوره	دوره
دوزی	دوزی
دوست	دوست
دوشاب	دوشاب
دوشنبه	دوشنبه
دولاب	دولاب
دولت	دولت
دوم	دوم
دومین	دومین
دومینیکن	دومینیکن
دون	دون
دَره	دره
دَشتی	دشتی
دِه	ده
دچار	دچار
دژ	دژ
دکتر	دکتر
دی	دی
دید	دید
دیدار	دیدار
دیدن	دیدن
دیدنی	دیدنی
دیده	دیده
دیر	دیر
دیسک	دیسک
دیلم	دیلم
دیلمان	دیلمان
دیلمی	دیلمی
دیم	دیم
دیمه	دیمه
دین	دین
دینی	دینی
دیوار	دیوار
دیوان	دیوان
دیپلم	دیپلم
دیپلمه	دیپلمه
دیگر	دیگر
دیگران	دیگران
دیگری	دیگری
دیگه	دیگه
ذخیره	ذخیره
ذره	ذره
ذهن	ذهن
ذوق	ذوق
ذکر	ذکر
رئیس	رئیس
را	را
راب	راب
رابرت	رابرت
رابطه	رابطه
راجع	راجع
راحت	راحت
راد	راد
رادی	رادی
رادیو	رادیو
رادیکال	رادیکال
راز	راز
رازی	رازی
راس	راس
راست	راست
راسته	راسته
راش	راش
راضی	راضی
رامسر	رامسر
راننده	راننده
راه	راه
راهنمایی	راهنمایی
راهی	راهی
راک	راک
راکتور	راکتور
رای	رای
رایانه	رایانه
رایج	رایج
رایگان	رایگان
رباط	رباط
ربط	ربط
رتبه	رتبه
رج	رج
رجایی	رجایی
رجه	رجه
رحمت	رحمت
رحیم	رحیم
رخ	رخ
رخت	رخت
رد	رد
ردا	ردا
رده	رده
ردیف	ردیف
رز	رز
رزن	رزن
رساله	رساله
رسانه	رسانه
رسانی	رسانی
رستم	رستم
رسم	رسم
رسما	رسما
رسماً	رسماً
رسوایی	رسوایی
رسول	رسول
رسوم	رسوم
رسید	رسید
رسیدگی	رسیدگی
رشت	رشت
رشته	رشته
رشتِ	رشت
رشتی	رشتی
رشد	رشد
رشوه	رشوه
رضا	رضا
رضاخان	رضاخان
رضاشاه	رضاشاه
رضایی	رضایی
رضوانشهر	رضوانشهر
رضوی	رضوی
رضی	رضی
رعایت	رعایت
رفاه	رفاه
رفت	رفت
رفتار	رفتار
رفسنجان	رفسنجان
رفع	رفع
رفیع	رفیع
رقابت	رقابت
رمضان	رمضان
رمضانعلی	رمضانعلی
رمضانی	رمضانی
رنج	رنج
رنگ	رنگ
ره	ره
رها	رها
رهبر	رهبر
رهبری	رهبری
رو	رو
روابط	روابط
رواج	رواج
روان	روان
روانشناسی	روانشناسی
روانه	روانه
روایت	روایت
روبرو	روبرو
روح	روح
روحانی	روحانی
رود	رود
رودبار	رودبار
رودخانه	رودخانه
رودسر	رودسر
روده	روده
روز	روز
روزانه	روزانه
روزنامه	روزنامه
روزه	روزه
روزی	روزی
روس	روس
روستا	روستا
روستایی	روستایی
روسی	روسی
روسیه	روسیه
روش	روش
روشن	روشن
روغن	روغن
روم	روم
رومی	رومی
روند	روند
رونق	رونق
روی	روی
رویان	رویان
رپ	رپ
رژیم	رژیم
رکاب	رکاب
رکن	رکن
رکود	رکود
ری	ری
ریاست	ریاست
ریاضی	ریاضی
ریز	ریز
ریزه	ریزه
ریزی	ریزی
ریشه	ریشه
ریه	ریه
ریواس	ریواس
ریچموند	ریچموند
زاد	زاد
زاده	زاده
زادگاه	زادگاه
زار	زار
زارع	زارع
زارم	زارم
زال	زال
زاهد	زاهد
زاهدان	زاهدان
زاک	زاک
زاکه	زاکه
زبان	زبان
زبون	زبون
زخم	زخم
زخمی	زخمی
زرد	زرد
زره	زره
زرین	زرین
زلزله	زلزله
زمان	زمان
زمانی	زمانی
زمزمه	زمزمه
زمستان	زمستان
زمین	زمین
زمینه	زمینه
زمینی	زمینی
زن	زن
زنان	زنان
زنانه	زنانه
زنجان	زنجان
زند	زند
زندان	زندان
زنده	زنده
زندگی	زندگی
زنگ	زنگ
زنگی	زنگی
زنی	زنی
زنید	زنید
زهرا	زهرا
زود	زود
زور	زور
زیاد	زیاد
زیاده	زیاده
زیادی	زیادی
زیارت	زیارت
زیبا	زیبا
زیباکنار	زیباکنار
زیبایی	زیبایی
زیر	زیر
زیرنظر	زیرنظر
زیست	زیست
زین	زین
سابق	سابق
سابقه	سابقه
ساحل	ساحل
ساخت	ساخت
ساختار	ساختار
ساختمان	ساختمان
ساخته	ساخته
سادات	سادات
ساده	ساده
سارا	سارا
سارتر	سارتر
ساری	ساری
ساز	ساز
سازمان	سازمان
سازه	سازه
سازی	سازی
ساسان	ساسان
ساسانی	ساسانی
ساسانیان	ساسانیان
ساعت	ساعت
ساعته	ساعته
ساعی	ساعی
ساقه	ساقه
سال	سال
سالار	سالار
سالانه	سالانه
سالم	سالم
ساله	ساله
سالِ	سال
سالگی	سالگی
سامان	سامان
سامانه	سامانه
سامانیان	سامانیان
سامورایی	سامورایی
سامی	سامی
سان	سان
سانتیمتر	سانتیمتر
ساواک	ساواک
ساوجبلاغ	ساوجبلاغ
ساوه	ساوه
ساکن	ساکن
ساکنان	ساکنان
ساکنین	ساکنین
سایت	سایت
سایر	سایر
سایه	سایه
سایپا	سایپا
سبب	سبب
سبز	سبز
سبزه	سبزه
سبزوار	سبزوار
سبزی	سبزی
سبک	سبک
ستاره	ستاره
ستم	ستم
ستوان	ستوان
ستون	ستون
سخت	سخت
سختی	سختی
سد	سد
سده	سده
سر	سر
سرا	سرا
سراب	سراب
سراسر	سراسر
سراسری	سراسری
سرانجام	سرانجام
سرایی	سرایی
سرباز	سرباز
سربازان	سربازان
سرتیپ	سرتیپ
سرجمع	سرجمع
سرخ	سرخ
سرد	سرد
سردار	سردار
سردبیر	سردبیر
سردشت	سردشت
سرده	سرده
سرزمین	سرزمین
سرسبز	سرسبز
سرشت	سرشت
سرشماری	سرشماری
سرشناس	سرشناس
سرطان	سرطان
سرعت	سرعت
سرما	سرما
سرمایه	سرمایه
سرنا	سرنا
سرنوشت	سرنوشت
سره	سره
سرو	سرو
سرور	سرور
سرویس	سرویس
سرپا	سرپا
سرپرست	سرپرست
سرپرستی	سرپرستی
سرچشمه	سرچشمه
سرک	سرک
سرکرده	سرکرده
سرکوب	سرکوب
سری	سری
سریال	سریال
سریر	سریر
سریع	سریع
سطح	سطح
سعادت	سعادت
سعدآباد	سعدآباد
سعدی	سعدی
سعی	سعی
سعید	سعید
سفارت	سفارت
سفارش	سفارش
سفال	سفال
سفر	سفر
سفرنامه	سفرنامه
سفره	سفره
سفلی	سفلی
سفید	سفید
سفیدرود	سفیدرود
سقز	سقز
سقف	سقف
سقوط	سقوط
سل	سل
سلاح	سلاح
سلام	سلام
سلامت	سلامت
سلجوقی	سلجوقی
سلسله	سلسله
سلطان	سلطان
سلطنت	سلطنت
سلطه	سلطه
سلماس	سلماس
سله	سله
سلوکی	سلوکی
سلیم	سلیم
سلیمان	سلیمان
سمت	سمت
سمنان	سمنان
سمند	سمند
سمیرم	سمیرم
سمیعی	سمیعی
سن	سن
سنا	سنا
سنت	سنت
سنتور	سنتور
سنجد	سنجد
سند	سند
سنقر	سنقر
سنندج	سنندج
سنگ	سنگ
سنگر	سنگر
سنگلج	سنگلج
سنگین	سنگین
سه	سه
سهامی	سهامی
سهراب	سهراب
سهم	سهم
سو	سو
سوئد	سوئد
سوئدی	سوئدی
سواحل	سواحل
سواد	سواد
سوادکوه	سوادکوه
سوار	سوار
سواره	سواره
سوخته	سوخته
سوریه	سوریه
سوسن	سوسن
سوسیال	سوسیال
سوسیالیستی	سوسیالیستی
سوفال	سوفال
سوم	سوم
سومین	سومین
سوی	سوی
سویا	سویا
سِد	سد
سپاه	سپاه
سپاهان	سپاهان
سپتامبر	سپتامبر
سپر	سپر
سپرده	سپرده
سپری	سپری
سپس	سپس
سپه	سپه
سپهبد	سپهبد
سپهدار	سپهدار
سپهسالار	سپهسالار
سپید	سپید
سپیدرود	سپیدرود
سک	سک
سکته	سکته
سکنه	سکنه
سکه	سکه
سکونت	سکونت
سگ	سگ
سی	سی
سیا	سیا
سیاره	سیاره
سیاست	سیاست
سیاسی	سیاسی
سیاه	سیاه
سیاهان	سیاهان
سیاهکل	سیاهکل
سیب	سیب
سیبری	سیبری
سید	سید
سیر	سیر
سیروس	سیروس
سیزده	سیزده
سیزدهم	سیزدهم
سیستان	سیستان
سیستم	سیستم
سیصد	سیصد
سیم	سیم
سیما	سیما
سینا	سینا
سینما	سینما
سینمایی	سینمایی
سینه	سینه
سینی	سینی
شاخ	شاخ
شاخص	شاخص
شاخه	شاخه
شاد	شاد
شادمهر	شادمهر
شادی	شادی
شازند	شازند
شاعر	شاعر
شاعران	شاعران
شاعری	شاعری
شاق	شاق
شال	شال
شام	شام
شامل	شامل
شانزده	شانزده
شانزدهم	شانزدهم
شاه	شاه
شاهان	شاهان
شاهد	شاهد
شاهرخ	شاهرخ
شاهرود	شاهرود
شاهزاده	شاهزاده
شاهنامه	شاهنامه
شاهی	شاهی
شاهین	شاهین
شاپور	شاپور
شاگرد	شاگرد
شاگردان	شاگردان
شاید	شاید
شایسته	شایسته
شب	شب
شبان	شبان
شبانه	شبانه
شباهت	شباهت
شبستر	شبستر
شبه	شبه
شبکه	شبکه
شبیه	شبیه
شتاب	شتاب
شخ	شخ
شخص	شخص
شخصی	شخصی
شخصیت	شخصیت
شد	شد
شدت	شدت
شدن	شدن
شده	شده
شدید	شدید
شر	شر
شراب	شراب
شرایط	شرایط
شربت	شربت
شرح	شرح
شرق	شرق
شرقی	شرقی
شرمن	شرمن
شروان	شروان
شروع	شروع
شرکت	شرکت
شریر	شریر
شریعتمدار	شریعتمدار
شریعتی	شریعتی
شریف	شریف
شش	شش
ششم	ششم
شصت	شصت
شعبان	شعبان
شعبه	شعبه
شعر	شعر
شغل	شغل
شفیع	شفیع
شما	شما
شمار	شمار
شماره	شماره
شماری	شماری
شمال	شمال
شمالی	شمالی
شمس	شمس
شمسی	شمسی
شمشیر	شمشیر
شمشیری	شمشیری
شمع	شمع
شمه	شمه
شنا	شنا
شناخت	شناخت
شناختن	شناختن
شناخته	شناخته
شناس	شناس
شناسی	شناسی
شنبه	شنبه
شه	شه
شهاب	شهاب
شهادت	شهادت
شهدی	شهدی
شهر	شهر
شهرام	شهرام
شهران	شهران
شهرت	شهرت
شهرداری	شهرداری
شهرسازی	شهرسازی
شهرستان	شهرستان
شهره	شهره
شهروند	شهروند
شهروندی	شهروندی
شهرک	شهرک
شهرکرد	شهرکرد
شهری	شهری
شهریار	شهریار
شهریور	شهریور
شهید	شهید
شهیدان	شهیدان
شو	شو
شواهد	شواهد
شود	شود
شور	شور
شوراب	شوراب
شورش	شورش
شورشیان	شورشیان
شوروی	شوروی
شوش	شوش
شوی	شوی
شویی	شویی
شکار	شکار
شکر	شکر
شکست	شکست
شکل	شکل
شکم	شکم
شکنجه	شکنجه
شگون	شگون
شی	شی
شیخ	شیخ
شیر	شیر
شیراز	شیراز
شیرازی	شیرازی
شیروان	شیروان
شیرین	شیرین
شیرینی	شیرینی
شیشه	شیشه
شیطان	شیطان
شیعه	شیعه
شیمی	شیمی
شین	شین
شیون	شیون
شیکاگو	شیکاگو
صابری	صابری
صاحب	صاحب
صاحبقرانیه	صاحبقرانیه
صادر	صادر
صادرات	صادرات
صادق	صادق
صاف	صاف
صالح	صالح
صبا	صبا
صبح	صبح
صبر	صبر
صحبت	صحبت
صحرا	صحرا
صحنه	صحنه
صد	صد
صدا	صدا
صدر	صدر
صدها	صدها
صغیر	صغیر
صفا	صفا
صفت	صفت
صفحه	صفحه
صفر	صفر
صفوی	صفوی
صفویه	صفویه
صفی	صفی
صلاح	صلاح
صلح	صلح
صمد	صمد
صنایع	صنایع
صندلی	صندلی
صنعت	صنعت
صنعتی	صنعتی
صورت	صورت
صوفی	صوفی
صومعه	صومعه
صیقل	صیقل
ضبط	ضبط
ضد	ضد
ضرب	ضرب
ضربه	ضربه
ضعف	ضعف
ضلع	ضلع
ضمن	ضمن
ضمیمه	ضمیمه
طارم	طارم
طاعون	طاعون
طاق	طاق
طالب	طالب
طالبی	طالبی
طالش	طالش
طالقان	طالقان
طالقانی	طالقانی
طاهر	طاهر
طاهری	طاهری
طایفه	طایفه
طب	طب
طبرستان	طبرستان
طبس	طبس
طبق	طبق
طبقه	طبقه
طبیعت	طبیعت
طبیعی	طبیعی
طراحی	طراحی
طرح	طرح
طرف	طرف
طرفدار	طرفدار
طریق	طریق
طعم	طعم
طغرل	طغرل
طلا	طلا
طلایی	طلایی
طلب	طلب
طنز	طنز
طهماسب	طهماسب
طور	طور
طوری	طوری
طول	طول
طولانی	طولانی
طی	طی
ظاهر	ظاهر
ظرف	ظرف
ظرفیت	ظرفیت
ظروف	ظروف
ظلم	ظلم
ظهر	ظهر
عادل	عادل
عادی	عادی
عارف	عارف
عاشق	عاشق
عاشقانه	عاشقانه
عالم	عالم
عالی	عالی
عامل	عامل
عامه	عامه
عبارت	عبارت
عباس	عباس
عباسی	عباسی
عبدالرزاق	عبدالرزاق
عبدالفتاح	عبدالفتاح
عبدالله	عبدالله
عبدالوهاب	عبدالوهاب
عبور	عبور
عثمانی	عثمانی
عجب	عجب
عدالت	عدالت
عدد	عدد
عدس	عدس
عدم	عدم
عده	عده
عذر	عذر
عراق	عراق
عرب	عرب
عربستان	عربستان
عربی	عربی
عرصه	عرصه
عرض	عرض
عرضه	عرضه
عروس	عروس
عروسی	عروسی
عزت	عزت
عزل	عزل
عزیز	عزیز
عسل	عسل
عشاق	عشاق
عشرت	عشرت
عشق	عشق
عصر	عصر
عضدالدوله	عضدالدوله
عضو	عضو
عضویت	عضویت
عطر	عطر
عظیمی	عظیمی
عقاب	عقاب
عقاید	عقاید
عقب	عقب
عقیده	عقیده
عقیلی	عقیلی
علاقمند	علاقمند
علاقه	علاقه
علامه	علامه
علاوه	علاوه
علت	علت
علم	علم
علمی	علمی
علوم	علوم
علویان	علویان
علی	علی
علیا	علیا
علیرضا	علیرضا
علیزاده	علیزاده
علیه	علیه
عمارت	عمارت
عمده	عمده
عمر	عمر
عمران	عمران
عمق	عمق
عمل	عمل
عملکرد	عملکرد
عملیات	عملیات
عمو	عمو
عموم	عموم
عمومی	عمومی
عنصر	عنصر
عنوان	عنوان
عهد	عهد
عهده	عهده
عوامل	عوامل
عوض	عوض
عکس	عکس
عین	عین
غار	غار
غارت	غارت
غاز	غاز
غالب	غالب
غذا	غذا
غذایی	غذایی
غرب	غرب
غربی	غربی
غریب	غریب
غزاله	غزاله
غزل	غزل
غضب	غضب
غلات	غلات
غلاف	غلاف
غلامحسین	غلامحسین
غلامرضا	غلامرضا
غلامی	غلامی
غلتک	غلتک
غم	غم
غمزه	غمزه
غنی	غنی
غیر	غیر
غیرانتفاعی	غیرانتفاعی
غیردولتی	غیردولتی
فاتح	فاتح
فاجعه	فاجعه
فاخته	فاخته
فاراب	فاراب
فارابی	فارابی
فارس	فارس
فارسان	فارسان
فارسی	فارسی
فارغ	فارغ
فاز	فاز
فاصله	فاصله
فاضله	فاضله
فاطمه	فاطمه
فاطمی	فاطمی
فاعل	فاعل
فامیل	فامیل
فانی	فانی
فایرفاکس	فایرفاکس
فایل	فایل
فتح	فتح
فتوحی	فتوحی
فدا	فدا
فدایی	فدایی
فدرال	فدرال
فرات	فرات
فرار	فرار
فرامرز	فرامرز
فرانسه	فرانسه
فرانسوی	فرانسوی
فرانسویان	فرانسویان
فرانسیسکو	فرانسیسکو
فرانک	فرانک
فراهم	فراهم
فراوان	فراوان
فراوانی	فراوانی
فرح	فرح
فرخ	فرخ
فرخی	فرخی
فرد	فرد
فردا	فردا
فردوس	فردوس
فردوسی	فردوسی
فرزند	فرزند
فرزندان	فرزندان
فرش	فرش
فرشته	فرشته
فرصت	فرصت
فرق	فرق
فرم	فرم
فرمان	فرمان
فرماندار	فرماندار
فرمانداری	فرمانداری
فرمانده	فرمانده
فرماندهی	فرماندهی
فرمانروایان	فرمانروایان
فرهاد	فرهاد
فرهنگ	فرهنگ
فرهنگسرا	فرهنگسرا
فرهنگی	فرهنگی
فروردین	فروردین
فروزانفر	فروزانفر
فروش	فروش
فریاد	فریاد
فریب	فریب
فرید	فرید
فریدون	فریدون
فریدونی	فریدونی
فریضه	فریضه
فریم	فریم
فساد	فساد
فستیوال	فستیوال
فسفر	فسفر
فشار	فشار
فشم	فشم
فصل	فصل
فضا	فضا
فضل	فضل
فعال	فعال
فعالیت	فعالیت
فعل	فعل
فعلی	فعلی
فقر	فقر
فقط	فقط
فلات	فلات
فلاح	فلاح
فلز	فلز
فلزات	فلزات
فلسطین	فلسطین
فلسفه	فلسفه
فلفل	فلفل
فلوت	فلوت
فندق	فندق
فنلاند	فنلاند
فنلاندی	فنلاندی
فهرست	فهرست
فهیمه	فهیمه
فوت	فوت
فوتبال	فوتبال
فوریه	فوریه
فوریهٔ	فوریه
فوق	فوق
فولاد	فولاد
فولکلور	فولکلور
فومن	فومن
فومنی	فومنی
فَدا	فدا
فکر	فکر
فی	فی
فیات	فیات
فیروز	فیروز
فیروزکوه	فیروزکوه
فیزیک	فیزیک
فیش	فیش
فیلم	فیلم
فیلمنامه	فیلمنامه
قائل	قائل
قائم	قائم
قابل	قابل
قاجار	قاجار
قاجاریه	قاجاریه
قادر	قادر
قاره	قاره
قاسم	قاسم
قاسمی	قاسمی
قاضی	قاضی
قاضیان	قاضیان
قاطر	قاطر
قالب	قالب
قالی	قالی
قانع	قانع
قانون	قانون
قانونی	قانونی
قایقران	قایقران
قایم	قایم
قبر	قبر
قبرستان	قبرستان
قبل	قبل
قبلا	قبلا
قبلاً	قبلاً
قبلی	قبلی
قبول	قبول
قبیل	قبیل
قتل	قتل
قد	قد
قدر	قدر
قدرت	قدرت
قدس	قدس
قدم	قدم
قدمت	قدمت
قدیم	قدیم
قدیمی	قدیمی
قرآن	قرآن
قرائت	قرائت
قرار	قرار
قرارداد	قرارداد
قران	قران
قربان	قربان
قربانی	قربانی
قرق	قرق
قرمز	قرمز
قرن	قرن
قره	قره
قرون	قرون
قروه	قروه
قرچک	قرچک
قزوین	قزوین
قسم	قسم
قسمت	قسمت
قشلاق	قشلاق
قشم	قشم
قشنگ	قشنگ
قصاب	قصاب
قصد	قصد
قصر	قصر
قصه	قصه
قطار	قطار
قطب	قطب
قطر	قطر
قطره	قطره
قطع	قطع
قطعات	قطعات
قطعه	قطعه
قفس	قفس
قفسه	قفسه
قفقاز	قفقاز
قلب	قلب
قلعه	قلعه
قلم	قلم
قلمرو	قلمرو
قله	قله
قم	قم
قمر	قمر
قمری	قمری
قند	قند
قندی	قندی
قه	قه
قهرمان	قهرمان
قهرمانی	قهرمانی
قهقهه	قهقهه
قوامی	قوامی
قوانین	قوانین
قوت	قوت
قول	قول
قوم	قوم
قوه	قوه
قوی	قوی
قیام	قیام
قیامه	قیامه
قیمت	قیمت
لا	لا
لات	لات
لاتین	لاتین
لار	لار
لازم	لازم
لازمه	لازمه
لالا	لالا
لاله	لاله
لام	لام
لانه	لانه
لاهیجان	لاهیجان
لاهیجی	لاهیجی
لاک	لاک
لاکو	لاکو
لب	لب
لباس	لباس
لته	لته
لحاظ	لحاظ
لحظه	لحظه
لذت	لذت
لر	لر
لرزه	لرزه
لرستان	لرستان
لشکر	لشکر
لغت	لغت
لغو	لغو
لفظ	لفظ
لقب	لقب
لله	لله
لم	لم
لندن	لندن
لنکران	لنکران
لنگر	لنگر
لنگرود	لنگرود
لنگرودی	لنگرودی
لنگه	لنگه
لهجه	لهجه
لهستان	لهستان
لوازم	لوازم
لواسان	لواسان
لوبیا	لوبیا
لوشان	لوشان
لوله	لوله
لویزان	لویزان
لپه	لپه
لکه	لکه
لی	لی
لیبرال	لیبرال
لیسانس	لیسانس
لیل	لیل
لیلا	لیلا
لیگ	لیگ
مؤسسه	مؤسسه
ما	ما
ماجرا	ماجرا
ماد	ماد
مادر	مادر
مادرید	مادرید
ماده	ماده
مار	مار
مارس	مارس
مارلیک	مارلیک
مارچ	مارچ
مارکس	مارکس
ماری	ماری
مازندران	مازندران
مازندرانی	مازندرانی
مازیار	مازیار
ماسال	ماسال
ماسوله	ماسوله
ماسک	ماسک
ماشین	ماشین
مال	مال
ماله	ماله
مالک	مالک
مالکیت	مالکیت
مالی	مالی
مالیات	مالیات
ماندگار	ماندگار
مانستن	مانستن
مانع	مانع
مانند	مانند
مانه	مانه
ماه	ماه
ماهان	ماهان
ماهدشت	ماهدشت
ماهشهر	ماهشهر
ماهه	ماهه
ماهی	ماهی
ماهیگیری	ماهیگیری
ماکان	ماکان
ماکو	ماکو
مایل	مایل
مایه	مایه
مایکل	مایکل
مبارزه	مبارزه
مبارک	مبارک
مبدأ	مبدأ
متال	متال
متحد	متحد
متحده	متحده
متحرک	متحرک
متخلص	متخلص
متر	متر
مترمربع	مترمربع
متصل	متصل
متعدد	متعدد
متعصب	متعصب
متعلق	متعلق
متفاوت	متفاوت
متمم	متمم
متن	متن
متنوع	متنوع
متهم	متهم
متوجه	متوجه
متوسط	متوسط
متوسطه	متوسطه
متوقف	متوقف
متولد	متولد
مثال	مثال
مثبت	مثبت
مثل	مثل
مثلا	مثلا
مثلاً	مثلاً
مثله	مثله
مجانی	مجانی
مجاورت	مجاورت
مجبور	مجبور
مجتبی	مجتبی
مجتمع	مجتمع
مجتهد	مجتهد
مجلات	مجلات
مجلس	مجلس
مجله	مجله
مجموعه	مجموعه
مجوز	مجوز
مجید	مجید
محاصره	محاصره
محافظت	محافظت
محافظه	محافظه
محاکمه	محاکمه
محبت	محبت
محبوب	محبوب
محبوبیت	محبوبیت
محتشم	محتشم
محتوا	محتوا
محجوبی	محجوبی
محدود	محدود
محدوده	محدوده
محراب	محراب
محرم	محرم
محرمانه	محرمانه
محروم	محروم
محسن	محسن
محسوب	محسوب
محصول	محصول
محصولات	محصولات
محقق	محقق
محل	محل
محلات	محلات
محله	محله
محلی	محلی
محمد	محمد
محمدرضا	محمدرضا
محمدی	محمدی
محمدیه	محمدیه
محمود	محمود
محمودآباد	محمودآباد
محور	محور
محوطه	محوطه
محکوم	محکوم
محیط	محیط
مخابرات	مخابرات
مخالفت	مخالفت
مختصات	مختصات
مختلف	مختلف
مخدر	مخدر
مخصوص	مخصوص
مخصوصا	مخصوصا
مخفف	مخفف
مخمصه	مخمصه
مدار	مدار
مدارس	مدارس
مدارک	مدارک
مدال	مدال
مدت	مدت
مدرس	مدرس
مدرسه	مدرسه
مدرسهٔ	مدرسه
مدرن	مدرن
مدرک	مدرک
مدل	مدل
مدیر	مدیر
مدیره	مدیره
مدیریت	مدیریت
مذهب	مذهب
مذهبی	مذهبی
مرا	مرا
مراتب	مراتب
مراجعه	مراجعه
مراحل	مراحل
مراد	مراد
مراسم	مراسم
مراغه	مراغه
مراکز	مراکز
مربا	مربا
مربع	مربع
مربوط	مربوط
مربیگری	مربیگری
مرتبط	مرتبط
مرتضی	مرتضی
مرجان	مرجان
مرجع	مرجع
مرحله	مرحله
مرحوم	مرحوم
مرد	مرد
مرداب	مرداب
مرداد	مرداد
مردان	مردان
مرداک	مرداک
مردم	مردم
مردن	مردن
مردی	مردی
مرز	مرز
مرس	مرس
مرطوب	مرطوب
مرعشی	مرعشی
مرغ	مرغ
مرغانه	مرغانه
مرقد	مرقد
مرمت	مرمت
مرمر	مرمر
مرند	مرند
مره	مره
مرکبات	مرکبات
مرکز	مرکز
مرکزگرایی	مرکزگرایی
مرکزی	مرکزی
مرگ	مرگ
مریم	مریم
مزار	مزار
مزارع	مزارع
مس	مس
مسئله	مسئله
مسئول	مسئول
مسئولان	مسئولان
مسئولیت	مسئولیت
مسئولین	مسئولین
مسائل	مسائل
مسابقات	مسابقات
مسابقه	مسابقه
مساحت	مساحت
مسافر	مسافر
مسافرت	مسافرت
مستعمره	مستعمره
مستقر	مستقر
مستقل	مستقل
مستقیم	مستقیم
مستند	مستند
مستوفی	مستوفی
مسجد	مسجد
مسعود	مسعود
مسعودی	مسعودی
مسلح	مسلح
مسلحانه	مسلحانه
مسلمانان	مسلمانان
مسکن	مسکن
مسکونی	مسکونی
مسیح	مسیح
مسیحی	مسیحی
مسیحیت	مسیحیت
مسیر	مسیر
مشابه	مشابه
مشاغل	مشاغل
مشاهیر	مشاهیر
مشاور	مشاور
مشاوره	مشاوره
مشترک	مشترک
مشخص	مشخص
مشخصات	مشخصات
مشرق	مشرق
مشروطه	مشروطه
مشغول	مشغول
مشهد	مشهد
مشهور	مشهور
مشکل	مشکل
مشکلات	مشکلات
مشکین	مشکین
مصادره	مصادره
مصادف	مصادف
مصالح	مصالح
مصدر	مصدر
مصدق	مصدق
مصر	مصر
مصرف	مصرف
مصطفی	مصطفی
مصلی	مصلی
مصنوعی	مصنوعی
مصوبه	مصوبه
مطابق	مطابق
مطالب	مطالب
مطالعات	مطالعات
مطالعه	مطالعه
مطبوعات	مطبوعات
مطرح	مطرح
مطلب	مطلب
مطهری	مطهری
مطیعی	مطیعی
مظفر	مظفر
مظفری	مظفری
معادل	معادل
معارف	معارف
معاش	معاش
معاصر	معاصر
معاف	معاف
معاون	معاون
معاونت	معاونت
معبد	معبد
معتبر	معتبر
معتدل	معتدل
معتقد	معتقد
معدن	معدن
معدنی	معدنی
معده	معده
معرب	معرب
معرض	معرض
معرفی	معرفی
معروف	معروف
معطر	معطر
معلم	معلم
معلوم	معلوم
معمار	معمار
معماری	معماری
معمولا	معمولا
معمولی	معمولی
معنا	معنا
معنی	معنی
معین	معین
مغان	مغان
مغز	مغز
مفید	مفید
مقابل	مقابل
مقابله	مقابله
مقاله	مقاله
مقام	مقام
مقامات	مقامات
مقاومت	مقاومت
مقبره	مقبره
مقدار	مقدار
مقدس	مقدس
مقدمه	مقدمه
مقدونی	مقدونی
مقر	مقر
مقصد	مقصد
مقطع	مقطع
ملا	ملا
ملارد	ملارد
ملاط	ملاط
ملاقات	ملاقات
ملال	ملال
ملایر	ملایر
ملت	ملت
ملحق	ملحق
ملقب	ملقب
ملل	ملل
ملوان	ملوان
ملک	ملک
ملکان	ملکان
ملکه	ملکه
ملی	ملی
مملکت	مملکت
ممنوع	ممنوع
ممکن	ممکن
من	من
منابع	منابع
مناره	مناره
مناسب	مناسب
مناطق	مناطق
منبت	منبت
منبع	منبع
منتشر	منتشر
منتقدان	منتقدان
منتقل	منتقل
منتهی	منتهی
منجر	منجر
منحصر	منحصر
منزل	منزل
منشأ	منشأ
منشا	منشا
منصور	منصور
منطق	منطق
منطقه	منطقه
منظره	منظره
منظور	منظور
منفی	منفی
منوچهر	منوچهر
مه	مه
مهاباد	مهاباد
مهاجرت	مهاجرت
مهارت	مهارت
مهدی	مهدی
مهر	مهر
مهران	مهران
مهربان	مهربان
مهرنوش	مهرنوش
مهری	مهری
مهسا	مهسا
مهم	مهم
مهندس	مهندس
مهندسی	مهندسی
مو	مو
مواجه	مواجه
مواد	مواد
موارد	موارد
موافق	موافق
موبایل	موبایل
موتور	موتور
موج	موج
موجب	موجب
موجود	موجود
مودت	مودت
مورد	مورد
موز	موز
موزه	موزه
موس	موس
موسسه	موسسه
موسوی	موسوی
موسی	موسی
موسیقی	موسیقی
موسیو	موسیو
موش	موش
موضوع	موضوع
موظف	موظف
موفق	موفق
موفقیت	موفقیت
موقع	موقع
موقعیت	موقعیت
مولوی	مولوی
مژده	مژده
مک	مک
مکان	مکان
مکانیکی	مکانیکی
مکتب	مکتب
مکزیک	مکزیک
مکزیکو	مکزیکو
مکمل	مکمل
مگر	مگر
مگس	مگس
می	می
میان	میان
میاندورود	میاندورود
میانرود	میانرود
میانه	میانه
میانگین	میانگین
میدان	میدان
میراث	میراث
میرزا	میرزا
میری	میری
میل	میل
میلاد	میلاد
میلادی	میلادی
میله	میله
میلیون	میلیون
میم	میم
مین	مین
مینا	مینا
میناب	میناب
میهن	میهن
میوه	میوه
میَن	مین
نا	نا
نابود	نابود
نابودی	نابودی
ناتل	ناتل
ناحیه	ناحیه
ناخالص	ناخالص
ناخوشی	ناخوشی
نادر	نادر
ناراحت	ناراحت
نارنج	نارنج
ناز	ناز
ناشناس	ناشناس
ناصر	ناصر
ناصرالدین	ناصرالدین
ناصری	ناصری
نام	نام
نامجو	نامجو
نامزد	نامزد
نامه	نامه
نامی	نامی
نامیده	نامیده
نان	نان
ناو	ناو
ناچار	ناچار
ناگاه	ناگاه
نایب	نایب
نبرد	نبرد
نبو	نبو
نبی	نبی
نتایج	نتایج
نتیجه	نتیجه
نجات	نجات
نجدی	نجدی
نجف	نجف
نجفی	نجفی
نجم	نجم
نخست	نخست
نخستین	نخستین
ندارد	ندارد
نر	نر
نرم	نرم
نره	نره
نروژ	نروژ
نرگس	نرگس
نزد	نزد
نزدیک	نزدیک
نزدیکی	نزدیکی
نسا	نسا
نساجی	نساجی
نسایی	نسایی
نسب	نسب
نسبت	نسبت
نسبتا	نسبتا
نسترن	نسترن
نسخه	نسخه
نسق	نسق
نسل	نسل
نشا	نشا
نشان	نشان
نشانه	نشانه
نشتی	نشتی
نشر	نشر
نشریه	نشریه
نشین	نشین
نشینی	نشینی
نصب	نصب
نصر	نصر
نصرت	نصرت
نصف	نصف
نصفه	نصفه
نظارت	نظارت
نظام	نظام
نظامی	نظامی
نظر	نظر
نظرات	نظرات
نظریه	نظریه
نظم	نظم
نعمت	نعمت
نعناع	نعناع
نفت	نفت
نفر	نفر
نفره	نفره
نفس	نفس
نفوذ	نفوذ
نفیس	نفیس
نقاره	نقاره
نقاشی	نقاشی
نقاط	نقاط
نقد	نقد
نقده	نقده
نقره	نقره
نقش	نقش
نقشه	نقشه
نقطه	نقطه
نقل	نقل
نم	نم
نما	نما
نماد	نماد
نماز	نماز
نمایش	نمایش
نمایشنامه	نمایشنامه
نمایشگاه	نمایشگاه
نماینده	نماینده
نمایندگان	نمایندگان
نمایندگی	نمایندگی
نمود	نمود
نمونه	نمونه
نمک	نمک
نمی	نمی
ننه	ننه
نه	نه
نهاد	نهاد
نهاوند	نهاوند
نهایت	نهایت
نهضت	نهضت
نهم	نهم
نو	نو
نوا	نوا
نواحی	نواحی
نواختن	نواختن
نوار	نوار
نواز	نواز
نوازنده	نوازنده
نوازندگان	نوازندگان
نوازندگی	نوازندگی
نوازی	نوازی
نوامبر	نوامبر
نوبت	نوبت
نوجوانان	نوجوانان
نوجوانی	نوجوانی
نود	نود
نوده	نوده
نور	نور
نورس	نورس
نوروز	نوروز
نوروزی	نوروزی
نوری	نوری
نوزاد	نوزاد
نوزدهم	نوزدهم
نوشته	نوشته
نوشهر	نوشهر
نوع	نوع
نوه	نوه
نوک	نوک
نوکیا	نوکیا
نویس	نویس
نویسنده	نویسنده
نویسندگان	نویسندگان
نویسی	نویسی
نَی	نی
نژاد	نژاد
نژادی	نژادی
نژند	نژند
نکا	نکا
نگار	نگار
نگارستان	نگارستان
نگاره	نگاره
نگاری	نگاری
نگاه	نگاه
نگه	نگه
نگهداری	نگهداری
نی	نی
نیا	نیا
نیاز	نیاز
نیاوران	نیاوران
نیر	نیر
نیرو	نیرو
نیز	نیز
نیست	نیست
نیم	نیم
نیما	نیما
نیمه	نیمه
نیک	نیک
هابرماس	هابرماس
هادی	هادی
هاشم	هاشم
هاشمی	هاشمی
هانس	هانس
هاوانا	هاوانا
هتل	هتل
هجده	هجده
هجدهم	هجدهم
هجری	هجری
هخامنشیان	هخامنشیان
هدا	هدا
هدایت	هدایت
هدف	هدف
هدی	هدی
هر	هر
هراز	هراز
هرجا	هرجا
هرمزد	هرمزد
هرمزگان	هرمزگان
هرچند	هرچند
هرچه	هرچه
هرکسی	هرکسی
هرگز	هرگز
هریس	هریس
هزار	هزار
هزاران	هزاران
هزینه	هزینه
هستند	هستند
هسته	هسته
هسه	هسه
هشت	هشت
هشتاد	هشتاد
هشترود	هشترود
هشتم	هشتم
هشتگرد	هشتگرد
هضم	هضم
هفت	هفت
هفتاد	هفتاد
هفتم	هفتم
هفته	هفته
هفدهم	هفدهم
هم	هم
همان	همان
هماهنگ	هماهنگ
همت	همت
همدان	همدان
همدیگر	همدیگر
همراه	همراه
همراهی	همراهی
همزمان	همزمان
همسایه	همسایه
همسر	همسر
همه	همه
همچنان	همچنان
همچنین	همچنین
همچون	همچون
همکار	همکار
همکاری	همکاری
همیشه	همیشه
همین	همین
هند	هند
هندوستان	هندوستان
هنر	هنر
هنرستان	هنرستان
هنرمند	هنرمند
هنرمندان	هنرمندان
هنری	هنری
هنوز	هنوز
هنگام	هنگام
هنگامه	هنگامه
هوا	هوا
هواخواه	هواخواه
هوادار	هوادار
هواداران	هواداران
هوایی	هوایی
هوشنگ	هوشنگ
هویت	هویت
هکتار	هکتار
هیئت	هیئت
هیجدهم	هیجدهم
هیچ	هیچ
و	و
وا	وا
وابسته	وابسته
واج	واج
واحد	واحد
وادار	وادار
وارد	وارد
واره	واره
واسطه	واسطه
واشینگتن	واشینگتن
واقع	واقع
واقعا	واقعا
واقعه	واقعه
وال	وال
واله	واله
والی	والی
والیبال	والیبال
وانت	وانت
واژه	واژه
واگذار	واگذار
وایکینگ	وایکینگ
وب	وب
وبلاگ	وبلاگ
وتو	وتو
وجه	وجه
وجود	وجود
وحدت	وحدت
وحیدیه	وحیدیه
ورامین	ورامین
ورزا	ورزا
ورزش	ورزش
ورزشگاه	ورزشگاه
ورود	ورود
ورودی	ورودی
وزارت	وزارت
وزن	وزن
وزنه	وزنه
وزیر	وزیر
وسایل	وسایل
وسط	وسط
وسطی	وسطی
وسعت	وسعت
وسیله	وسیله
وصل	وصل
وضع	وضع
وضعیت	وضعیت
وطن	وطن
وظایف	وظایف
وظیفه	وظیفه
وعده	وعده
وفادار	وفادار
وقت	وقت
وقتی	وقتی
ول	ول
ولد	ولد
ولز	ولز
ولی	ولی
ولیعصر	ولیعصر
وهن	وهن
وکیل	وکیل
وی	وی
ویتامین	ویتامین
ویر	ویر
ویرجینیا	ویرجینیا
ویسی	ویسی
ویل	ویل
ویلن	ویلن
ویلیام	ویلیام
ویولن	ویولن
ویژه	ویژه
ویژگی	ویژگی
ویکی	ویکی
پا	پا
پادشاه	پادشاه
پادشاهان	پادشاهان
پادشاهی	پادشاهی
پادگان	پادگان
پارس	پارس
پارسی	پارسی
پارلمان	پارلمان
پاره	پاره
پارچه	پارچه
پارک	پارک
پاریس	پاریس
پاشا	پاشا
پامنار	پامنار
پامچال	پامچال
پاناما	پاناما
پانزده	پانزده
پانزدهم	پانزدهم
پانصد	پانصد
پاپ	پاپ
پاچه	پاچه
پاک	پاک
پاکت	پاکت
پاکستان	پاکستان
پای	پای
پایان	پایان
پایتخت	پایتخت
پاینده	پاینده
پایه	پایه
پایین	پایین
پخش	پخش
پذیرفته	پذیرفته
پر	پر
پراگ	پراگ
پراید	پراید
پرتقال	پرتقال
پرد	پرد
پرداخت	پرداخت
پردازش	پردازش
پرده	پرده
پردیس	پردیس
پردیسان	پردیسان
پرست	پرست
پرسپولیس	پرسپولیس
پرشکوه	پرشکوه
پرنده	پرنده
پرندگان	پرندگان
پره	پره
پرواز	پرواز
پروانه	پروانه
پرورش	پرورش
پروفسور	پروفسور
پروین	پروین
پرچم	پرچم
پریشان	پریشان
پزشک	پزشک
پزشکی	پزشکی
پس	پس
پست	پست
پستاندار	پستاندار
پسته	پسته
پسر	پسر
پسران	پسران
پسند	پسند
پسوند	پسوند
پشت	پشت
پشته	پشته
پشتکوه	پشتکوه
پشم	پشم
پل	پل
پلنگ	پلنگ
پله	پله
پناه	پناه
پنبه	پنبه
پنج	پنج
پنجاه	پنجاه
پنجره	پنجره
پنجم	پنجم
پنجه	پنجه
پنگ	پنگ
پهلو	پهلو
پهلوان	پهلوان
پهلوی	پهلوی
پهن	پهن
پهنه	پهنه
پور	پور
پورداوود	پورداوود
پوررضا	پوررضا
پوره	پوره
پورهادی	پورهادی
پوست	پوست
پوشش	پوشش
پوشیده	پوشیده
پول	پول
پولیس	پولیس
پُر	پر
پژو	پژو
پکن	پکن
پگاه	پگاه
پی	پی
پیاده	پیاده
پیاز	پیاز
پیام	پیام
پیانو	پیانو
پیت	پیت
پیدا	پیدا
پیر	پیر
پیرانشهر	پیرانشهر
پیرنیا	پیرنیا
پیروز	پیروز
پیروزی	پیروزی
پیست	پیست
پیش	پیش
پیشتر	پیشتر
پیشرفت	پیشرفت
پیشروی	پیشروی
پیشنهاد	پیشنهاد
پیشوا	پیشوا
پیل	پیل
پیله	پیله
پیمان	پیمان
پیوند	پیوند
پیچیده	پیچیده
پیکان	پیکان
پیکر	پیکر
چابهار	چابهار
چادر	چادر
چارلز	چارلز
چاره	چاره
چاقو	چاقو
چال	چال
چالدران	چالدران
چاله	چاله
چالوس	چالوس
چاه	چاه
چاپ	چاپ
چاپارخانه	چاپارخانه
چاک	چاک
چای	چای
چایی	چایی
چراغ	چراغ
چربی	چربی
چرخ	چرخ
چرخه	چرخه
چرم	چرم
چریک	چریک
چشم	چشم
چشمه	چشمه
چفت	چفت
چلنگر	چلنگر
چله	چله
چم	چم
چمخاله	چمخاله
چمران	چمران
چمن	چمن
چنار	چنار
چناران	چناران
چنته	چنته
چند	چند
چندان	چندان
چندتا	چندتا
چندی	چندی
چندین	چندین
چه	چه
چهار	چهار
چهاردانگه	چهاردانگه
چهارده	چهارده
چهاردهم	چهاردهم
چهارراه	چهارراه
چهارشنبه	چهارشنبه
چهارم	چهارم
چهارمحال	چهارمحال
چهل	چهل
چو	چو
چوب	چوب
چوبی	چوبی
چول	چول
چوله	چوله
چون	چون
چوپان	چوپان
چوکا	چوکا
چپ	چپ
چپگرا	چپگرا
چک	چک
چکاوک	چکاوک
چی	چی
چیان	چیان
چیتگر	چیتگر
چیز	چیز
چین	چین
چینی	چینی
ژان	ژان
ژانر	ژانر
ژانویه	ژانویه
ژاپن	ژاپن
ژنرال	ژنرال
ژنو	ژنو
ژوئن	ژوئن
کابین	کابین
کابینه	کابینه
کاتولیک	کاتولیک
کاخ	کاخ
کار	کار
کارا	کارا
کارانه	کارانه
کاراکتر	کاراکتر
کاربر	کاربر
کاربرد	کاربرد
کارت	کارت
کارخانه	کارخانه
کارشناسی	کارشناسی
کارل	کارل
کارمند	کارمند
کارنامه	کارنامه
کاره	کاره
کاروانسرا	کاروانسرا
کارولینا	کارولینا
کارگاه	کارگاه
کارگر	کارگر
کارگران	کارگران
کارگردان	کارگردان
کارگردانی	کارگردانی
کاری	کاری
کازرون	کازرون
کاست	کاست
کاسه	کاسه
کاسپین	کاسپین
کاشان	کاشان
کاشت	کاشت
کاشف	کاشف
کاشمر	کاشمر
کاشی	کاشی
کاظم	کاظم
کاغذ	کاغذ
کافه	کافه
کال	کال
کالا	کالا
کالج	کالج
کالیفرنیا	کالیفرنیا
کام	کام
کامل	کامل
کاملا	کاملا
کاملاً	کاملاً
کامپیوتر	کامپیوتر
کامپیوتری	کامپیوتری
کان	کان
کانادا	کانادا
کانال	کانال
کانون	کانون
کاهش	کاهش
کبیر	کبیر
کبیسه	کبیسه
کتاب	کتاب
کتابخانه	کتابخانه
کته	کته
کتی	کتی
کتیبه	کتیبه
کجور	کجور
کدو	کدو
کراوات	کراوات
کرج	کرج
کرد	کرد
کردستان	کردستان
کردن	کردن
کرده	کرده
کرم	کرم
کرمان	کرمان
کرمانشاه	کرمانشاه
کره	کره
کرون	کرون
کرک	کرک
کری	کری
کریستین	کریستین
کریسمس	کریسمس
کریم	کریم
کریمی	کریمی
کس	کس
کسانی	کسانی
کسب	کسب
کسری	کسری
کسما	کسما
کسمایی	کسمایی
کسی	کسی
کش	کش
کشاورز	کشاورز
کشاورزی	کشاورزی
کشت	کشت
کشتی	کشتی
کشف	کشف
کشمش	کشمش
کشور	کشور
کشوری	کشوری
کشی	کشی
کشیده	کشیده
کشیش	کشیش
کف	کف
کفش	کفش
کل	کل
کلا	کلا
کلات	کلات
کلاس	کلاس
کلاسیک	کلاسیک
کلاله	کلاله
کلام	کلام
کلان	کلان
کلانشهر	کلانشهر
کلاه	کلاه
کلاچای	کلاچای
کلمه	کلمه
کله	کله
کلی	کلی
کلیسا	کلیسا
کم	کم
کما	کما
کمال	کمال
کمانچه	کمانچه
کمبود	کمبود
کمتر	کمتر
کمر	کمر
کمونیست	کمونیست
کمک	کمک
کمی	کمی
کن	کن
کنار	کنار
کناره	کناره
کنترل	کنترل
کنجد	کنجد
کند	کند
کنسرت	کنسرت
کنف	کنف
کننده	کننده
کنه	کنه
کنگره	کنگره
کنید	کنید
کنیم	کنیم
که	که
کهریزک	کهریزک
کهن	کهن
کهنه	کهنه
کو	کو
کوتاه	کوتاه
کوثر	کوثر
کود	کود
کودتا	کودتا
کودن	کودن
کودنِ	کودن
کودکان	کودکان
کودکی	کودکی
کور	کور
کوره	کوره
کوروش	کوروش
کول	کول
کوله	کوله
کولی	کولی
کومه	کومه
کونه	کونه
کوه	کوه
کوهان	کوهان
کوهدشت	کوهدشت
کوهسار	کوهسار
کوهستان	کوهستان
کوهستانی	کوهستانی
کوهپایه	کوهپایه
کوچ	کوچ
کوچه	کوچه
کوچک	کوچک
کوچکی	کوچکی
کوچی	کوچی
کوی	کوی
کویری	کویری
کَله	کله
کِه	که
کی	کی
کیا	کیا
کیاشهر	کیاشهر
کیان	کیان
کیایی	کیایی
کیبورد	کیبورد
کیس	کیس
کیش	کیش
کیلومتر	کیلومتر
کیهان	کیهان
کیوان	کیوان
کیومرث	کیومرث
گاز	گاز
گالش	گالش
گاه	گاه
گاو	گاو
گبه	گبه
گت	گت
گذاری	گذاری
گذر	گذر
گذشته	گذشته
گر	گر
گرا	گرا
گران	گران
گرانت	گرانت
گرایش	گرایش
گرجی	گرجی
گرد	گرد
گردش	گردش
گردشگری	گردشگری
گردن	گردن
گردنه	گردنه
گرده	گرده
گرزه	گرزه
گرفته	گرفته
گرم	گرم
گرما	گرما
گرمی	گرمی
گره	گره
گروه	گروه
گروهی	گروهی
گرچه	گرچه
گرگ	گرگ
گرگان	گرگان
گرگین	گرگین
گری	گری
گز	گز
گزارش	گزارش
گسترده	گسترده
گسترش	گسترش
گشت	گشت
گفت	گفت
گفتن	گفتن
گفته	گفته
گفتی	گفتی
گل	گل
گلستان	گلستان
گلشن	گلشن
گلشهر	گلشهر
گلف	گلف
گله	گله
گلوگاه	گلوگاه
گلیم	گلیم
گمرک	گمرک
گنبد	گنبد
گنج	گنج
گندم	گندم
گه	گه
گواتمالا	گواتمالا
گوارا	گوارا
گواراٰ	گوارا
گوته	گوته
گود	گود
گودی	گودی
گورستان	گورستان
گوزن	گوزن
گوستاو	گوستاو
گوسفند	گوسفند
گوش	گوش
گوشت	گوشت
گوشه	گوشه
گوشی	گوشی
گول	گول
گولی	گولی
گوناگون	گوناگون
گونه	گونه
گوهر	گوهر
گوید	گوید
گویش	گویش
گَه	گه
گپ	گپ
گچ	گچ
گیاه	گیاه
گیاهان	گیاهان
گیتار	گیتار
گیر	گیر
گیره	گیره
گیری	گیری
گیرید	گیرید
گیل	گیل
گیلان	گیلان
گیلانه	گیلانه
گیلانی	گیلانی
گیلکی	گیلکی
گینه	گینه
یا	یا
یاد	یاد
یادگار	یادگار
یار	یار
یاران	یاران
یارانه	یارانه
یاری	یاری
یازده	یازده
یازدهم	یازدهم
یافت	یافت
یاور	یاور
یحیی	یحیی
یخ	یخ
یخبندان	یخبندان
یخچال	یخچال
یزد	یزد
یزید	یزید
یعقوبی	یعقوبی
یعنی	یعنی
یواش	یواش
یورو	یورو
یوسف	یوسف
یونان	یونان
یونانی	یونانی
یک	یک
یکسان	یکسان
یکشنبه	یکشنبه
یکم	یکم
یکی	یکی
ییلاق	ییلاق