ئاباد	آباد
ئابادی	آبادی
ئابراهام	آبراهام
ئابو	ابو
ئابڕو	آبرو
ئابی	ابی
ئاتەش	آتش
ئاخ	آخ
ئاخر	آخر
ئاخرین	آخرین
ئاخرێوی	اخروی
ئاخرە	آخر
ئاخور	آخور
ئاخوندی	آخوندی
ئاخێز	اخذ
ئاخێزێ	اخذ
ئاخێزە	اخذ
ئاد	اد
ئاداب	آداب
ئاداری	اداری
ئادرنالین	آدرنالین
ئادو	ادو
ئادوە	ادو
ئادێ	اد
ئادە	اد
ئادەم	آدم
ئارا	آرا
ئارام	آرام
ئارامش	آرامش
ئارامی	آرامی
ئارانە	آران
ئارتا	آرتا
ئارد	آرد
ئاردێنێ	اردن
ئاردە	آرد
ئاردەن	اردن
ئاردەنە	اردن
ئاردەی	آردی
ئارزو	آرزو
ئارسلان	ارسلان
ئارمان	آرمان
ئارمانەی	آرمانی
ئاروین	آروین
ئارۆئینە	آروین
ئارۆنە	آرون
ئارۆینە	آروین
ئارۆیەن	آروین
ئارۆیەنە	آروین
ئارۆیەوە	آرویو
ئاری	آری
ئارین	آرین
ئاریە	آری
ئاریەن	آرین
ئارێز	ارز
ئارەزو	آرزو
ئارەزوو	آرزو
ئازاد	آزاد
ئازادی	آزادی
ئازادێ	آزاد
ئازادە	آزاد
ئازار	آزار
ئازاری	آزاری
ئازارێ	آزار
ئازارە	آزار
ئازربایجان	آذربایجان
ئازمون	آزمون
ئازموون	آزمون
ئازموونە	آزمون
ئازیێنێ	آذین
ئازێ	آز
ئازەر	آذر
ئازەربایجان	آذربایجان
ئازەربایجانی	آذربایجانی
ئازەری	آذری
ئازەرەکێ	آذرک
ئاسا	آسا
ئاسان	آسان
ئاسانتەر	آسانتر
ئاسایشی	آسایشی
ئاسایشەی	آسایشی
ئاسایی	آسایی
ئاست	است
ئاستانە	آستان
ئاستێ	است
ئاستە	است
ئاستەکانە	استکان
ئاسلان	اصلان
ئاسمان	آسمان
ئاسمانی	آسمانی
ئاسمانیێ	آسمانی
ئاسمانە	آسمان
ئاسنی	اثنی
ئاسودە	آسود
ئاسوودە	آسود
ئاسوودەئی	آسودی
ئاسپرین	آسپرین
ئاسیا	آسیا
ئاش	آش
ئاشتی	آشتی
ئاشتیانە	آشتیان
ئاشتیە	آشتی
ئاشنا	آشنا
ئاشنایی	آشنایی
ئاشوری	آشوری
ئاشکارا	آشکارا
ئاغا	آغا
ئافریقا	آفریقا
ئافڕیێنێ	آفرین
ئال	آل
ئالبێرت	آلبرت
ئالمانی	آلمانی
ئالودێ	آلود
ئاما	اما
ئاماجە	آماج
ئاماده	آماده
ئامادێ	آماد
ئامادێێ	آماد
ئامادە	آماد
ئامادەگی	آمادگی
ئامار	آمار
ئامارێ	آمار
ئامارە	آمار
ئامازۆن	آمازون
ئامان	امان
ئامانی	امانی
ئامانێ	امان
ئامانە	امان
ئامایش	آمایش
ئامبوڵانسێ	آمبولانس
ئامراز	امراض
ئامرازێ	امراض
ئامرازە	امراض
ئامفی	آمفی
ئاموزش	آموزش
ئاموس	آموس
ئامڕازێ	امراض
ئامی	امی
ئامینێ	آمین
ئامینە	آمین
ئامێتێ	امت
ئامێتە	امت
ئامێدی	آمدی
ئامێرێ	آمر
ئامێنا	امنا
ئامێنێ	امن
ئامێنە	امن
ئامەد	آمد
ئامەدی	آمدی
ئامەیتا	آمیتا
ئامەینه	آمینه
ئامەینێ	آمین
ئان	آن
ئانا	آنا
ئانارە	انار
ئانان	آنان
ئانتالیا	آنتالیا
ئاندە	آند
ئانیە	آنی
ئانێ	آن
ئانێچه	آنچه
ئانە	آن
ئانەشا	انشا
ئانەشانە	انشان
ئانەی	آنی
ئانەیە	آنی
ئاه	آه
ئاهەنگ	آهنگ
ئاهەنگێ	آهنگ
ئاهەنگە	آهنگ
ئاهەنگەی	آهنگی
ئاهەنی	آهنی
ئاو	او
ئاوا	آوا
ئاوارێ	آوار
ئاوارە	آوار
ئاوارەێ	آوار
ئاوایی	آوایی
ئاور	آور
ئاورد	آورد
ئاوردێ	آورد
ئاوردێنێ	آوردن
ئاوردەن	آوردن
ئاوردەی	آوردی
ئاوردەیێ	آوردی
ئاورەی	آوری
ئاوێ	او
ئاوێش	اوش
ئاوێنە	اون
ئاوێوە	او
ئاوە	او
ئاوەر	آور
ئاوەرد	آورد
ئاوەردەن	آوردن
ئاوەردەی	آوردی
ئاوەری	آوری
ئاوەزو	اوزو
ئاوەزوو	اوزو
ئاوەو	او
ئاڕاستیە	آراستی
ئاڕاستێ	آراست
ئاڕاستە	آراست
ئاڕاستەنێ	آراستن
ئاڕاستەی	آراستی
ئاژانسێ	آژانس
ئاژانسە	آژانس
ئاژێوە	آژو
ئاژەو	آژو
ئاڤجی	اوجی
ئاڤێستا	اوستا
ئاکتۆرێ	آکتور
ئاکو	اکو
ئاکەس	اکس
ئاکەسانە	آکسان
ئاکەسێ	اکس
ئاگر	اگر
ئاڵا	آلا
ئاڵترناتیڤ	آلترناتیو
ئاڵف	الف
ئاڵمان	آلمان
ئاڵمانی	آلمانی
ئاڵێ	آل
ئاۊردەی	آوردی
ئاۊەزو	اوزو
ئای	آی
ئایا	آیا
ئایاز	ایاز
ئایر	ایر
ئاین	این
ئایندێ	آیند
ئایندە	آیند
ئاینێ	این
ئاینە	این
ئاینەکێ	اینک
ئایی	آیی
ئایین	آیین
ئایینێ	آیین
ئایینە	آیین
ئایە	آی
ئایەنە	این
ئبراق	براق
ئتر	تر
ئتمیز	تمیز
ئجۆر	جور
ئزمیر	ضمیر
ئقباڵ	قبال
ئلوس	لوث
ئو	و
ئوسن	وسن
ئوو	و
ئووتی	وطی
ئۆ	و
ئۆزەن	وزن
ئیدی	یدی
ئیراق	یراق
ئیساقی	یساقی
ئیمانی	یمانی
ئیمەن	یمن
ئیمەنە	یمن
ئیوەرو	یورو
ئیڤری	یوری
ئێای	آی
ئێتر	تر
ئێحساس	حساس
ئێخڵاق	خلاق
ئێدامە	دام
ئێدی	دی
ئێدێعاێ	دعا
ئێران	ران
ئێرانش	رانش
ئێرانی	رانی
ئێرانیێ	رانی
ئێرانێ	ران
ئێردا	ردا
ئێرس	رس
ئێرو	رو
ئێرەکە	رک
ئێرەکەی	رکی
ئێزدی	زدی
ئێزدیێ	زدی
ئێزیدی	زیدی
ئێزیدیێ	زیدی
ئێزیدێ	زید
ئێسامی	سامی
ئێساڵ	سال
ئێساڵەنە	سالن
ئێسلامی	سلامی
ئێشارە	شار
ئێشێوش	شوش
ئێشەو	شو
ئێلی	لی
ئێمام	مام
ئێمشەو	مشو
ئێملی	ملّی
ئێمه	مه
ئێمەش	مش
ئێمەن	من
ئێمەنە	من
ئێمەوە	مو
ئێمەی	می
ئێنرە	نر
ئێوە	و
ئەئەپا	پا
ئەبری	بری
ئەبلێی	بلی
ئەبو	بو
ئەبوو	بو
ئەبەد	بد
ئەجنەبی	جنبی
ئەجیێ	جی
ئەجێم	جم
ئەجەل	جل
ئەجەوید	جوید
ئەحسەن	حسن
ئەحمەد	حمد
ئەحمەدی	حمدی
ئەحەمەد	حمد
ئەخلاق	خلاق
ئەخلاقێ	خلاق
ئەدائیما	دایما
ئەداو	داو
ئەدایی	دایی
ئەدبی	دبی
ئەدەب	دب
ئەدەبی	دبی
ئەدەبیێ	دبی
ئەدەبیە	دبی
ئەدەنە	دن
ئەدەنەی	دنی
ئەردە	رد
ئەرمانێ	رمان
ئەرووپایی	روپایی
ئەرک	رک
ئەرکی	رکی
ئەرکیە	رکی
ئەرکێ	رک
ئەرکە	رک
ئەرکەن	رکن
ئەرکەیە	رکی
ئەرەمەزیێ	رمزی
ئەرەن	رن
ئەرەک	رک
ئەرەی	ری
ئەزهەری	ظهری
ئەسارا	سارا
ئەسان	سان
ئەستۆنە	ستون
ئەستێرەی	ستری
ئەستەر	سطر
ئەسرا	سرا
ئەسعەد	سعد
ئەسمەر	ثمر
ئەسنیێنێ	سنین
ئەسپه	سپه
ئەسپەردێ	سپرد
ئەسپەردە	سپرد
ئەسکەندەر	سکندر
ئەسڵ	سل
ئەسڵی	صلی
ئەسیدا	صیدا
ئەسیر	سیر
ئەسێنە	سن
ئەسەرا	سرا
ئەشرەف	شرف
ئەشق	شق
ئەشقی	شقی
ئەشقیە	شقی
ئەشناسا	شناسا
ئەشناسیێ	شناسی
ئەشناسێ	شناس
ئەشکەفت	شکفت
ئەشکەنجێ	شکنج
ئەشکەنجە	شکنج
ئەشۆم	شوم
ئەعزەمی	عظمی
ئەقڵ	قل
ئەقڵو	قلو
ئەقڵی	قلی
ئەقڵە	قل
ئەلئەوەل	لول
ئەلسانی	لسانی
ئەلک	لک
ئەلیزێ	لیز
ئەمشێ	مش
ئەمن	من
ئەمنی	منی
ئەمنیێ	منی
ئەمنیە	منی
ئەمنە	من
ئەمڕۆ	مرو
ئەمڕۆی	مروی
ئەمین	مین
ئەمینێ	مین
ئەمەش	مش
ئەنارە	نار
ئەنباری	نباری
ئەنجو	نجو
ئەنسار	نثار
ئەنساری	نثاری
ئەننام	ننام
ئەنوارە	نوآر
ئەنوەر	نور
ئەنی	نی
ئەهل	هل
ئەهلو	هلو
ئەهلی	هلی
ئەهلیێ	هلی
ئەو	و
ئەوان	وان
ئەوانە	وان
ئەورای	ورای
ئەوستایی	وسطایی
ئەولا	ولا
ئەوی	وی
ئەویە	وی
ئەوێ	و
ئەوێستا	وسطا
ئەوە	و
ئەوەش	وش
ئەوەل	ول
ئەوەڵ	ول
ئەوەڵو	ولو
ئەوەڵوو	ولو
ئەوەڵۆ	ولو
ئەوەی	وی
ئەوەیە	وی
ئەپا	پا
ئەپی	پی
ئەپێسە	پس
ئەچی	چی
ئەچینە	چین
ئەچینەی	چینی
ئەچێوەڵ	چول
ئەچێوەڵی	چولی
ئەڕکەی	رکی
ئەڤین	وین
ئەکتی	کتی
ئەکتەی	کتی
ئەکید	کید
ئەکین	کین
ئەکەرەم	کرم
ئەکەم	کم
ئەکەپەی	کپی
ئەگیل	گیل
ئەگەر	گر
ئەگەرو	گرو
ئەگەری	گری
ئەگەرێ	گر
ئەگەرێوی	گروی
ئەگەرە	گر
ئەیمەن	یمن
ئەیوان	یوآن
ابراهیم	ابراهیم
اتش	آتش
احسان	احسان
احمد	احمد
ادبیات	ادبیات
ارس	ارس
ارش	آرش
از	از
اساس	اساس
است	است
اسحاق	اسحاق
اسفند	اسفند
اسم	اسم
اسماعیل	اسماعیل
اشعار	اشعار
اشمیت	اشمیت
اشنایی	آشنایی
اشک	اشک
افتاد	افتاد
افتادم	افتادم
افتادن	افتادن
افتادیم	افتادیم
الام	آلام
العرب	العرب
العلم	العلم
العین	العین
الله	الله
الیە	آلی
امان	امان
امد	آمد
امدن	آمدن
امدند	آمدند
امین	امین
ان	آن
انتشارات	انتشارات
اند	آند
اندازە	انداز
انرا	آنرا
انگشت	انگشت
انگلیسی	انگلیسی
اهل	اهل
اهن	آهن
اوردی	آوردی
اوقات	اوقات
اکبری	اکبری
ای	ای
اید	آید
ایرانی	ایرانی
این	این
بئاش	باش
بئاشی	باشی
با	با
باب	باب
بابا	بابا
بابایی	بابایی
بابلی	بابلی
بابە	باب
بابەت	بابت
بابەتێ	بابت
بابەتە	بابت
بابەکان	بابکان
باتڵ	باطل
باجی	باجی
باجەلان	باجلان
باجەلانێ	باجلان
باخ	باخ
باخە	باخ
بار	بار
باران	باران
بارانە	باران
بارزانی	بارزانی
بارش	بارش
بارمێ	بارم
بارو	بارو
باروو	بارو
بارۆ	بارو
باری	باری
باریچ	باریچ
باریک	باریک
بارێ	بار
بارێو	بارو
بارێوە	بارو
بارێی	باری
بارە	بار
بارەت	بارت
بارەو	بارو
بارەوە	بارو
بارەکێ	بارک
باز	باز
بازار	بازار
بازاری	بازاری
بازارێ	بازار
بازرگانی	بازرگانی
بازمێنه	بازمنه
بازگەو	بازگو
بازۆ	بازو
بازی	بازی
بازید	بازید
بازیم	بازیم
بازێ	باز
بازێو	بازو
باستان	باستان
باستانی	باستانی
باسنە	باسن
باسەکە	باسک
باش	باش
باشوو	باشو
باشی	باشی
باشە	باش
باعێس	باعث
باغ	باغ
باغداری	باغداری
باغێ	باغ
باغە	باغ
باقری	باقری
باقی	باقی
بال	بال
بالا	بالا
بالکان	بالکان
بالی	بالی
بام	بام
بامدادان	بامدادان
بان	بان
بانه	بانه
بانک	بانک
بانکداری	بانکداری
بانکی	بانکی
بانکێ	بانک
بانکە	بانک
بانگ	بانگ
بانێ	بان
بانێی	بانی
بانە	بان
بانەو	بانو
بانەکەی	بانکی
باوڕ	باور
باوەر	باور
باوەرە	باور
باوەڕ	باور
باوەڕمەند	باورمند
باوەڕمەندێ	باورمند
باوەڕمەندە	باورمند
باک	باک
باکتریێ	باکتری
باڵا	بالا
باڵادەستێ	بالادست
باڵانس	بالانس
باڵایی	بالایی
باڵش	بالش
باڵندێ	بالند
باڵی	بالی
باڵێش	بالش
باڵە	بال
باڵەنە	بالن
بایزید	بایزید
بایکۆت	بایکوت
ببۆ	ببو
ببین	ببین
ببەرانێ	ببران
بت	بت
بتوانێ	بتوان
بخاری	بخاری
بخش	بخش
بخواب	بخواب
بخوابیم	بخوابیم
بخوڕمێ	بخورم
بداری	بداری
بدان	بدان
بدانێ	بدان
بدانە	بدان
بدونە	بدون
بدۆ	بدو
بدۆنە	بدون
بدە	بد
بدەن	بدن
بدەنێ	بدن
بدەورە	بدور
بدەی	بدی
بدەیدێ	بدید
بدەین	بدین
برای	برای
برایان	برایان
برایش	برایش
برایێ	برای
برایە	برای
برف	برف
برق	برق
برنج	برنج
برندارێ	برندار
برو	برو
برگ	برگ
برۆ	برو
برۆشور	بروشور
برۆشۆرێ	بروشور
برۆکسل	بروکسل
بریان	بریان
بریانە	بریان
برینێ	برین
بریێ	بری
بریێنی	برینی
بریێنێ	برین
بریێنە	برین
برێ	بر
برێتینێ	برتین
برێنج	برنج
برێنێ	برن
برەهیم	برهیم
برەڤ	برو
بزرگ	بزرگ
بزوەڕە	بذور
بزی	بزی
بزە	بز
بزەی	بزی
بشار	بشار
بشە	بش
بغداد	بغداد
بلا	بلا
بلبلێی	بلبلی
بلخ	بلخ
بلمێ	بلم
بلوغ	بلوغ
بلووت	بلوط
بلۆک	بلوک
بلۆکی	بلوکی
بلۆکێ	بلوک
بلۆکە	بلوک
بلی	بلی
بلێ	بل
بلە	بل
بلەی	بلی
بمیر	بمیر
بمیرد	بمیرد
بمیرم	بمیرم
بمیرند	بمیرند
بمیرید	بمیرید
بمیریم	بمیریم
بن	بن
بنا	بنا
بنامێ	بنام
بندار	بندار
بنویس	بنویس
بنویسمێ	بنویسم
بنکێ	بنک
بنکە	بنک
بنیامین	بنیامین
بنیانێ	بنیان
بنە	بن
بنەما	بنما
بنەماێ	بنما
بنەی	بنی
به	به
بهار	بهار
بهجت	بهجت
بهروز	بهروز
بهمن	بهمن
بو	بو
بود	بود
بودم	بودم
بودند	بودند
بودی	بودی
بودید	بودید
بودیم	بودیم
بوزان	بوزان
بوزانێ	بوزان
بوزی	بوزی
بوش	بوش
بوشەهر	بوشهر
بوو	بو
بوومی	بومی
بووە	بو
بوڵە	بول
بوێ	بو
بوە	بو
بوەری	بوری
بوەرە	بور
بوەم	بوم
بوەو	بو
بڕ	بر
بڕو	برو
بڕوات	بروات
بڕگێ	برگ
بڕۆکسێل	بروکسل
بڕی	بری
بڕیانە	بریان
بڕین	برین
بڕیێنێ	برین
بڕیێنە	برین
بڕیە	بری
بڕیەم	بریم
بڕێ	بر
بڕێتەر	برتر
بڕێو	برو
بڕێوە	برو
بڕە	بر
بڕەی	بری
بکر	بکر
بکوش	بکوش
بکوشێ	بکوش
بکەر	بکر
بکەردێ	بکرد
بکەری	بکری
بکەرە	بکر
بکەن	بکن
بکەێ	بک
بگندێ	بگند
بگو	بگو
بگویم	بگویم
بگێران	بگران
بگێرانێ	بگران
بگێرانە	بگران
بگێردێ	بگرد
بڵی	بلی
بڵێم	بلم
بۆ	بو
بۆتان	بوتان
بۆر	بور
بۆریس	بوریس
بۆرێ	بور
بۆرە	بور
بۆز	بوز
بۆسە	بوس
بۆکان	بوکان
بی	بی
بیا	بیا
بیابانی	بیابانی
بیابانێ	بیابان
بیانی	بیانی
بیانیێ	بیانی
بیانیە	بیانی
بیانێ	بیان
بیت	بیت
بیدێ	بید
بیرون	بیرون
بیست	بیست
بیشتر	بیشتر
بیفتم	بیفتم
بیفتیم	بیفتیم
بیم	بیم
بیمێ	بیم
بیمە	بیم
بین	بین
بینایی	بینایی
بینی	بینی
بینێ	بین
بینە	بین
بیوە	بیو
بیکە	بیک
بیکەن	بیکن
بیۆ	بیو
بیۆلۆژی	بیولوژی
بیێ	بی
بیێمێ	بیم
بیێن	بین
بیێنا	بینا
بیێندێ	بیند
بیێنمێ	بینم
بیێنه	بینه
بیێنی	بینی
بیێنێ	بین
بیێنە	بین
بیێنەش	بینش
بیێوە	بیو
بیێوەو	بیو
بیێە	بی
بیە	بی
بیەن	بین
بیەنا	بینا
بیەنش	بینش
بیەنێ	بین
بیەو	بیو
بیەوە	بیو
بێبەری	ببری
بێت	بت
بێتهۆوێن	بتهوون
بێخەم	بخم
بێدار	بدار
بێداری	بداری
بێداریم	بداریم
بێدێ	بد
بێدەر	بدر
بێرو	برو
بێرە	بر
بێزار	بزار
بێزاری	بزاری
بێزارێ	بزار
بێسودێ	بسود
بێسەران	بسران
بێسەرێ	بسر
بێمان	بمان
بێمێ	بم
بێن	بن
بێنا	بنا
بێنان	بنان
بێنه	بنه
بێنی	بنی
بێنێ	بن
بێنێما	بنما
بێنە	بن
بێهروز	بهروز
بێهرووز	بهروز
بێهۆش	بهوش
بێو	بو
بێوە	بو
بێچەک	بچک
بێکاری	بکاری
بێکارێ	بکار
بێکامێ	بکام
بێکێشە	بکش
بێکەس	بکس
بێڵ	بل
بێڵێ	بل
بێڵەی	بلی
بێیەنێ	بین
بەئا	با
بەئارۆ	بارو
بەئاسانی	باسانی
بەان	بان
بەباشی	بباشی
بەت	بت
بەتول	بتول
بەتڵان	بطلان
بەتەر	بطر
بەتەمەن	بتمن
بەجا	بجا
بەجەنگ	بجنگ
بەحاڵ	بحال
بەحرەین	بحرین
بەحساب	بحساب
بەحەر	بحر
بەختیار	بختیار
بەختیاری	بختیاری
بەختە	بخت
بەخشایشگەر	بخشایشگر
بەخشی	بخشی
بەخشیان	بخشیان
بەخشیێ	بخشی
بەخەتی	بختی
بەخەیر	بخیر
بەد	بد
بەدان	بدان
بەدر	بدر
بەدری	بدری
بەدست	بدست
بەدلیلێ	بدلیل
بەدم	بدم
بەدوور	بدور
بەدووە	بدو
بەدڵ	بدل
بەدی	بدی
بەدیعە	بدیع
بەدیل	بدیل
بەدیلێ	بدیل
بەدیێ	بدی
بەدەر	بدر
بەدەرێ	بدر
بەدەست	بدست
بەدەستێ	بدست
بەدەل	بدل
بەدەن	بدن
بەر	بر
بەرئاورد	برآورد
بەرئاوردێ	برآورد
بەرابەر	برابر
بەرات	برات
بەران	بران
بەرانێ	بران
بەرانە	بران
بەراورد	برآورد
بەراوردی	برآوردی
بەربەر	بربر
بەرتەرێ	برتر
بەرجەستەن	برجستن
بەرد	برد
بەردن	بردن
بەردی	بردی
بەردێ	برد
بەردێنێ	بردن
بەردێنە	بردن
بەردە	برد
بەردەم	بردم
بەردەن	بردن
بەردەی	بردی
بەردەێنە	بردن
بەرز	برز
بەرزنە	برزن
بەرزو	برزو
بەرزوە	برزو
بەرزۆ	برزو
بەرزینە	برزین
بەرزێ	برز
بەرزێوە	برزو
بەرزە	برز
بەرزەن	برزن
بەرزەنە	برزن
بەرزەو	برزو
بەرش	برش
بەرشا	برشا
بەرفێ	برف
بەرقەراری	برقراری
بەرلین	برلین
بەرمێ	برم
بەرمێنە	برمن
بەرنامه	برنامه
بەرهەم	برهم
بەرهەمێ	برهم
بەرهەمە	برهم
بەرو	برو
بەروو	برو
بەرپا	برپا
بەرکەرد	برکرد
بەرکەردەی	برکردی
بەرگ	برگ
بەرگری	برگری
بەرگێ	برگ
بەرگە	برگ
بەرۆ	برو
بەرۆنە	برون
بەری	بری
بەریتانیا	بریتانیا
بەرینێ	برین
بەرێ	بر
بەرێنێ	برن
بەرێنە	برن
بەرە	بر
بەرەنە	برن
بەرەو	برو
بەرەوو	برو
بەرەوە	برو
بەرەکێ	برک
بەرەکە	برک
بەرەکەتیە	برکتی
بەرەگانە	برگان
بەرەی	بری
بەزری	بذری
بەزل	بذل
بەزم	بزم
بەزمێ	بزم
بەزمە	بزم
بەزۆر	بذور
بەزیێ	بزی
بەزیێکێ	بزیک
بەزەیی	بزیی
بەسات	بساط
بەستێ	بست
بەستە	بست
بەستەری	بستری
بەستەم	بستم
بەستەن	بستن
بەستەی	بستی
بەسرە	بسر
بەسزا	بسزا
بەسی	بسی
بەسیج	بسیج
بەسیجێ	بسیج
بەسیر	بصیر
بەسیێ	بسی
بەسەختی	بسختی
بەسەر	بسر
بەسەرێ	بسر
بەش	بش
بەشار	بشار
بەشو	بشو
بەشوو	بشو
بەشکست	بشکست
بەشیر	بشیر
بەشێ	بش
بەشێو	بشو
بەشێوی	بشوی
بەشێوێوی	بشوی
بەشێوێوە	بشو
بەشێوە	بشو
بەشێوەی	بشوی
بەشە	بش
بەشەر	بشر
بەشەری	بشری
بەشەو	بشو
بەشەوەی	بشوی
بەعەمەل	بعمل
بەغداد	بغداد
بەغدادی	بغدادی
بەفشاری	بفشاری
بەلا	بلا
بەلاش	بلاش
بەلوچی	بلوچی
بەم	بم
بەمە	بم
بەنام	بنام
بەنامێ	بنام
بەند	بند
بەندی	بندی
بەندەر	بندر
بەندەی	بندی
بەنزینێ	بنزین
بەنگالی	بنگالی
بەنی	بنی
بەنەما	بنما
بەنەوەشێ	بنوش
بەها	بها
بەهادار	بهادار
بەهبەهان	بهبهان
بەهجەت	بهجت
بەهرامی	بهرامی
بەهرە	بهر
بەهمەنی	بهمنی
بەهەرحاڵ	بهرحال
بەهەشت	بهشت
بەهەشتی	بهشتی
بەهەمان	بهمان
بەهەڵە	بهل
بەو	بو
بەوێ	بو
بەوێش	بوش
بەوە	بو
بەوەش	بوش
بەچڕی	بچری
بەچێر	بچر
بەچەکی	بچکی
بەڕاحەتی	براحتی
بەڕبەر	بربر
بەڕوو	برو
بەڕۆ	برو
بەڕۊشنی	بروشنی
بەڕێز	برز
بەڕێوە	برو
بەڕێوەی	بروی
بەڕێی	بری
بەکار	بکار
بەکاری	بکاری
بەکارێ	بکار
بەکامە	بکام
بەکتاش	بکتاش
بەکر	بکر
بەکری	بکری
بەکێشی	بکشی
بەکەسی	بکسی
بەگا	بگا
بەگردی	بگردی
بەگری	بگری
بەگشتی	بگشتی
بەڵا	بلا
بەڵغەم	بلغم
بەڵێ	بل
بەڵێە	بل
بەڵە	بل
بەی	بی
بەیا	بیا
بەیاسا	بیاسا
بەیان	بیان
بەیانی	بیانی
بەیانیان	بیانیان
بەیانێ	بیان
بەیانە	بیان
بەیتا	بیتا
بەیتێ	بیت
بەیتە	بیت
بەیدێ	بید
بەیش	بیش
بەین	بین
بەینا	بینا
بەینێ	بین
بەینە	بین
بەیونە	بیون
بەیک	بیک
بەیۆن	بیون
بەیۆنە	بیون
تا	تا
تابلوێ	تابلو
تابلۆ	تابلو
تابڵۆ	تابلو
تاتەو	تاتو
تاج	تاج
تاجر	تاجر
تار	تار
تارا	تارا
تاراج	تاراج
تارق	طارق
تارک	تارک
تاریخ	تاریخ
تاریک	تاریک
تاریکی	تاریکی
تاریکە	تاریک
تارێخ	تارخ
تارە	تار
تازێش	تازش
تازەش	تازش
تازەی	تازی
تاسە	تاس
تاسەە	تاس
تاشۆ	تاشو
تاق	تاق
تاقی	تاقی
تاقێ	تاق
تاقە	تاق
تاقەت	طاقت
تالبی	طالبی
تام	تام
تانک	تانک
تانکێ	تانک
تانێک	تانک
تاهریان	طاهریان
تاهێر	طاهر
تاوان	تاوان
تاوانێ	تاوان
تاوانە	تاوان
تاپۆ	تاپو
تاک	تاک
تاکی	تاکی
تاکید	تاکید
تاکە	تاک
تاکەسی	تاکسی
تاکەی	تاکی
تاڵشی	طالشی
تاڵەبانی	طالبانی
تاڵەقانی	طالقانی
تایپ	تایپ
تبریزی	تبریزی
تجارەت	تجارت
تخم	تخم
تر	تر
تراس	تراس
ترامپ	ترامپ
تراژدی	تراژدی
تراژدیێ	تراژدی
تراکتۆر	تراکتور
ترک	ترک
ترکی	ترکی
ترۆر	ترور
ترۆرێ	ترور
تریاک	تریاک
ترێ	تر
ترەشتە	طرشت
تزێ	تز
تزە	تز
تسلیم	تسلیم
تفڵیێ	طفلی
تفێ	تف
تقدس	تقدس
تل	تل
تلاش	تلاش
تن	تن
ته	ته
تهران	تهران
تو	تو
توانا	توانا
توانایی	توانایی
توتە	توت
توز	توز
توشێ	توش
تولیدات	تولیدات
تومانێ	تومان
تونس	تونس
توو	تو
تووتە	توت
تووتەی	طوطی
توورەی	توری
تووش	توش
تووشێ	توش
توول	طول
توولە	طول
تووڕە	تور
تووڵ	طول
تووڵێ	طول
تووڵە	طول
توڕێ	تور
توڕە	تور
توڵی	تولی
توێسی	توسی
توە	تو
توەر	تور
توەن	تون
توەنی	تونی
توەنیە	تونی
توەو	تو
توەکا	توکا
تڤی	توی
تکریتی	تکریتی
تکنیک	تکنیک
تکە	تک
تۆ	تو
تۆرە	تور
تۆلستۆی	تولستوی
تۆمار	طومار
تۆمارێ	طومار
تۆمارە	طومار
تۆنی	تونی
تۆنە	تون
تۆپچی	توپچی
تۆپێ	توپ
تۆڕێ	تور
تۆڕە	تور
تۆڵە	طول
تۆی	توی
تی	تی
تیر	تیر
تیرێ	تیر
تیرە	تیر
تیغ	تیغ
تیمارێ	تیمار
تیمی	تیمی
تیمێ	تیم
تیمە	تیم
تیۆرە	طیور
تێر	تر
تێوری	توری
تێک	تک
تێکدەر	تکدر
تێکرار	تکرار
تێکێ	تک
تێکەڵ	تکل
تێکەڵێ	تکل
تێکەڵە	تکل
تەباخی	طباخی
تەبارێ	تبار
تەبلیغاتی	تبلیغاتی
تەبێعی	طبعی
تەبەری	تبری
تەحریر	تحریر
تەحسین	تحسین
تەحەمل	تحمل
تەخت	تخت
تەختی	تختی
تەختە	تخت
تەختەی	تختی
تەخریبگەر	تخریبگر
تەر	تر
تەرا	ترا
تەربیەت	تربیت
تەربیەتێ	تربیت
تەرتیب	ترتیب
تەرز	طرز
تەرزە	طرز
تەرس	ترس
تەرسا	ترسا
تەرسان	ترسان
تەرسناکێ	ترسناک
تەرسو	ترسو
تەرسی	ترسی
تەرسێ	ترس
تەرسە	ترس
تەرسەو	ترسو
تەرسەی	ترسی
تەرش	ترش
تەرم	ترم
تەرمێ	ترم
تەرنە	ترن
تەرک	ترک
تەرۆر	ترور
تەرۆریستێ	تروریست
تەرۆرە	ترور
تەریقەتی	طریقتی
تەرێ	تر
تەرێش	ترش
تەرێق	ترق
تەرێنە	ترن
تەرە	تر
تەرەن	ترن
تەرەنە	ترن
تەزویر	تزویر
تەسلیم	تسلیم
تەسلیمێ	تسلیم
تەسەوف	تصوف
تەشریف	تشریف
تەشک	تشک
تەشکیل	تشکیل
تەشکە	تشک
تەعبیر	تعبیر
تەفسیر	تفسیر
تەفسیڵ	تفصیل
تەقلیل	تقلیل
تەقە	تق
تەقەلا	تقلا
تەل	تل
تەلاش	تلاش
تەلاشگەر	تلاشگر
تەلخ	تلخ
تەلە	تل
تەم	تم
تەماشا	تماشا
تەماشاچیێ	تماشاچی
تەماعە	طماع
تەمام	تمام
تەمامە	تمام
تەمرێ	تمر
تەمیزی	تمیزی
تەمە	تم
تەمەدنی	تمدنی
تەن	تن
تەنها	تنها
تەنگ	تنگ
تەنگی	تنگی
تەنێ	تن
تەوافق	توافق
تەوانایی	توانایی
تەوانستە	توانست
تەور	تور
تەورە	تور
تەورەنە	تورن
تەوزیح	توضیح
تەوفیق	توفیق
تەونە	تون
تەوێلی	تولی
تەوێڵی	تولی
تەوێڵێ	طول
تەوەر	تور
تەوەرین	تورین
تەوەرە	تور
تەوەن	تون
تەوەنی	تونی
تەوەنێ	تون
تەوەنە	تون
تەپ	تپ
تەپە	تپ
تەڕتەر	ترتر
تەڕەنە	ترن
تەک	تک
تەکمیل	تکمیل
تەکیە	تکی
تەکەل	تکل
تەڵا	طلا
تەیب	طیب
جا	جا
جابەجا	جابجا
جاجم	جاجم
جادەو	جادو
جار	جار
جارو	جارو
جاری	جاری
جارێ	جار
جارێو	جارو
جارێوە	جارو
جارێۆ	جارو
جارە	جار
جارەو	جارو
جاسم	جاسم
جاش	جاش
جاشێ	جاش
جاشە	جاش
جام	جام
جامع	جامع
جامی	جامی
جامێ	جام
جان	جان
جانتێ	جانت
جانە	جان
جانەوەرێ	جانور
جانەی	جانی
جاڕ	جار
جاڕوو	جارو
جاگیرێ	جاگیر
جبەر	جبر
جبەری	جبری
جدی	جدی
جستە	جست
جستەی	جستی
جل	جل
جلد	جلد
جلێ	جل
جلە	جل
جم	جم
جمال	جمال
جماڵ	جمال
جمعە	جمع
جمعەی	جمعی
جمهووری	جمهوری
جمە	جم
جنابی	جنابی
جنس	جنس
جنوا	جنوا
جهانی	جهانی
جواب	جواب
جوان	جوان
جوانا	جوآنا
جوانان	جوانان
جوانانە	جوانان
جوانی	جوانی
جوانیە	جوانی
جوانێ	جوان
جوانە	جوان
جودی	جودی
جور	جور
جورێ	جور
جورە	جور
جوودی	جودی
جوڵی	جولی
جوڵەی	جولی
جویس	جویس
جگەر	جگر
جگەری	جگری
جگەرە	جگر
جڵو	جلو
جڵەو	جلو
جۆر	جور
جۆراجۆرێ	جوراجور
جۆرێ	جور
جۆرە	جور
جۆش	جوش
جۆکە	جوک
جۆیس	جویس
جی	جی
جیانی	جیانی
جیایو	جیایو
جیرە	جیر
جیش	جیش
جین	جین
جینێ	جین
جیێ	جی
جیێکێ	جیک
جیێێ	جی
جێرسی	جرسی
جێی	جی
جەئانەیە	جانی
جەئەدێ	جد
جەبار	جبار
جەباری	جباری
جەبهە	جبه
جەبینی	جبینی
جەدار	جدار
جەدلێ	جدل
جەر	جر
جەراح	جراح
جەرج	جرج
جەستە	جست
جەستەنە	جستن
جەستەی	جستی
جەسیم	جسیم
جەشن	جشن
جەعفەر	جعفر
جەعل	جعل
جەعلە	جعل
جەلا	جلا
جەلادەت	جلادت
جەلال	جلال
جەلالیان	جلالیان
جەلالیانێ	جلالیان
جەلالیانە	جلالیان
جەلاێ	جلا
جەم	جم
جەماعەت	جماعت
جەماعەتە	جماعت
جەمال	جمال
جەماڵ	جمال
جەمشید	جمشید
جەمشیدی	جمشیدی
جەمع	جمع
جەمعی	جمعی
جەمعیەت	جمعیت
جەمعیەتە	جمعیت
جەمی	جمی
جەمیل	جمیل
جەمێ	جم
جەنایەتکار	جنایتکار
جەنگ	جنگ
جەنگاوەری	جنگاوری
جەنگی	جنگی
جەنگیێ	جنگی
جەنگێ	جنگ
جەنگێئ	جنگ
جەنگە	جنگ
جەنی	جنی
جەنەراڵ	جنرال
جەهان	جهان
جەهانپوور	جهانپور
جەهانی	جهانی
جەهانیان	جهانیان
جەهل	جهل
جەو	جو
جەواد	جواد
جەوانا	جوآنا
جەوانانێ	جوانان
جەوانی	جوانی
جەوانێ	جوان
جەوهەری	جوهری
جەوێ	جو
جەوێش	جوش
جەڵەبە	جلب
جەڵەبەی	جلبی
جەی	جی
جەیش	جیش
حاجی	حاجی
حاجەتێ	حاجت
حازر	حاضر
حازری	حاضری
حاشا	حاشا
حافزی	حافظی
حافێز	حافظ
حافێزەی	حافظی
حامد	حامد
حامی	حامی
حاکم	حاکم
حاکێمێ	حاکم
حاڵ	حال
حاڵەت	حالت
حاڵەتێ	حالت
حاڵەتە	حالت
حبیب	حبیب
حجاب	حجاب
حجاج	حجاج
حران	حران
حرووفیە	حروفی
حرکت	حرکت
حزب	حزب
حزبە	حزب
حساب	حساب
حسابە	حساب
حسام	حسام
حسامی	حسامی
حسن	حسن
حسین	حسین
حسینی	حسینی
حسێن	حسن
حسێنی	حسنی
حسەین	حسین
حق	حق
حقوق	حقوق
حقوقی	حقوقی
حقوقیە	حقوقی
حقوقێی	حقوقی
حقۆقی	حقوقی
حلبی	حلبی
حلوول	حلول
حماسەی	حماسی
حماڵ	حمال
حمس	حمص
حمید	حمید
حواس	حواس
حوریە	حوری
حکم	حکم
حکمەت	حکمت
حکومت	حکومت
حکومەت	حکومت
حکومەتێ	حکومت
حکومەتە	حکومت
حکوومەت	حکومت
حکەمەتی	حکمتی
حێسامی	حسامی
حێفزێ	حفظ
حەبیبی	حبیبی
حەجاب	حجاب
حەر	حر
حەرف	حرف
حەریر	حریر
حەریری	حریری
حەرەکەت	حرکت
حەز	حظ
حەزف	حذف
حەزم	حزم
حەساب	حساب
حەسابێ	حساب
حەساسیەتێ	حساسیت
حەسن	حسن
حەسودی	حسودی
حەسەن	حسن
حەسەنی	حسنی
حەشر	حشر
حەفارە	حفار
حەق	حق
حەقی	حقی
حەقیقەت	حقیقت
حەل	حل
حەلاج	حلاج
حەلب	حلب
حەلیم	حلیم
حەلەب	حلب
حەلەبی	حلبی
حەماسی	حماسی
حەماسە	حماس
حەمام	حمام
حەمامی	حمامی
حەمید	حمید
حەمەد	حمد
حەنا	حنا
حەنیفە	حنیف
حەوت	حوت
حەکایت	حکایت
حەکیم	حکیم
حەیاتی	حیاتی
حەیدەر	حیدر
حەیدەری	حیدری
حەیف	حیف
حەیفا	حیفا
حەیوان	حیوان
حەیوانە	حیوان
خائینێ	خاین
خاتوون	خاتون
خاتوونە	خاتون
خاتوونەی	خاتونی
خار	خار
خاس	خاص
خاستە	خاست
خاسێ	خاص
خاسە	خاص
خالد	خالد
خالدی	خالدی
خالێ	خال
خالێد	خالد
خالێس	خالص
خام	خام
خامۆش	خاموش
خامێ	خام
خامە	خام
خان	خان
خانی	خانی
خانێ	خان
خانە	خان
خانەی	خانی
خاوێری	خاوری
خاوەری	خاوری
خاک	خاک
خاکستر	خاکستر
خاکه	خاکه
خاکی	خاکی
خاکیێ	خاکی
خاکیە	خاکی
خاکە	خاک
خاڵ	خال
خاڵی	خالی
خاڵێ	خال
خاڵە	خال
خاڵەی	خالی
خبر	خبر
ختم	ختم
ختی	خطی
خدری	خدری
خراب	خراب
خرابی	خرابی
خرابێ	خراب
خرووسە	خروس
خرۆش	خروش
خزمێ	خزم
خستە	خست
خسروی	خسروی
خسلەتێ	خصلت
خسڵەتە	خصلت
خشتی	خشتی
خشتێ	خشت
خشک	خشک
خلیل	خلیل
خواب	خواب
خواباندم	خواباندم
خواباندید	خواباندید
خواباندیم	خواباندیم
خوابیدم	خوابیدم
خوابیدی	خوابیدی
خوابیدید	خوابیدید
خوابیدیم	خوابیدیم
خواجه	خواجه
خوانده	خوانده
خوانی	خوانی
خواهیم	خواهیم
خودمختاری	خودمختاری
خودی	خودی
خورد	خورد
خوردن	خوردن
خورشید	خورشید
خون	خون
خوڕەم	خورم
خوی	خوی
خوێن	خون
خوەدێی	خودی
خوەش	خوش
خوەی	خوی
خڕە	خر
خۆ	خو
خۆراک	خوراک
خۆراکی	خوراکی
خۆراکێ	خوراک
خۆرشید	خورشید
خۆشحاڵی	خوشحالی
خۆشی	خوشی
خۆی	خوی
خیابان	خیابان
خیابانێ	خیابان
خیابانە	خیابان
خیار	خیار
خیام	خیام
خیانەت	خیانت
خیانەتکار	خیانتکار
خیانەتە	خیانت
خیاڵ	خیال
خیزانی	خیزانی
خێر	خر
خێرئامی	خرامی
خێراش	خراش
خێری	خری
خێریێ	خری
خێرێ	خر
خێزانێ	خزان
خێزانە	خزان
خێمێ	خم
خەبەر	خبر
خەت	خط
خەتی	خطی
خەتیب	خطیب
خەتیێ	خطی
خەتیە	خطی
خەتێ	خط
خەتە	خط
خەتەر	خطر
خەتەرناک	خطرناک
خەتەی	خطی
خەجاڵەت	خجالت
خەر	خر
خەرامان	خرامان
خەربانێ	خربان
خەرج	خرج
خەرجی	خرجی
خەردەل	خردل
خەزان	خزان
خەزانێ	خزان
خەزەر	خزر
خەسرەوی	خسروی
خەشابێ	خشاب
خەفەت	خفت
خەلاقیەت	خلاقیت
خەلدون	خلدون
خەلیل	خلیل
خەلیلی	خلیلی
خەلەف	خلف
خەم	خم
خەمانم	خمانم
خەمی	خمی
خەمینێ	خمین
خەمێ	خم
خەمێوش	خموش
خەندانی	خندانی
خەوف	خوف
خەوفێ	خوف
خەون	خون
خەڵکانی	خلکانی
خەڵەف	خلف
خەڵەفە	خلف
خەیاتەی	خیاطی
خەیاڵ	خیال
خەیر	خیر
خەیری	خیری
خەیلێ	خیل
دائی	دائی
دائێم	دام
داد	داد
دادوەر	دادور
دادوەری	دادوری
دادوەرە	دادور
دادگانە	دادگان
دادگەری	دادگری
دادی	دادی
دادە	داد
دار	دار
دارا	دارا
دارایی	دارایی
دارایە	دارای
دارستانێ	دارستان
دارند	دارند
دارو	دارو
داروو	دارو
داروێ	دارو
داری	داری
داریوە	داریو
داریۆش	داریوش
داریە	داری
دارێ	دار
دارێو	دارو
دارێوە	دارو
دارە	دار
دارەن	دارن
دارەی	داری
داستان	داستان
داستانی	داستانی
داستانێ	داستان
داستانە	داستان
داستانەی	داستانی
داش	داش
داشت	داشت
داعش	داعش
داعشی	داعشی
داعشێ	داعش
داعشە	داعش
داغ	داغ
دام	دام
دامنە	دامن
دامە	دام
دان	دان
دانا	دانا
دانش	دانش
دانشوەر	دانشور
دانی	دانی
دانێ	دان
دانە	دان
دانەش	دانش
داو	داو
داود	داود
داودی	داودی
داوە	داو
داڵاهوو	دالاهو
داڵاهۆ	دالاهو
دایره	دایره
دایم	دایم
دایمە	دایم
دایوە	دایو
دایەوەو	دایو
دبیر	دبیر
دختران	دختران
دخترک	دخترک
درختی	درختی
درزێ	درز
درشتی	درشتی
دروس	دروس
دروسی	دروسی
دروسە	دروس
دروغ	دروغ
درووسی	دروسی
درک	درک
درۆ	درو
درۆس	دروس
درۆسی	دروسی
درۆسە	دروس
درۆن	درون
درۆێ	درو
دریا	دریا
دریافت	دریافت
دریێ	دری
دریێنێ	درین
درێ	در
درێی	دری
درە	در
درەباز	درباز
درەخت	درخت
درەختی	درختی
درەختێ	درخت
درەو	درو
دزی	دزی
دزیە	دزی
دستگیر	دستگیر
دفاع	دفاع
دلق	دلق
دلو	دلو
دلێ	دل
دلێنەشیەن	دلنشین
دلێو	دلو
دلێوە	دلو
دلێگەی	دلگی
دما	دما
دمارە	دمار
دمدمی	دمدمی
دنی	دنی
دنیا	دنیا
دنیایەی	دنیایی
دنێ	دن
دنە	دن
ده	ده
دهێ	ده
دو	دو
دوا	دوا
دوانە	دوان
دوبارە	دوبار
دور	دور
دوروو	دورو
دوری	دوری
دورێ	دور
دورە	دور
دورەو	دورو
دوما	دوما
دوو	دوو
دووبارێ	دوبار
دووبارە	دوبار
دوودڵی	دودلی
دوور	دور
دووربین	دوربین
دوورتەر	دورتر
دوورو	دورو
دووروە	دورو
دوورۆ	دورو
دووری	دوری
دوورێ	دور
دوورە	دور
دوورەو	دورو
دوورەوە	دورو
دوورەیە	دوری
دووم	دوم
دووێ	دو
دووە	دو
دووەم	دوم
دووەمین	دومین
دوڕان	دوران
دوڕی	دوری
دوی	دوی
دوێ	دو
دوێنێ	دون
دوە	دو
دوەدڵی	دودلی
دوەم	دوم
دوەمین	دومین
دوەمینە	دومین
دڕندێ	درند
دڕندە	درند
دڕی	دری
دڕیێ	دری
دڕیێنێ	درین
دڕەی	دری
دژ	دژ
دژە	دژ
دکتر	دکتر
دکتری	دکتری
دڵ	دل
دڵا	دلا
دڵداری	دلداری
دڵسۆزانه	دلسوزانه
دڵسۆزی	دلسوزی
دڵسەردی	دلسردی
دڵشاد	دلشاد
دڵو	دلو
دڵوو	دلو
دڵگیر	دلگیر
دڵێ	دل
دۆ	دو
دۆرو	دورو
دۆزی	دوزی
دۆستێ	دوست
دۆغان	دوغان
دۆل	دول
دۆن	دون
دۆناڵد	دونالد
دۆڕیێ	دوری
دۆڕێ	دور
دۆڵ	دول
دۆڵو	دولو
دۆڵێ	دول
دۆڵەت	دولت
دۆڵەو	دولو
دۆڵەوێ	دولو
دی	دی
دیار	دیار
دیاربەکر	دیاربکر
دیاری	دیاری
دیاریێ	دیاری
دیاریە	دیاری
دیارێ	دیار
دیارە	دیار
دیانەتی	دیانتی
دیدار	دیدار
دیدارێ	دیدار
دیدە	دید
دیدەی	دیدی
دیر	دیر
دیروز	دیروز
دیری	دیری
دیش	دیش
دیلی	دیلی
دیم	دیم
دیمه	دیمه
دیمی	دیمی
دیمێ	دیم
دیمەن	دیمن
دیمەنێ	دیمن
دین	دین
دینار	دینار
دینارێ	دینار
دینامیت	دینامیت
دیندار	دیندار
دینداری	دینداری
دینو	دینو
دینوو	دینو
دینی	دینی
دینەوەری	دینوری
دیوار	دیوار
دیوان	دیوان
دیوانی	دیوانی
دیوانیە	دیوانی
دیوانە	دیوان
دیوید	دیوید
دیکتاتۆر	دیکتاتور
دیکتاتۆری	دیکتاتوری
دیکە	دیک
دیگران	دیگران
دیێنە	دین
دیەن	دین
دێر	در
دێرک	درک
دێرین	درین
دێرینە	درین
دێرێک	درک
دێز	دز
دێموکراتیک	دموکراتیک
دێمۆکراسی	دموکراسی
دێنی	دنی
دێنێ	دن
دێنە	دن
دێهاتێ	دهات
دێوانە	دوان
دێوە	دو
دەبیر	دبیر
دەبێ	دب
دەبە	دب
دەخیلێ	دخیل
دەر	در
دەرباز	درباز
دەربازێ	درباز
دەربەدەری	دربدری
دەربەند	دربند
دەرختێ	درخت
دەرس	درس
دەرسێ	درس
دەرسەد	درصد
دەرمان	درمان
دەرمانی	درمانی
دەرمانێ	درمان
دەره	دره
دەرهەم	درهم
دەرو	درو
دەرونی	درونی
دەروو	درو
دەروون	درون
دەروونی	درونی
دەروونیە	درونی
دەروونەی	درونی
دەرویش	درویش
دەرک	درک
دەرکە	درک
دەری	دری
دەریا	دریا
دەریایی	دریایی
دەریێ	دری
دەرێ	در
دەرە	در
دەرەختێ	درخت
دەرەو	درو
دەرەوەی	دروی
دەرەکێ	درک
دەست	دست
دەستماڵ	دستمال
دەستور	دستور
دەستوری	دستوری
دەستوور	دستور
دەستووری	دستوری
دەستکێشێ	دستکش
دەستگیر	دستگیر
دەستگیری	دستگیری
دەستگیرێ	دستگیر
دەستگیرە	دستگیر
دەستی	دستی
دەستیێ	دستی
دەستێ	دست
دەستە	دست
دەشت	دشت
دەشتی	دشتی
دەشتە	دشت
دەشتەی	دشتی
دەفتەر	دفتر
دەفتەرێ	دفتر
دەفە	دف
دەق	دق
دەلیل	دلیل
دەلیلەی	دلیلی
دەم	دم
دەماوەند	دماوند
دەمو	دمو
دەموو	دمو
دەمی	دمی
دەمێو	دمو
دەمێوە	دمو
دەمە	دم
دەمەو	دمو
دەمەوە	دمو
دەنکتاش	دنکتاش
دەنگ	دنگ
دەنگێ	دنگ
دەنگە	دنگ
دەها	دها
دەوا	دوا
دەور	دور
دەورانە	دوران
دەورو	دورو
دەوروبەر	دوروبر
دەوروبەرە	دوروبر
دەوروو	دورو
دەوری	دوری
دەوریە	دوری
دەورێو	دورو
دەورێوە	دورو
دەورە	دور
دەورەو	دورو
دەورەی	دوری
دەولەت	دولت
دەولەتە	دولت
دەوڵەت	دولت
دەوڵەتێ	دولت
دەوڵەتە	دولت
دەوەن	دون
دەڤەر	دور
دەڤەرو	دورو
دەڤەری	دوری
دەڤەرێ	دور
دەڤەرە	دور
دەڤەرەو	دورو
دەی	دی
دەیدێ	دید
دەیدەن	دیدن
دەیلمان	دیلمان
دەیلەمی	دیلمی
دەیمی	دیمی
دەیمێ	دیم
دەیمێنە	دیمن
دەین	دین
دەەرو	درو
را	را
رائدی	رادی
رادار	رادار
رادیۆ	رادیو
رازی	رازی
راسا	راسا
راست	راست
راستی	راستی
راستیێ	راستی
راستیێن	راستین
راستیە	راستی
راستە	راست
رانیە	رانی
رایت	رایت
رده	رده
رزم	رزم
رستەنە	رستن
رشید	رشید
رعد	رعد
رفت	رفت
رفتم	رفتم
رمانی	رمانی
رمزی	رمزی
ره	ره
رو	رو
روا	روا
روانە	روان
روحی	روحی
رود	رود
روز	روز
روسری	روسری
روسی	روسی
روو	رو
رووبەروو	روبرو
رووبەڕوو	روبرو
رووسیە	روسی
روونی	رونی
رووی	روی
روویان	رویان
رووە	رو
رووەش	روش
روێ	رو
روەش	روش
روەو	رو
رژیم	رژیم
رۆ	رو
رۆح	روح
رۆحی	روحی
رۆحە	روح
رۆحەی	روحی
رۆحەیە	روحی
رۆزگاری	روزگاری
رۆشن	روشن
رۆشنی	روشنی
رۆژانە	روژان
رۆی	روی
ری	ری
ریزه	ریزه
ریش	ریش
ریشە	ریش
رینی	رینی
ریودۆژانیرۆ	ریودوژانیرو
رێز	رز
رێم	رم
رێمێ	رم
رێژی	رژی
رێک	رک
رێی	ری
رێیا	ریا
رەحمان	رحمان
رەحمانی	رحمانی
رەحمەتی	رحمتی
رەحیم	رحیم
رەحیمی	رحیمی
رەدیف	ردیف
رەزا	رزا
رەسمە	رسم
رەسولی	رسولی
رەسوڵ	رسول
رەسەن	رسن
رەفتار	رفتار
رەفعەت	رفعت
رەقیب	رقیب
رەمزی	رمزی
رەمەزان	رمضان
رەنج	رنج
رەنگینی	رنگینی
رەنگە	رنگ
رەوان	روان
رەوانی	روانی
رەوانێ	روان
رەوتێرە	روتر
رەی	ری
رەیا	ریا
زاتی	ذاتی
زاد	زاد
زاده	زاده
زادێ	زاد
زادە	زاد
زار	زار
زارعی	زارعی
زاری	زاری
زارێی	زاری
زارە	زار
زامن	ضامن
زان	زان
زانێ	زان
زاهێر	ظاهر
زاڵ	ذال
زاڵمانە	ظالمان
زاڵوو	زالو
زاڵێ	ذال
زبان	زبان
زبانشناسی	زبانشناسی
زخمە	زخم
زدێ	زد
زدە	زد
زرار	ضرار
زرنگ	زرنگ
زریران	زریران
زرین	زرین
زعفران	زعفران
زلە	زل
زمان	زمان
زمانی	زمانی
زمینی	زمینی
زمینە	زمین
زنجان	زنجان
زنجیرێ	زنجیر
زنجیرە	زنجیر
زندانیێ	زندانی
زندگی	زندگی
زه	زه
زهن	ذهن
زهنیەت	ذهنیت
زهنیەتە	ذهنیت
زوو	زو
زوەو	زو
زوەوە	زو
زکر	ذکر
زڵم	ظلم
زۆر	زور
زۆرێک	زورک
زیا	ضیا
زیاد	زیاد
زیادی	زیادی
زیار	زیار
زیارتە	زیارت
زیارەت	زیارت
زیان	زیان
زیانمەند	زیانمند
زیانمەندی	زیانمندی
زیانمەندێ	زیانمند
زیانێ	زیان
زیانە	زیان
زیاێ	ضیا
زیدان	زیدان
زین	زین
زیندێ	زیند
زیندە	زیند
زینێ	زین
زینە	زین
زێد	زد
زێرێ	ذر
زێنێ	ذن
زێوەر	زور
زەبر	زبر
زەبری	زبری
زەجرئاوەرێ	زجرآور
زەحمەت	زحمت
زەحمەتکێش	زحمتکش
زەحمەتێکشێ	زحمتکش
زەدەن	زدن
زەرب	ضرب
زەرد	زرد
زەردی	زردی
زەردە	زرد
زەردەشت	زردشت
زەردەی	زردی
زەروورەت	ضرورت
زەریف	ظریف
زەریفەیە	ظریفی
زەرێ	ذر
زەرەر	ضرر
زەفەر	ظفر
زەق	زق
زەل	زل
زەلی	ظلی
زەلیل	ذلیل
زەمان	زمان
زەمانێ	زمان
زەمانە	زمان
زەمانەی	زمانی
زەمانەیە	زمانی
زەمین	زمین
زەمینی	زمینی
زەمینیێ	زمینی
زەمینێ	زمین
زەمینە	زمین
زەندی	زندی
زەنگی	زنگی
زەنگێ	زنگ
زەوق	ذوق
زەوقی	ذوقی
زەڕ	ذر
زەڕی	زری
زەڕە	ذر
زەڕەکە	زرک
زەکات	زکات
زەکی	ذکی
زەکەریا	ذکریا
زەیتون	زیتون
زەیتونی	زیتونی
زەیتونێ	زیتون
زەیتوون	زیتون
زەیتوونی	زیتونی
زەید	زید
زەیف	زیف
زەینال	زینال
زەینەب	زینب
زەینەبێ	زینب
زەینەبە	زینب
زەینەڵ	زینل
سائیبی	ثایبی
سابت	ثابت
سابون	صابون
سابونی	صابونی
سابێر	صابر
ساتو	ساتو
ساتێو	ساتو
ساتەنە	ساتن
ساحب	صاحب
ساحبی	صاحبی
ساحبێ	صاحب
ساحێب	صاحب
ساحێل	ساحل
ساخت	ساخت
ساختار	ساختار
ساختارە	ساختار
ساختێ	ساخت
ساختەی	ساختی
ساداتێ	سادات
سادق	صادق
سادقی	صادقی
سادۆ	سادو
سادێ	صاد
سادە	صاد
سادەو	سادو
سارا	سارا
ساری	ساری
ساریێ	ساری
سارێ	سار
ساز	ساز
سازمانێ	سازمان
سازی	سازی
سازیێ	سازی
سازیە	سازی
سازێ	ساز
سازە	ساز
ساسانی	ساسانی
ساعەتێ	ساعت
ساف	ساف
سافی	صافی
ساق	ساق
ساقی	ساقی
ساقێ	ساق
ساقە	ساق
سالارە	سالار
سالح	صالح
سالم	سالم
سالێ	سال
سالێن	سالن
سالە	سال
سامان	سامان
سامانی	سامانی
سامانیان	سامانیان
سامانە	سامان
سامی	سامی
سامیە	سامی
سان	سان
سانا	سانا
سانس	سانس
سانچز	سانچز
سانی	ثانی
سانیێ	ثانی
ساوجی	ساوجی
ساڵ	سال
ساڵح	صالح
ساڵحی	صالحی
ساڵێ	سال
ساڵێن	سالن
ساڵێنە	سالن
ساڵە	سال
ساڵەن	سالن
ساڵەنە	سالن
ساڵەکێ	سالک
ساڵەگی	سالگی
سایەی	سایی
ستار	ستار
ستاری	ستاری
ستارە	ستار
ستایش	ستایش
ستەم	ستم
ستەمکاری	ستمکاری
ستەور	ستور
ستەوری	ستوری
سدیق	صدیق
سدیقە	صدیق
سدێق	صدق
سراب	سراب
سرابێ	سرآب
سرانجام	سرانجام
سرشارە	سرشار
سرودی	سرودی
سرودێ	سرود
سروە	سرو
سروەت	ثروت
سریلانکا	سریلانکا
سریە	سری
سزا	سزا
سزایی	سزایی
سعادەتی	سعادتی
سعد	سعد
سعدالله	سعدالله
سعدون	سعدون
سعودی	سعودی
سفت	سفت
سفتەم	سفتم
سفر	سفر
سفرە	سفر
سفی	صفی
سفەت	سفت
سقز	سقز
سلاح	سلاح
سلام	سلام
سلامەتی	سلامتی
سلتان	سلطان
سلتانی	سلطانی
سلولێ	سلول
سلوک	سلوک
سلوکی	سلوکی
سلێمان	سلمان
سلێمانی	سلمانی
سلێمانیێ	سلمانی
سلێمانیە	سلمانی
سلێمانێ	سلمان
سماع	سماع
سماق	سماق
سمبول	سمبول
سمری	ثمری
سمنانی	سمنانی
سمینارێ	سمینار
سمەری	ثمری
سندوقی	صندوقی
سندوقێ	صندوق
سندیێ	سندی
سنگ	سنگ
سنگر	سنگر
سنە	سن
سنەنە	سنن
سنەگر	سنگر
سنەی	سنّی
سنەینە	سنین
سنەیە	سنّی
سنەیەن	سنین
سنەیەنە	سنین
سه	سه
سهو	سهو
سوئال	سوال
سواری	سواری
سوارە	سوار
سوال	سوال
سوت	سوت
سود	سود
سودان	سودان
سودمەندێ	سودمند
سودی	سودی
سور	سور
سوراخ	سوراخ
سوری	سوری
سوریێ	سوری
سورێ	سور
سورێنێ	سورن
سورێی	سوری
سورەت	صورت
سورەن	سورن
سورەنا	سورنا
سورەنە	سورن
سورەی	سوری
سوز	سوز
سوزن	سوزن
سوزی	سوزی
سوفی	صوفی
سومر	سومر
سومەری	سومری
سوود	سود
سوور	سور
سوورێنێ	سورن
سوورە	سور
سووک	سوک
سووکە	سوک
سوویا	سویا
سوچی	سوچی
سوڕێنێ	سورن
سوک	سوک
سوکی	سوکی
سوەو	سو
سپاردەن	سپاردن
سپاس	سپاس
سپتامبر	سپتامبر
سڕ	سر
سڕنا	سرنا
سڕو	سرو
سکرتێر	سکرتر
سکسی	سکسی
سکێ	سک
سڵ	سل
سڵام	سلام
سڵامی	سلامی
سڵامەتی	سلامتی
سڵامەتیان	سلامتیان
سڵامەتێ	سلامت
سڵتان	سلطان
سڵتانی	سلطانی
سڵیمان	سلیمان
سڵێمانی	سلمانی
سۆخت	سوخت
سۆر	سور
سۆز	سوز
سۆزدار	سوزدار
سۆزداری	سوزداری
سۆزی	سوزی
سۆزە	سوز
سۆزەن	سوزن
سۆسیال	سوسیال
سۆسیالیزم	سوسیالیزم
سۆسیالیست	سوسیالیست
سۆفی	صوفی
سۆگەند	سوگند
سۆگەندی	سوگندی
سۊز	سوز
سی	سی
سیاست	سیاست
سیاستە	سیاست
سیاسی	سیاسی
سیاسیێ	سیاسی
سیاسیە	سیاسی
سیاسەت	سیاست
سیاسەتمەدار	سیاستمدار
سیاسەتمەدارێ	سیاستمدار
سیاسەتی	سیاستی
سیاسەتیە	سیاستی
سیاسەتێ	سیاست
سیاسەتە	سیاست
سیاسەتەی	سیاستی
سیاسەتەیە	سیاستی
سیامەک	سیامک
سید	سید
سیدیێ	صیدی
سیروان	سیروان
سیری	سیری
سیرێ	سیر
سیستم	سیستم
سیستماتیک	سیستماتیک
سیستمێ	سیستم
سیستمە	سیستم
سیستێمە	سیستم
سیستەم	سیستم
سیستەماتیک	سیستماتیک
سیستەمە	سیستم
سیفە	سیف
سیفەی	سیفی
سیما	سیما
سینا	سینا
سینێ	سین
سینە	سین
سینەما	سینما
سینەی	سینی
سیوندی	سیوندی
سیوەند	سیوند
سیوەندی	سیوندی
سیێ	سی
سێرە	سر
سێمڕ	ثمر
سێمینارێ	سمینار
سێن	سن
سێنتێ	سنت
سێکسی	سکسی
سێیەم	سیم
سەباح	صباح
سەباحی	صباحی
سەباەت	ثبات
سەبری	صبری
سەبع	سبع
سەبکی	سبکی
سەبکێ	سبک
سەتحە	سطح
سەحر	سحر
سەحەر	سحر
سەخت	سخت
سەختتەر	سختتر
سەختی	سختی
سەختیێ	سختی
سەختێنێ	سختن
سەختەن	سختن
سەختەنە	سختن
سەختەیە	سختی
سەد	سد
سەدام	صدام
سەدر	سدر
سەدیقی	صدیقی
سەدە	سد
سەر	سر
سەرا	سرا
سەرانێ	سران
سەرانە	سران
سەرباز	سرباز
سەربازان	سربازان
سەربازی	سربازی
سەربازیێ	سربازی
سەربازیە	سربازی
سەربازێ	سرباز
سەربازە	سرباز
سەربە	سرب
سەرتاسەر	سرتاسر
سەرتاسەری	سرتاسری
سەرتاسەریێ	سرتاسری
سەرتیپ	سرتیپ
سەرتەر	سرتر
سەرحەد	سرحد
سەرحەدی	سرحدی
سەرخود	سرخود
سەرد	سرد
سەردار	سردار
سەردە	سرد
سەردەشت	سردشت
سەردەشتی	سردشتی
سەردەشتیێ	سردشتی
سەرراست	سرراست
سەرزەمین	سرزمین
سەرزەمینە	سرزمین
سەرسام	سرسام
سەرسامێ	سرسام
سەرشارە	سرشار
سەرف	صرف
سەرفرازی	سرفرازی
سەرمایەی	سرمایی
سەرمەست	سرمست
سەرمەشق	سرمشق
سەرنشینێ	سرنشین
سەرهەنگ	سرهنگ
سەرهەنگی	سرهنگی
سەرو	سرو
سەروئانەیە	سروانی
سەروان	سروان
سەروو	سرو
سەرووێ	سرو
سەروە	سرو
سەروەت	ثروت
سەروەر	سرور
سەروەری	سروری
سەروەرە	سرور
سەروەش	سروش
سەروەشی	سروشی
سەرپێڵ	سرپل
سەرپەل	سرپل
سەرڕاست	سرراست
سەرڕاستێ	سرراست
سەرکووب	سرکوب
سەرکێشی	سرکشی
سەرگەردانی	سرگردانی
سەرگەرم	سرگرم
سەرۆ	سرو
سەری	سری
سەریش	سریش
سەرین	سرین
سەرە	سر
سەرەتانە	سرطان
سەرەسام	سرسام
سەرەم	سرم
سەرەو	سرو
سەرەوە	سرو
سەرەوەشی	سروشی
سەرەک	سرک
سەرەیش	سریش
سەزا	سزا
سەعدی	سعدی
سەعید	سعید
سەفا	صفا
سەفاری	صفاری
سەفی	صفی
سەفیرە	سفیر
سەفەری	صفری
سەقز	سقز
سەقەت	سقط
سەلاح	سلاح
سەلاس	ثلاث
سەلام	سلام
سەلامی	سلامی
سەلامەتی	سلامتی
سەلجوق	سلجوق
سەلمان	سلمان
سەلمانی	سلمانی
سەلیم	سلیم
سەلیمی	سلیمی
سەلیمە	سلیم
سەلەبی	سلبی
سەلەفی	سلفی
سەما	سما
سەمبولیک	سمبولیک
سەمیر	سمیر
سەمیرە	سمیر
سەمیمی	صمیمی
سەمینارێ	سمینار
سەمەد	صمد
سەمەدی	صمدی
سەمەر	ثمر
سەمەرقەند	سمرقند
سەمەرقەندی	سمرقندی
سەمەرێ	ثمر
سەمەرە	ثمر
سەنتەرە	سنتر
سەندیکا	سندیکا
سەنعەتی	صنعتی
سەنگ	سنگ
سەنگێ	سنگ
سەنگەر	سنگر
سەنگەری	سنگری
سەنگەرێ	سنگر
سەو	سو
سەوا	سوا
سەواد	سواد
سەوادی	سوادی
سەودا	سودا
سەودایی	سودایی
سەوز	سوز
سەوزش	سوزش
سەوزی	سوزی
سەوزێ	سوز
سەوزە	سوز
سەوزەش	سوزش
سەکەوتەی	سکوتی
سەی	سی
سەیارە	سیار
سەیاف	سیاف
سەید	سید
سەیدی	صیدی
سەیدیە	صیدی
سەیف	سیف
سەیفی	سیفی
شاخ	شاخ
شادمان	شادمان
شادمانی	شادمانی
شادمانێ	شادمان
شادی	شادی
شادێ	شاد
شار	شار
شارستان	شارستان
شارێ	شار
شارێل	شارل
شارە	شار
شارەلێ	شارل
شاعر	شاعر
شاعران	شاعران
شاعری	شاعری
شاعرێ	شاعر
شاعرە	شاعر
شاعێر	شاعر
شاعێران	شاعران
شاعێری	شاعری
شاعێرێ	شاعر
شام	شام
شاملو	شاملو
شامپۆ	شامپو
شامی	شامی
شانی	شانی
شاهان	شاهان
شاهدێ	شاهد
شاهو	شاهو
شاهۆ	شاهو
شاهین	شاهین
شاهێدی	شاهدی
شاکر	شاکر
شاگردێ	شاگرد
شاڵ	شال
شایان	شایان
شاید	شاید
شایستە	شایست
شایستەنە	شایستن
شایێستە	شایست
شت	شط
شدن	شدن
شده	شده
شریف	شریف
شش	شش
ششسەد	ششصد
ششەم	ششم
ششەمین	ششمین
شعر	شعر
شعرا	شعرا
شعرێ	شعر
شعوور	شعور
شعێرێ	شعر
شما	شما
شماڵ	شمال
شمس	شمس
شمە	شم
شمەنە	شمن
شناخت	شناخت
شناسایی	شناسایی
شناسی	شناسی
شنۆی	شنوی
شهرستان	شهرستان
شوتی	شوتی
شود	شود
شورەوی	شوروی
شورەوەی	شوروی
شوم	شوم
شوو	شو
شووم	شوم
شوومی	شومی
شوکرانە	شوکران
شوە	شو
شڕ	شر
شک	شک
شکار	شکار
شکست	شکست
شکستی	شکستی
شکستێ	شکست
شکستەن	شکستن
شکم	شکم
شکڵ	شکل
شکە	شک
شکەنە	شکن
شۆت	شوت
شۆتی	شوتی
شۆتە	شوت
شۆخە	شوخ
شۆر	شور
شۆرەوی	شوروی
شۆفێرە	شوفر
شۆمان	شومان
شۆڕش	شورش
شۆڕشگێر	شورشگر
شۆڕشگێری	شورشگری
شۆڕشگێڕی	شورشگری
شۆڕشی	شورشی
شۆڕشێ	شورش
شۆڕشە	شورش
شۆک	شوک
شۆڵە	شول
شی	شی
شیار	شیار
شیخ	شیخ
شیخان	شیخان
شیر	شیر
شیراز	شیراز
شیرازی	شیرازی
شیرودی	شیرودی
شیرین	شیرین
شیرینی	شیرینی
شیمیایی	شیمیایی
شیکە	شیک
شیێ	شی
شیێنێ	شین
شیێنە	شین
شیەن	شین
شیەنێ	شین
شێت	شط
شێتم	شتم
شێتە	شط
شێخ	شخ
شێخێ	شخ
شێری	شری
شێعر	شعر
شێعری	شعری
شێعرێ	شعر
شێعرە	شعر
شێعرەکێ	شعرک
شێعرەی	شعری
شێوێ	شو
شێوێو	شو
شێوێوی	شوی
شێوێوە	شو
شێوە	شو
شێوەش	شوش
شێوەو	شو
شێوەی	شوی
شێوەیە	شوی
شێوەیەیە	شویی
شێیەنێ	شین
شەبەقی	شبقی
شەخسی	شخصی
شەخسە	شخص
شەرافەتی	شرافتی
شەراکەت	شراکت
شەراکەتی	شراکتی
شەرت	شرط
شەرحه	شرحه
شەرحێ	شرح
شەرعی	شرعی
شەرقی	شرقی
شەرم	شرم
شەری	شری
شەریعەتی	شریعتی
شەریف	شریف
شەریفی	شریفی
شەریک	شریک
شەریکە	شریک
شەرەف	شرف
شەفیعی	شفیعی
شەفیق	شفیق
شەفەق	شفق
شەق	شق
شەلاقێ	شلاق
شەمال	شمال
شەماڵ	شمال
شەمری	شمری
شەمس	شمس
شەمسی	شمسی
شەمێرانی	شمرانی
شەمە	شم
شەن	شن
شەنگول	شنگول
شەنە	شن
شەهادەتی	شهادتی
شەهریار	شهریار
شەهلا	شهلا
شەهید	شهید
شەهیدان	شهیدان
شەهیدانە	شهیدان
شەهیدپەروەر	شهیدپرور
شەهیدی	شهیدی
شەهیدێ	شهید
شەهیدە	شهید
شەهیر	شهیر
شەهین	شهین
شەهێدێ	شهد
شەو	شو
شەوق	شوق
شەوی	شوی
شەوێ	شو
شەوێش	شوش
شەوێوە	شو
شەوە	شو
شەوەو	شو
شەوەکێ	شوک
شەڕ	شر
شەڕڤان	شروان
شەڕڤانی	شروانی
شەڕڤانێ	شروان
شەڕی	شری
شەڕە	شر
شەی	شی
شەیخی	شیخی
شەیدا	شیدا
شەیدێ	شید
شەیما	شیما
عابد	عابد
عابر	عابر
عاتفی	عاطفی
عاتێفی	عاطفی
عاجز	عاجز
عادل	عادل
عادلی	عادلی
عادڵ	عادل
عادەت	عادت
عازم	عازم
عاسیە	عاصی
عالی	عالی
عالەی	عالی
عام	عام
عامر	عامر
عامری	عامری
عامی	عامی
عاکف	عاکف
عاڵەمی	عالمی
عبد	عبد
عبدالباقی	عبدالباقی
عبدالخالق	عبدالخالق
عبدالرزاق	عبدالرزاق
عبدالعزیز	عبدالعزیز
عبدالفتاح	عبدالفتاح
عبدالله	عبدالله
عبدالمجید	عبدالمجید
عبدالوهاب	عبدالوهاب
عبدالکریم	عبدالکریم
عدس	عدس
عدنان	عدنان
عراق	عراق
عرفان	عرفان
عرفانی	عرفانی
عرفانیێ	عرفانی
عروسک	عروسک
عروسی	عروسی
عرەبی	عربی
عزەت	عزت
عسمەت	عصمت
عسکری	عسکری
عشق	عشق
عفوونی	عفونی
علا	علا
علم	علم
علمی	علمی
علی	علی
عمار	عمار
عمر	عمر
عمران	عمران
عمید	عمید
عودە	عود
عێراق	عراق
عێراقی	عراقی
عێرفانی	عرفانی
عێرفانیێ	عرفانی
عێرفانیە	عرفانی
عێلم	علم
عێلمی	علمی
عێلمیێ	علمی
عەباس	عباس
عەباسی	عباسی
عەبد	عبد
عەبدۆ	عبدو
عەبدی	عبدی
عەبیدی	عبیدی
عەتار	عطار
عەدالەت	عدالت
عەدل	عدل
عەدلی	عدلی
عەدنان	عدنان
عەدوو	عدو
عەرز	عرض
عەرعەر	عرعر
عەرعەرێ	عرعر
عەرەب	عرب
عەرەبی	عربی
عەرەبیێ	عربی
عەرەبیە	عربی
عەرەبێ	عرب
عەرەبە	عرب
عەزیز	عزیز
عەزیزخانی	عزیزخانی
عەزیزی	عزیزی
عەزیم	عظیم
عەزیمی	عظیمی
عەزەڵێ	عزل
عەسر	عسر
عەسری	عصری
عەسکەر	عسکر
عەسەبی	عصبی
عەشایری	عشایری
عەشق	عشق
عەقلە	عقل
عەقڵ	عقل
عەقڵانیەت	عقلانیت
عەقڵی	عقلی
عەقیدەتی	عقیدتی
عەلی	علی
عەلەم	علم
عەلەوی	علوی
عەلەویێ	علوی
عەمر	عمر
عەمروو	عمرو
عەمیدی	عمیدی
عەمەر	عمر
عەمەڵ	عمل
عەمەڵی	عملی
عەنان	عنان
عەوام	عوام
عەیارە	عیار
عەین	عین
عەینی	عینی
غازی	غازی
غافڵ	غافل
غالب	غالب
غربال	غربال
غرور	غرور
غریبی	غریبی
غلام	غلام
غەدیری	غدیری
غەربی	غربی
غەریب	غریب
غەریبی	غریبی
غەریبێ	غریب
غەریزەی	غریزی
غەریوی	غریوی
غەزال	غزال
غەزالی	غزالی
غەزلێ	غزل
غەزەلی	غزلی
غەزەلیێ	غزلی
غەزەلێ	غزل
غەزەڵ	غزل
غەزەڵی	غزلی
غەزەڵێ	غزل
غەفاری	غفاری
غەفور	غفور
غەمبارێ	غمبار
غەمگین	غمگین
غەمگینی	غمگینی
غەیبی	غیبی
غەیر	غیر
غەیرە	غیر
فاتح	فاتح
فاتێح	فاتح
فارس	فارس
فارسی	فارسی
فارسیە	فارسی
فارسە	فارس
فاروق	فاروق
فاروقی	فاروقی
فازل	فاضل
فاسله	فاصله
فاش	فاش
فاشیست	فاشیست
فاشیستی	فاشیستی
فاعل	فاعل
فام	فام
فامیلی	فامیلی
فانۆس	فانوس
فاڕ	فار
فاڕە	فار
فاکتورێ	فاکتور
فتحی	فتحی
فتوح	فتوح
فحش	فحش
فدراڵی	فدرالی
فدڕاڵی	فدرالی
فرات	فرات
فراتی	فراتی
فراتە	فرات
فرانسەوی	فرانسوی
فراهەم	فراهم
فراوان	فراوان
فراوانی	فراوانی
فراکسیۆن	فراکسیون
فردیناند	فردیناند
فرستاد	فرستاد
فرسەت	فرصت
فرقە	فرق
فرناندۆ	فرناندو
فره	فره
فرهنگ	فرهنگ
فرهنگی	فرهنگی
فروزان	فروزان
فرۆ	فرو
فریاد	فریاد
فریال	فریال
فرێ	فر
فرێش	فرش
فرێنی	فرنی
فرێو	فرو
فرێوە	فرو
فرە	فر
فرەش	فرش
فرەو	فرو
فرەوە	فرو
فرەی	فری
فرەیەرە	فریر
فرەێ	فر
فشار	فشار
فشاری	فشاری
فشارێ	فشار
فشارە	فشار
فشارەکێ	فشارک
فعل	فعل
فعلیە	فعلی
فلان	فلان
فلانی	فلانی
فلۆرانس	فلورانس
فلیکس	فلیکس
فندق	فندق
فنیقی	فنیقی
فهد	فهد
فهلویات	فهلویات
فوئاد	فواد
فواد	فواد
فوزی	فوزی
فولکلۆر	فولکلور
فڕش	فرش
فڕێکانس	فرکانس
فڕێکانسە	فرکانس
فڕە	فر
فکر	فکر
فکری	فکری
فڵان	فلان
فڵانە	فلان
فۆلکلۆر	فولکلور
فۆنەتیک	فونتیک
فیرو	فیرو
فیزیۆلۆژی	فیزیولوژی
فیزیۆلۆژیکێ	فیزیولوژیک
فیلم	فیلم
فیلمێ	فیلم
فێر	فر
فێراق	فراق
فێرش	فرش
فێرو	فرو
فێروو	فرو
فێری	فری
فێرێ	فر
فێرە	فر
فێعلیێ	فعلی
فێڵێکی	فلکی
فەتاح	فتاح
فەتاحی	فتاحی
فەتحی	فتحی
فەتحیێ	فتحی
فەتحەی	فتحی
فەخر	فخر
فەداکاری	فداکاری
فەرامۆش	فراموش
فەرامۆشی	فراموشی
فەرانسە	فرانس
فەراهم	فراهم
فەراهەم	فراهم
فەراهەمێ	فراهم
فەردا	فردا
فەرز	فرز
فەرشاد	فرشاد
فەرشید	فرشید
فەرق	فرق
فەرم	فرم
فەرمان	فرمان
فەرمانبەردارێ	فرمانبردار
فەرماندار	فرماندار
فەرمانداری	فرمانداری
فەرماندارێ	فرماندار
فەرمانڕەواێ	فرمانروا
فەرمانە	فرمان
فەرهاد	فرهاد
فەرهنگی	فرهنگی
فەرهەنگ	فرهنگ
فەرهەنگسازی	فرهنگسازی
فەرهەنگی	فرهنگی
فەرهەنگیێ	فرهنگی
فەرهەنگێ	فرهنگ
فەرهەنگە	فرهنگ
فەریالە	فریال
فەریبا	فریبا
فەرید	فرید
فەریدە	فرید
فەرە	فر
فەرەج	فرج
فەرەجی	فرجی
فەرەنگیسێ	فرنگیس
فەرەی	فری
فەرەیدوون	فریدون
فەساد	فساد
فەعال	فعال
فەقر	فقر
فەقیری	فقیری
فەقیرێ	فقیر
فەقەت	فقط
فەلات	فلات
فەلسەفی	فلسفی
فەلسەفەی	فلسفی
فەلەستینی	فلسطینی
فەلەسەفی	فلسفی
فەهمی	فهمی
فەهیمی	فهیمی
فەهیمێ	فهیم
فەهەد	فهد
فەوج	فوج
فەوزی	فوزی
فەڕانسەوی	فرانسوی
فەڵەستینی	فلسطینی
فەڵەکی	فلکی
فەیروز	فیروز
فەیرۆز	فیروز
فەیزی	فیضی
فەیسبوک	فیسبوک
فەیسەڵ	فیصل
فەیلەسوف	فیلسوف
فەیلەسوفی	فیلسوفی
فەیلەسوفە	فیلسوف
قائم	قائم
قابل	قابل
قابلیەتێ	قابلیت
قادر	قادر
قادرپوور	قادرپور
قادری	قادری
قادریان	قادریان
قازی	قاضی
قاسم	قاسم
قاسمی	قاسمی
قاسمێ	قاسم
قافیه	قافیه
قانون	قانون
قانونی	قانونی
قانونێ	قانون
قانوون	قانون
قاپی	قاپی
قاڵ	قال
قاڵبە	قالب
قاڵیێ	قالی
قایم	قایم
قبوول	قبول
قبوڵ	قبول
قبوڵی	قبولی
قبوڵێ	قبول
قبۆڵ	قبول
قدم	قدم
قدیم	قدیم
قران	قران
قربانی	قربانی
قزڵباش	قزلباش
قسم	قسم
قسمەت	قسمت
قسێت	قسط
قسەدە	قصد
قسەم	قسم
قمە	قم
قه	قه
قو	قو
قوتێ	قوت
قوتە	قوت
قول	قول
قولە	قول
قووت	قوت
قووتێ	قوت
قوول	قول
قوڵ	قول
قوڵی	قولی
قوڵێ	قول
قوەت	قوت
قڕ	قر
قڕان	قرآن
قڕێ	قر
قۆت	قوت
قۆم	قوم
قۆمێ	قوم
قیامەتەە	قیامت
قیس	قیس
قەبووڵی	قبولی
قەبوڵ	قبول
قەتار	قطار
قەتڵ	قتل
قەد	قد
قەدیمی	قدیمی
قەدەغەن	قدغن
قەرار	قرار
قەراردادیە	قراردادی
قەرز	قرض
قەرس	قرص
قەرسی	قرصی
قەزا	قضا
قەسر	قصر
قەسەد	قصد
قەسەدە	قصد
قەسەم	قسم
قەشەنگ	قشنگ
قەلەم	قلم
قەمەر	قمر
قەناس	قناس
قەناعەت	قناعت
قەناعەتە	قناعت
قەندیل	قندیل
قەوام	قوام
قەوم	قوم
قەومە	قوم
قەوڵ	قول
قەوی	قوی
قەویتەر	قویتر
قەڕنی	قرنی
قەڕنیە	قرنی
قەڕنە	قرن
قەڵب	قلب
قەڵەم	قلم
قەڵەمی	قلمی
قەڵەمێ	قلم
قەڵەندەر	قلندر
قەید	قید
قەیسی	قیسی
قەیسەری	قیصری
لا	لا
لابی	لابی
لات	لات
لاتین	لاتین
لاتینی	لاتینی
لاتینیە	لاتینی
لارە	لار
لازم	لازم
لاش	لاش
لاشێ	لاش
لاشە	لاش
لاقەید	لاقید
لام	لام
لاما	لاما
لامێ	لام
لامە	لام
لاوان	لاوان
لاڵ	لال
لای	لای
لایق	لایق
لایقە	لایق
لایێ	لای
لایە	لای
لاێ	لا
لبه	لبه
لتێ	لت
لحن	لحن
لزا	لذا
لسان	لسان
لغت	لغت
له	له
لوئەی	لوی
لوا	لوا
لوت	لوت
لوترە	لوتر
لوتی	لوطی
لولێ	لول
لووبیا	لوبیا
لووتەرە	لوتر
لوچ	لوچ
لوڕی	لوری
لوی	لوی
لویس	لویس
لوێنێ	لون
لوێنە	لون
لوەی	لوی
لکه	لکه
لکی	لکی
لکیێ	لکی
لکە	لک
لۆلم	لولم
لۆنیە	لونی
لۆڤەر	لوور
لی	لی
لیبراڵ	لیبرال
لیترێ	لیتر
لیرێ	لیر
لیرە	لیر
لیست	لیست
لێرە	لر
لێم	لم
لێی	لی
لەتیف	لطیف
لەرزە	لرز
لەرە	لر
لەزەت	لذت
لەش	لش
لەشکر	لشکر
لەشکرکێشی	لشکرکشی
لەشکری	لشکری
لەشکرێ	لشکر
لەشکەری	لشکری
لەشی	لشی
لەعنەت	لعنت
لەفزێ	لفظ
لەقی	لقی
لەقێ	لق
لەقە	لق
لەم	لم
لەمەم	لمم
لەندەن	لندن
لەونە	لون
لەوەی	لوی
لەچک	لچک
لەڕ	لر
لەکی	لکی
لەیل	لیل
لەیلا	لیلا
لەیلێ	لیل
لەیەک	لیک
لەیەکێ	لیک
مئازو	مازو
مئازی	ماضی
ما	ما
ماجد	ماجد
ماجدێ	ماجد
مادری	مادری
مادڕی	مادری
مادی	مادی
مادیێ	مادی
مادە	ماد
مادەی	مادی
مادەیە	مادی
مارا	مارا
مارتا	مارتا
مارسی	مارسی
مارسێل	مارسل
مارسەی	مارسی
مارۆنە	مارون
ماری	ماری
ماریا	ماریا
مارەی	ماری
مازاد	مازاد
مازندرانی	مازندرانی
مازندەرانی	مازندرانی
مازوو	مازو
مازی	ماضی
ماسکێ	ماسک
ماش	ماش
ماشین	ماشین
ماشینی	ماشینی
ماشینێ	ماشین
مافی	مافی
مافیە	مافی
مالد	مالد
مالکیە	مالکی
مالیدی	مالیدی
مام	مام
ماما	ماما
مامە	مام
مانا	مانا
مانایی	مانایی
مانش	مانش
مانشە	مانش
مانۆڕێ	مانور
مانۆڕە	مانور
مانی	مانی
مانیا	مانیا
مانیێ	مانی
مانەش	مانش
مانەوی	مانوی
ماهی	ماهی
ماوا	ماوا
ماڕا	مارا
ماڕی	ماری
ماڕیا	ماریا
ماڕێ	مار
ماکۆ	ماکو
ماڵ	مال
ماڵا	مآلا
ماڵی	مالی
ماڵە	مال
ماڵەی	مالی
مایلێ	مایل
مایک	مایک
مایەن	ماین
مایەو	مایو
مایەوە	مایو
مبۆ	مبو
مبەران	مبران
مت	مت
متابقە	مطابق
متە	مت
متەبێ	مطب
متەی	متی
مجتەمع	مجتمع
مجلس	مجلس
مجیێر	مجیر
مجیێرە	مجیر
محاڵە	محال
محتوا	محتوا
محلی	محلی
محمد	محمد
محمدپوور	محمدپور
محمدی	محمدی
محمود	محمود
محمەد	محمد
محکەمی	محکمی
محکەمە	محکم
محەمەد	محمد
محەمەدنژاد	محمدنژاد
محەمەدی	محمدی
مدان	مدان
مدانێ	مدان
مدانە	مدان
مدران	مدران
مدرێ	مدر
مدرێنێ	مدرن
مدرێوە	مدرو
مدۆ	مدو
مدۆش	مدوش
مدۆنە	مدون
مدۊ	مدو
مدەو	مدو
مدەونە	مدون
مرادی	مرادی
مرانە	مران
مرد	مرد
مرغ	مرغ
مرو	مرو
مرۆ	مرو
مرۆیێ	مروی
مریەم	مریم
مزاحم	مزاحم
مزاف	مضاف
مزافا	مضافا
مزوری	مزوری
مستمر	مستمر
مستەر	مستر
مستەشار	مستشار
مستەشارە	مستشار
مستەوفی	مستوفی
مسر	مسر
مسری	مسری
مسعود	مسعود
مسقاڵە	مثقال
مسڵمان	مسلمان
مسەلێ	مثل
مشار	مشار
مشت	مشت
مشتێ	مشت
مشرەفیە	مشرفی
مشمەر	مشمر
مشناسانێ	مشناسان
مشۆ	مشو
مشەمەرێ	مشمر
معرفتی	معرفتی
معنی	معنی
معین	معین
معینی	معینی
مغز	مغز
مفاخر	مفاخر
مفتی	مفتی
مقدم	مقدم
مقدەم	مقدم
مقەدەم	مقدم
مقەدەمی	مقدمی
مل	مل
ملا	ملا
ملازمی	ملازمی
ملم	ملم
ملمێ	ملم
ملونە	ملون
ملکی	ملکی
ملۆنە	ملون
ملی	ملی
ملیەت	ملیت
ملەتە	ملت
ملەتەیە	ملتی
من	من
مناز	مناز
مناسبی	مناصبی
منبع	منبع
منبەری	منبری
منش	منش
منی	منی
منە	من
منەوەر	منور
مه	مه
مهاباد	مهاباد
مهم	مهم
موئید	موید
موزیسیەن	موزیسین
موزیک	موزیک
موس	موس
موسسە	موسس
موسو	موسو
موسوو	موسو
موسڵ	موصل
موسیقی	موسیقی
موش	موش
موشک	موشک
موشەک	موشک
موشەکێ	موشک
مولانا	مولانا
موو	مو
مووسڵ	موصل
مووش	موش
مووشەکێ	موشک
مووشەکە	موشک
موەقەتێ	موقت
مڕدارە	مردار
مڕو	مرو
مکنزی	مکنزی
مکەران	مکران
مکەرانە	مکران
مکەرمێ	مکرم
مڵ	مل
مڵک	ملک
مڵکێ	ملک
مڵەی	ملّی
مۆ	مو
مۆراڵ	مورال
مۆرە	مور
مۆزیکێ	موزیک
مۆمن	مومن
مۆناکۆ	موناکو
مۆڕاڵ	مورال
مۆڵێ	مول
می	می
میا	میا
میانجی	میانجی
میانجیگەری	میانجیگری
میانین	میانین
میانینە	میانین
میانیەنە	میانین
میانە	میان
میت	میت
میترائیسم	میترائیسم
میتە	میت
میدان	میدان
میراس	میراث
میراسێ	میراث
میرزا	میرزا
میری	میری
میزان	میزان
میسان	میسان
میسر	میسر
میلادی	میلادی
مین	مین
مینوورسکی	مینورسکی
مینۆرسکی	مینورسکی
مینێ	مین
میوە	میو
میە	می
میەو	میو
مێرکل	مرکل
مێرکلێ	مرکل
مێسر	مسر
مێمان	ممان
مێمانێ	ممان
مێنبەری	منبری
مێهری	مهری
مێهمانی	مهمانی
مێو	مو
مێوە	مو
مێوەش	موش
مەئاست	ماست
مەئام	مام
مەئاما	ماما
مەئەو	مو
مەئەیا	میا
مەبارەک	مبارک
مەبارەکەیە	مبارکی
مەبالات	مبالات
مەبنا	مبنا
مەبۆ	مبو
مەبەخشێ	مبخش
مەبەران	مبران
مەبەرانێ	مبران
مەبەرانە	مبران
مەترێ	متر
مەتن	متن
مەتڵوب	مطلوب
مەتی	متی
مەتین	متین
مەتە	مت
مەتەرسە	مترس
مەتەڵی	مطلی
مەجبور	مجبور
مەجبورێ	مجبور
مەجدی	مجدی
مەجنون	مجنون
مەجنوون	مجنون
مەجنوونی	مجنونی
مەجید	مجید
مەجیدی	مجیدی
مەحال	محال
مەحاڵێ	محال
مەحاڵە	محال
مەحتاجی	محتاجی
مەحتوا	محتوا
مەحفەل	محفل
مەحمدە	محمد
مەحمود	محمود
مەحمودی	محمودی
مەحموود	محمود
مەحموودپوور	محمودپور
مەحموودی	محمودی
مەحمەد	محمد
مەحکوم	محکوم
مەحکومێ	محکوم
مەحکووم	محکوم
مەحکەمە	محکم
مەحەمەد	محمد
مەحەمەدی	محمدی
مەخزەنێ	مخزن
مەخمور	مخمور
مەخموری	مخموری
مەخموور	مخمور
مەخمووری	مخموری
مەخمووریێ	مخموری
مەخوور	مخور
مەد	مد
مەداد	مداد
مەدادێ	مداد
مەدار	مدار
مەدالێ	مدال
مەدان	مدان
مەدانێ	مدان
مەدرەسێ	مدرس
مەدرەسەی	مدرسی
مەدنیێ	مدنی
مەدۆ	مدو
مەدۆنە	مدون
مەدیۆنە	مدیون
مەدەنی	مدنی
مەدەنیێ	مدنی
مەدەنیە	مدنی
مەدەنیەت	مدنیت
مەراسم	مراسم
مەراسمێ	مراسم
مەرام	مرام
مەرامی	مرامی
مەران	مران
مەرجان	مرجان
مەرجەعە	مرجع
مەرد	مرد
مەردم	مردم
مەردمی	مردمی
مەردیمێ	مردیم
مەردێنێ	مردن
مەردە	مرد
مەردەن	مردن
مەردەی	مردی
مەرز	مرز
مەرزی	مرضی
مەرزە	مرز
مەرو	مرو
مەروان	مروان
مەروانی	مروانی
مەرکەز	مرکز
مەرکەزی	مرکزی
مەرکەزیەت	مرکزیت
مەرگ	مرگ
مەرگە	مرگ
مەریوان	مریوان
مەریەم	مریم
مەرەخەس	مرخص
مەرەزی	مرضی
مەرەزە	مرز
مەزار	مزار
مەزارێ	مزار
مەزاق	مذاق
مەزانێ	مظان
مەزبوت	مضبوط
مەزرێ	مضر
مەزلووم	مظلوم
مەزلۆم	مظلوم
مەزن	مزن
مەزنێ	مزن
مەزهەب	مذهب
مەزهەبی	مذهبی
مەزهەبێ	مذهب
مەزهەر	مظهر
مەزڵوم	مظلوم
مەزین	مزین
مەزەی	مذی
مەست	مست
مەستوورە	مستور
مەستی	مستی
مەسرەف	مسرف
مەسرەفی	مسرفی
مەسعود	مسعود
مەسلێ	مثل
مەسلەک	مسلک
مەسنەوی	مثنوی
مەسوت	مصوت
مەسکەنی	مسکنی
مەسڵەحتی	مصلحتی
مەسڵەحەتی	مصلحتی
مەسیحیەت	مسیحیت
مەسیر	مسیر
مەسەلا	مثلا
مەسەلێ	مثل
مەسەلە	مثل
مەسەلەمیانە	مسلمیان
مەسەلەکێ	مسلک
مەسەلەکە	مسلک
مەسەلەی	مصلی
مەش	مش
مەشق	مشق
مەشهەد	مشهد
مەشوو	مشو
مەشۆ	مشو
مەشی	مشی
مەعدووم	معدوم
مەعرفەتی	معرفتی
مەعروف	معروف
مەعسوم	معصوم
مەعسووم	معصوم
مەعنەوی	معنوی
مەعەنەوی	معنوی
مەغرێبی	مغربی
مەفاهیمە	مفاهیم
مەفعول	مفعول
مەقالێ	مقال
مەقسودی	مقصودی
مەقسەد	مقصد
مەلا	ملا
مەلاح	ملاح
مەلازگرد	ملاذگرد
مەلونە	ملون
مەلوک	ملوک
مەلۆنە	ملون
مەلێ	مل
مەلەتی	ملتی
مەلەکان	ملکان
مەن	من
مەنار	منار
مەنافی	منافی
مەناڵان	منالان
مەندێ	مند
مەندەنیێ	مندنی
مەنزومە	منظوم
مەنزڵ	منزل
مەنسوور	منثور
مەنۆ	منو
مەنێوە	منو
مەنەو	منو
مەنەی	منی
مەهاباد	مهاباد
مەهابادی	مهابادی
مەهجووری	مهجوری
مەهد	مهد
مەهدی	مهدی
مەهوەشە	مهوش
مەو	مو
مەوات	موات
مەواتە	موات
مەواردێ	موارد
مەوج	موج
مەوجە	موج
مەوزانێ	موزان
مەوزانە	موزان
مەوزۆنە	موزون
مەوسو	موسو
مەوسوو	موسو
مەوسی	موسی
مەولانا	مولانا
مەولود	مولود
مەولودی	مولودی
مەولەوی	مولوی
مەویندێ	مویند
مەوەرمێنە	مورمن
مەوەرو	مورو
مەوەروو	مورو
مەوەرۆ	مورو
مەچەشان	مچشان
مەڕمەڕە	مرمر
مەڕوو	مرو
مەکان	مکان
مەکتوبات	مکتوبات
مەکتەب	مکتب
مەکتەبی	مکتبی
مەکتەبیە	مکتبی
مەکتەبە	مکتب
مەکرانێ	مکران
مەکفی	مکفی
مەکنزی	مکنزی
مەکۆشێ	مکوش
مەکەر	مکر
مەکەران	مکران
مەکەرانی	مکرانی
مەکەرانێ	مکران
مەکەرانە	مکران
مەکەرمێ	مکرم
مەکەرێ	مکر
مەکەرە	مکر
مەکەن	مکن
مەگێرانێ	مگران
مەگێرانە	مگران
مەگێردێ	مگرد
مەگێرۆ	مگرو
مەگێرێ	مگر
مەگەر	مگر
مەڵا	ملا
مەڵێ	مل
مەی	می
مەیا	میا
مەیان	میان
مەیانێ	میان
مەیانە	میان
مەیدان	میدان
مەیدانی	میدانی
مەیدانێ	میدان
مەیسەر	میسر
مەینە	مین
مەینەوە	مینو
مەیو	میو
مەیۆە	میو
مەێوە	مو
نا	نا
نائب	ناب
نابود	نابود
نابودی	نابودی
نابەرابەری	نابرابری
نابەڵەد	نابلد
ناتۆ	ناتو
ناتەمام	ناتمام
ناتەمامی	ناتمامی
ناتەمامە	ناتمام
ناجی	ناجی
ناحەق	ناحق
ناخوش	ناخوش
نادر	نادر
نادری	نادری
نارازی	ناراضی
نارەزایەتیێ	نارضایتی
ناز	ناز
نازا	نازا
نازانە	نازان
نازمە	نازم
نازک	نازک
نازی	نازی
نازیمە	نازیم
نازێمی	ناظمی
نازەنین	نازنین
ناسر	ناصر
ناسری	ناصری
ناسریە	ناصری
ناشیانه	ناشیانه
نافع	نافع
نافعی	نافعی
نالی	نالی
نام	نام
نامدار	نامدار
نامدارێ	نامدار
نامووس	ناموس
نامی	نامی
نامیێ	نامی
نامێ	نام
نامە	نام
نامەی	نامی
نامەیە	نامی
نان	نان
نانسی	نانسی
نانو	نانو
نانوو	نانو
نانە	نان
ناو	ناو
ناوە	ناو
ناوەوە	ناو
ناچار	ناچار
ناچاری	ناچاری
ناچارێ	ناچار
ناچارە	ناچار
ناڕازی	ناراضی
ناڕازیێ	ناراضی
ناڕاستی	ناراستی
ناڕاستیێ	ناراستی
ناڕەزایی	نارضایی
ناڕەزایەتی	نارضایتی
ناڕەزایەتیێ	نارضایتی
ناڕەزایەتیە	نارضایتی
ناڕەزایەی	نارضایی
ناکام	ناکام
ناکامی	ناکامی
ناکۆک	ناکوک
ناکۆکە	ناکوک
ناڵە	نال
ناڵەی	نالی
نایب	نایب
نایرۆبی	نایروبی
نایل	نایل
نباشد	نباشد
نبیل	نبیل
نجاری	نجاری
ندیم	ندیم
نرخش	نرخش
نریان	نریان
نریێ	نری
نریێنێ	نرین
نزار	نزار
نساری	نثاری
نسبەت	نسبت
نشین	نشین
نشینان	نشینان
نشینی	نشینی
نفر	نفر
نفرین	نفرین
نفووس	نفوس
نقشە	نقش
نما	نما
نمایندێ	نمایند
نمایەندێ	نمایند
نمو	نمو
نمک	نمک
نمێ	نم
نمەدان	نمدان
نمەو	نمو
نمەی	نمی
نه	نه
نهاد	نهاد
نوام	نوام
نود	نود
نوری	نوری
نونە	نون
نوورانی	نورانی
نووری	نوری
نویس	نویس
نویسی	نویسی
نویسیێ	نویسی
نویسێ	نویس
نویسە	نویس
نویسەی	نویسی
نوین	نوین
نویەنە	نوین
نوێ	نو
نوە	نو
نڕخ	نرخ
نڕخە	نرخ
نژاد	نژاد
نژادپەرستی	نژادپرستی
نگین	نگین
نگەران	نگران
نۆبەتی	نوبتی
نۆبەرانه	نوبرانه
نۆرۆزی	نوروزی
نۆزدە	نوزد
نۆع	نوع
نۆعێ	نوع
نۆکەری	نوکری
نۆکەرێ	نوکر
نۆکەرە	نوکر
نۊ	نو
نۊکە	نوک
نۊگەرا	نوگرا
نۊین	نوین
نۊینێ	نوین
نی	نی
نیا	نیا
نیابیێ	نیابی
نیاز	نیاز
نیازم	نیازم
نیازێ	نیاز
نیازە	نیاز
نیایش	نیایش
نیایشی	نیایشی
نیشتێرە	نیشتر
نیلسۆن	نیلسون
نیلوفەر	نیلوفر
نیم	نیم
نیمی	نیمی
نیمێ	نیم
نیمە	نیم
نیمەی	نیمی
نیوز	نیوز
نیێ	نی
نیێر	نیر
نیێرە	نیر
نیێوە	نیو
نیە	نی
نیەنا	نینا
نیەو	نیو
نێبیێ	نبی
نێت	نت
نێر	نر
نێرو	نرو
نێری	نری
نێزامی	نظامی
نێزامە	نظام
نێمەو	نمو
نێودەوڵەتی	نودولتی
نەئاوردێ	ناورد
نەبا	نبا
نەباتێ	نبات
نەبووە	نبو
نەبڕیێ	نبری
نەبۆ	نبو
نەبۆی	نبوی
نەبی	نبی
نەبینی	نبینی
نەبینێ	نبین
نەبیێ	نبی
نەبیێنێ	نبین
نەبیێنە	نبین
نەبیەن	نبین
نەبەرانی	نبرانی
نەبەردێنێ	نبردن
نەبەردە	نبرد
نەبەز	نبض
نەبەستەی	نبستی
نەتەرس	نترس
نەتەرسان	نترسان
نەتەرسانێ	نترسان
نەتەرسە	نترس
نەتەوانە	نتوان
نەجات	نجات
نەجاتی	نجاتی
نەجیب	نجیب
نەجیبە	نجیب
نەجەف	نجف
نەخا	نخا
نەدا	ندا
نەدار	ندار
نەداری	نداری
نەدان	ندان
نەدانە	ندان
نەدیم	ندیم
نەدەیمێ	ندیم
نەرم	نرم
نەرمی	نرمی
نەروی	نروی
نەرگس	نرگس
نەریمان	نریمان
نەرەی	نری
نەزاکەت	نزاکت
نەزایان	نزایان
نەزم	نظم
نەزیری	نذیری
نەزیرێ	نذیر
نەزەری	نذری
نەزەریێ	نذری
نەسر	نثر
نەسری	نسری
نەسرە	نثر
نەسڵ	نسل
نەسیم	نسیم
نەسەبی	نسبی
نەفرەت	نفرت
نەفی	نفی
نەفەرێ	نفر
نەفەرە	نفر
نەقش	نقش
نەقشبندی	نقشبندی
نەقشی	نقشی
نەقشێ	نقش
نەقڵ	نقل
نەقیب	نقیب
نەقیبی	نقیبی
نەقەشبەندی	نقشبندی
نەلێ	نل
نەما	نما
نەمو	نمو
نەمی	نمی
نەمەردم	نمردم
نەنویسی	ننویسی
نەهادینە	نهادین
نەهلێی	نهلی
نەو	نو
نەوا	نوا
نەوجوانێ	نوجوان
نەوجەوانێ	نوجوان
نەوروزی	نوروزی
نەورۆز	نوروز
نەورۆزی	نوروزی
نەوگەرا	نوگرا
نەویەن	نوین
نەوێ	نو
نەوێوە	نو
نەوە	نو
نەوەردم	نوردم
نەوەشی	نوشی
نەوەشیێ	نوشی
نەوەشیە	نوشی
نەوەو	نو
نەژادپەرەستە	نژادپرست
نەژادی	نژادی
نەک	نک
نەکا	نکا
نەکات	نکات
نەکرد	نکرد
نەکردنی	نکردنی
نەکەرد	نکرد
نەکەردم	نکردم
نەکەردی	نکردی
نەکەردێ	نکرد
نەکەردێنێ	نکردن
نەکەردەن	نکردن
نەکەردەی	نکردی
نەی	نی
نەیارا	نیارا
نەینەوا	نینوا
نەیۆ	نیو
نەیۆنە	نیون
هات	هات
هادی	هادی
هار	هار
هاشم	هاشم
هاشمی	هاشمی
هامبورگ	هامبورگ
هانا	هانا
هانی	هانی
هانەکاو	هانکاو
هانەی	هانی
هاوێل	هاول
هاوەنێ	هاون
هاڕوون	هارون
هاکان	هاکان
هاڵەو	هالو
هجووم	هجوم
هدایەتی	هدایتی
هر	هر
هرێمێ	هرم
هزار	هزار
هست	هست
هفت	هفت
هفتاد	هفتاد
همان	همان
همانند	همانند
همچنان	همچنان
همکارێ	همکار
همە	هم
هنری	هنری
هور	هور
هوور	هور
هووشیار	هوشیار
هوڵ	هول
هویت	هویت
هویەت	هویت
هکتارێ	هکتار
هۆر	هور
هۆرمۆنێ	هورمون
هۆرە	هور
هۆش	هوش
هۆشمەندی	هوشمندی
هۆشیاری	هوشیاری
هۆو	هوو
هۆڕ	هور
هۆگۆ	هوگو
هۆڵ	هول
هۆڵێ	هول
هۊشیار	هوشیار
هیزی	هیزی
هیزێ	هیز
هیزە	هیز
هیوا	هیوا
هیوێ	هیو
هیچ	هیچ
هیچی	هیچی
هێزمێ	هضم
هێمێ	هم
هێمەت	همت
هێندە	هند
هێچ	هچ
هێکتارێ	هکتار
هێڵ	هل
هێڵی	هلی
هێڵێ	هل
هێڵە	هل
هێڵەو	هلو
هێڵەی	هلی
هەدن	هدن
هەدەف	هدف
هەر	هر
هەراسانێ	هراسان
هەرتا	هرتا
هەرجە	هرج
هەرس	هرس
هەرمە	هرم
هەرچندە	هرچند
هەرچەند	هرچند
هەرچەندە	هرچند
هەرکەس	هرکس
هەرکەسێ	هرکس
هەرێ	هر
هەرێز	هرز
هەرێم	هرم
هەرێمێ	هرم
هەرێمە	هرم
هەرە	هر
هەرەمە	هرم
هەرەکۆل	هرکول
هەزار	هزار
هەزاران	هزاران
هەزارێ	هزار
هەست	هست
هەستی	هستی
هەستێ	هست
هەستەیە	هستی
هەشت	هشت
هەشتی	هشتی
هەشتێ	هشت
هەشتەمین	هشتمین
هەفت	هفت
هەفتێ	هفت
هەفتە	هفت
هەل	هل
هەلیکۆپتەر	هلیکوپتر
هەلیکۆپتەرێ	هلیکوپتر
هەلیکۆپتەرە	هلیکوپتر
هەلەن	هلن
هەم	هم
هەما	هما
هەمامێ	همام
هەمان	همان
هەمانێ	همان
هەماهەنگ	هماهنگ
هەماهەنگی	همآهنگی
هەماهەنگێ	هماهنگ
هەمایون	همایون
هەمزەمان	همزمان
هەموارێ	هموار
هەموو	همو
هەمچنین	همچنین
هەمکاری	همکاری
هەمکارێ	همکار
هەمیاری	همیاری
هەمین	همین
هەمە	هم
هەمەدان	همدان
هەمەدانی	همدانی
هەمەڕەنگێ	همرنگ
هەند	هند
هەندێ	هند
هەندێو	هندو
هەنری	هنری
هەنگامێ	هنگام
هەنگامە	هنگام
هەوا	هوا
هەوادارێ	هوادار
هەوار	هوار
هەواپیما	هواپیما
هەور	هور
هەوڵ	هول
هەوڵێ	هول
هەوڵە	هول
هەوێڵ	هول
هەڕ	هر
هەڕە	هر
هەکە	هک
هەڵوو	هلو
هەڵیکۆپتەرێ	هلیکوپتر
هەڵیکۆپەترێ	هلیکوپتر
هەڵێ	هل
هەڵێوە	هلو
هەڵە	هل
هەڵەن	هلن
هەڵەنە	هلن
هەڵەی	هلی
هەڵەیە	هلی
و	و
وئا	وا
وا	وا
وات	وات
واتێ	وات
واتە	وات
واجە	واج
واحد	واحد
وارد	وارد
واردێ	وارد
واردەی	واردی
وارو	وارو
واروو	وارو
وارۆ	وارو
واستی	واسطی
واستێ	واسط
واستە	واسط
واستەی	واسطی
واقعی	واقعی
واقێعی	واقعی
والا	والا
والنتاین	والنتاین
والی	والی
وام	وام
وامە	وام
وان	وان
وانا	وانا
وانگ	وانگ
وانگە	وانگ
وانە	وان
واژێ	واژ
واژە	واژ
واڵ	وال
واڵێ	وال
واڵە	وال
واڵەی	والی
وبە	وب
وتن	وطن
وتی	وطی
وتەن	وطن
وتەنی	وطنی
وتەو	وتو
وتەی	وطی
وجه	وجه
وجوود	وجود
وجوودی	وجودی
ورد	ورد
وردی	وردی
وردە	ورد
وردەی	وردی
ورمێ	ورم
ورەشو	ورشو
وزمێ	وزم
وزو	وضو
وزوو	وضو
وزۆ	وضو
وزی	وزی
وزینی	وزینی
وزینێ	وزین
وزیێرێ	وزیر
وزیێنی	وزینی
وزیێنێ	وزین
وزیێنە	وزین
وزێنێ	وزن
وست	وست
وستێ	وست
وستەی	وسطی
وشە	وش
ول	ول
ولا	ولا
ولایەتە	ولایت
ولی	ولی
ون	وِن
ونیز	ونیز
ونێ	وِن
ونە	وِن
وو	و
وڕای	ورای
وڵتەر	ولتر
وڵێ	ول
وڵە	ول
ویت	ویت
ویر	ویر
ویراست	ویراست
ویران	ویران
ویرانە	ویران
ویرایش	ویرایش
ویری	ویری
ویرێ	ویر
ویرە	ویر
ویس	ویس
وینەرێ	وینر
ویکتۆر	ویکتور
ویێتنام	ویتنام
ویەر	ویر
ویەری	ویری
ویەرێ	ویر
ویەرە	ویر
ویەرەی	ویری
ویەک	ویک
وێ	و
وێرای	ورای
وێزینێ	وزین
وێش	وش
وێنێ	وِن
وێنە	وِن
وێنەکێ	ونک
وێنەگێر	ونگر
وێڕای	ورای
وێڵ	ول
وێڵۆ	ولو
وە	و
وەبەر	وبر
وەتەن	وطن
وەتەنی	وطنی
وەحید	وحید
وەرامینی	ورامینی
وەرای	ورای
وەرد	ورد
وەردەست	وردست
وەردەی	وردی
وەرزش	ورزش
وەرزی	ورزی
وەرم	ورم
وەرڕەوی	ورروی
وەرۆرە	ورور
وەزارەتی	وزارتی
وەزی	وذی
وەزیر	وزیر
وەزیران	وزیران
وەزیری	وزیری
وەزیرێ	وزیر
وەزینی	وزینی
وەزیە	وذی
وەسف	وصف
وەسێن	وسن
وەش	وش
وەشێ	وش
وەشە	وش
وەفا	وفا
وەفادارێ	وفادار
وەل	ول
وەلا	ولا
وەلتەر	ولتر
وەلی	ولی
وەلێ	ول
وەلەدی	ولدی
وەلەنجەک	ولنجک
وەن	وِن
وەنگ	ونگ
وەنە	وِن
وەنەکێ	ونک
وەنەکە	ونک
وەهابی	وهابی
وەهابیێ	وهابی
وەهم	وهم
وەکالەت	وکالت
وەڵ	ول
وەڵا	ولا
وەڵتر	ولتر
وەڵتەر	ولتر
وەڵتەرە	ولتر
وەڵی	ولی
وەڵێ	ول
وەڵێو	ولو
وەڵە	ول
وەڵەتەر	ولتر
وەڵەد	ولد
وەی	وی
وەیسی	ویسی
وەیلان	ویلان
پا	پا
پابەند	پابند
پادگان	پادگان
پارت	پارت
پارتی	پارتی
پارتیێ	پارتی
پارتێ	پارت
پارتە	پارت
پارسی	پارسی
پارلەمان	پارلمان
پارلەمانێ	پارلمان
پارلەمانە	پارلمان
پارچیە	پارچی
پارچە	پارچ
پارچەی	پارچی
پاریس	پاریس
پاسدارێ	پاسدار
پاسدارە	پاسدار
پاسە	پاس
پاشایی	پاشایی
پانێچە	پانچ
پانێڵێ	پانل
پاوه	پاوه
پاپ	پاپ
پاک	پاک
پاکسازی	پاکسازی
پاکستان	پاکستان
پاکو	پاکو
پاکی	پاکی
پاکێ	پاک
پاکە	پاک
پاڵایش	پالایش
پاڵێ	پال
پای	پای
پایبەندی	پایبندی
پایبەندێ	پایبند
پایتەخت	پایتخت
پایدار	پایدار
پایی	پایی
پاییز	پاییز
پایە	پای
پایەی	پایی
پته	پته
پتەو	پتو
پتەویی	پتویی
پر	پر
پرد	پرد
پردە	پرد
پرسی	پرسی
پرسە	پرس
پروفسۆر	پروفسور
پرۆفسۆر	پروفسور
پرێس	پرس
پرێسی	پرسی
پرێسە	پرس
پزشکی	پزشکی
پزشکە	پزشک
پسر	پسر
پسە	پس
پشت	پشت
پشتی	پشتی
پشتیێ	پشتی
پل	پل
پلان	پلان
پلانەکێ	پلانک
پلنگێ	پلنگ
پلوورە	پلور
پلێ	پل
پلێوە	پلو
پلێکانێ	پلکان
پلە	پل
پلەو	پلو
پلەکە	پلک
پمپ	پمپ
پنتاگۆن	پنتاگون
پنە	پن
پهلوی	پهلوی
پوتین	پوتین
پور	پور
پوشش	پوشش
پوشی	پوشی
پوشەکێ	پوشک
پووش	پوش
پوول	پول
پووچ	پوچ
پوکەی	پوکی
پوڵ	پول
پڕ	پر
پڕان	پران
پڕۆ	پرو
پڵاوێ	پلاو
پڵنگ	پلنگ
پڵنگێ	پلنگ
پڵێ	پل
پۆتین	پوتین
پۆرە	پور
پۆست	پوست
پۆستێ	پوست
پۆستەرێ	پوستر
پۆل	پول
پۆلیس	پولیس
پۆلیسێ	پولیس
پۆلیسە	پولیس
پۆلێ	پول
پۆنه	پونه
پۆچی	پوچی
پۆکە	پوک
پۆکەی	پوکی
پی	پی
پیاز	پیاز
پیازە	پیاز
پیر	پیر
پیرا	پیرا
پیران	پیران
پیرسالاری	پیرسالاری
پیرو	پیرو
پیروو	پیرو
پیرۆز	پیروز
پیرۆزی	پیروزی
پیرۆزیە	پیروزی
پیرۆزە	پیروز
پیری	پیری
پیرێ	پیر
پیرێوی	پیروی
پیرە	پیر
پیزا	پیزا
پیس	پیس
پیسێ	پیس
پیسە	پیس
پیشە	پیش
پیمانێ	پیمان
پیمانە	پیمان
پیمانەیە	پیمانی
پیچ	پیچ
پیک	پیک
پیکان	پیکان
پیێ	پی
پیێنێ	پین
پێت	پت
پێسە	پس
پێش	پش
پێشنەگی	پشنگی
پێشەنگ	پشنگ
پێشەنگی	پشنگی
پێشەنگێ	پشنگ
پێنج	پنج
پێنجەمین	پنجمین
پێنس	پنس
پێوەر	پور
پێوەرە	پور
پێک	پک
پێکێ	پک
پێکێنێ	پکن
پێکە	پک
پێی	پی
پەتا	پتا
پەتێ	پت
پەخش	پخش
پەخشە	پخش
پەر	پر
پەردێ	پرد
پەردە	پرد
پەرس	پرس
پەرسانە	پرسان
پەرستش	پرستش
پەرسدێ	پرسد
پەرسو	پرسو
پەرسپەکتیوو	پرسپکتیو
پەرسیێ	پرسی
پەرسێ	پرس
پەرسێوە	پرسو
پەرسە	پرس
پەرسەو	پرسو
پەروانە	پروان
پەرویز	پرویز
پەروین	پروین
پەروەدەی	پرودی
پەروەر	پرور
پەروەردی	پروردی
پەروەردێ	پرورد
پەروەردە	پرورد
پەروەردەنە	پروردن
پەروەردەی	پروردی
پەرێ	پر
پەرێم	پرم
پەرە	پر
پەرەش	پرش
پەرەی	پری
پەس	پس
پەستو	پستو
پەسین	پسین
پەسەند	پسند
پەسەندێ	پسند
پەشت	پشت
پەشتو	پشتو
پەشتگەرمی	پشتگرمی
پەشتی	پشتی
پەشتەو	پشتو
پەشیمان	پشیمان
پەشیمانێ	پشیمان
پەل	پل
پەلاسی	پلاسی
پەلێ	پل
پەلە	پل
پەلەوەر	پلور
پەنتاگۆن	پنتاگون
پەنج	پنج
پەنجێ	پنج
پەنجە	پنج
پەنجەم	پنجم
پەنجەمین	پنجمین
پەنێ	پن
پەنە	پن
پەهلەوی	پهلوی
پەوچی	پوچی
پەوکی	پوکی
پەوکەی	پوکی
پەوەستێ	پوست
پەڕ	پر
پەڕم	پرم
پەڕوو	پرو
پەڕوێ	پرو
پەڕچین	پرچین
پەڕکەردەنەە	پرکردن
پەڕۆینێ	پروین
پەڕە	پر
پەۆکەی	پوکی
پەی	پی
پەیام	پیام
پەیامی	پیامی
پەیامێ	پیام
پەیامە	پیام
پەیامەکێ	پیامک
پەیامەکە	پیامک
پەیاپەی	پیاپی
پەیاپەیێ	پیاپی
پەیت	پیت
پەیدا	پیدا
پەیرێ	پیر
پەیرە	پیر
پەیرەو	پیرو
پەیرەوی	پیروی
پەیرەی	پیری
پەیش	پیش
پەیمان	پیمان
پەیوەست	پیوست
پەیوەستی	پیوستی
پەیوەستێ	پیوست
پەیوەستە	پیوست
پەیوەستەن	پیوستن
پەیوەند	پیوند
پەیوەندی	پیوندی
پەیوەندیە	پیوندی
پەیوەندێ	پیوند
پەیڕەو	پیرو
پەیڕەوی	پیروی
پەیکەر	پیکر
پەێڕەو	پرو
چارەکە	چارک
چاشت	چاشت
چاشتێ	چاشت
چالاک	چالاک
چالاکی	چالاکی
چالاکیێ	چالاکی
چالاکێ	چالاک
چالاکەی	چالاکی
چانە	چان
چاوش	چاوش
چاپ	چاپ
چاپگەرێ	چاپگر
چاپی	چاپی
چاپێ	چاپ
چاپە	چاپ
چاڵ	چال
چاڵدران	چالدران
چاڵدێران	چالدران
چایەی	چایی
چرا	چرا
چرکێ	چرک
چلێو	چلو
چنار	چنار
چناری	چناری
چند	چند
چندانی	چندانی
چندین	چندین
چندە	چند
چنگ	چنگ
چنگێ	چنگ
چنین	چنین
چهل	چهل
چون	چون
چوون	چون
چوونە	چون
چووە	چو
چوە	چو
چڕی	چری
چڕیێ	چری
چۆ	چو
چۆن	چون
چۆک	چوک
چۆڵ	چول
چۆڵی	چولی
چۆڵێ	چول
چۆڵە	چول
چۆڵەی	چولی
چی	چی
چیرو	چیرو
چیروو	چیرو
چین	چین
چینی	چینی
چینێ	چین
چینێوە	چینو
چینە	چین
چینەوە	چینو
چینەی	چینی
چینەیە	چینی
چیێ	چی
چیە	چی
چێرخانیە	چرخانی
چێشش	چشش
چێشم	چشم
چێشمان	چشمان
چێشی	چشی
چێو	چو
چێوێ	چو
چێوێو	چو
چێوێوە	چو
چێوە	چو
چێوەکا	چوکا
چێوەکە	چوک
چێوەڵ	چول
چەترێکە	چترک
چەتێ	چت
چەتە	چت
چەربی	چربی
چەرمێ	چرم
چەرمە	چرم
چەفت	چفت
چەلیک	چلیک
چەلێو	چلو
چەلێی	چلی
چەلەمە	چلم
چەم	چم
چەمێ	چم
چەمە	چم
چەمەن	چمن
چەمەین	چمین
چەمەینە	چمین
چەند	چند
چەندین	چندین
چەندە	چند
چەنین	چنین
چەنیەن	چنین
چەنیەنە	چنین
چەو	چو
چەپ	چپ
چەپی	چپی
چەپێ	چپ
چەک	چک
چەکی	چکی
چەکیە	چکی
چەکێ	چک
چەکە	چک
چەڵەمە	چلم
ڕا	را
ڕائدی	رادی
ڕادار	رادار
ڕادیو	رادیو
ڕادیکاڵ	رادیکال
ڕادیکاڵی	رادیکالی
ڕادیۆ	رادیو
ڕادێ	راد
ڕاز	راز
ڕازی	رازی
ڕازیێ	رازی
ڕازێ	راز
ڕازە	راز
ڕازەکێ	رازک
ڕازەیە	رازی
ڕاس	راس
ڕاسا	راسا
ڕاست	راست
ڕاستی	راستی
ڕاستینە	راستین
ڕاستیێ	راستی
ڕاستیە	راستی
ڕاستیەنە	راستین
ڕاستێ	راست
ڕاستە	راست
ڕاسێ	راس
ڕاسە	راس
ڕاسەو	راسو
ڕاسەووێ	راسو
ڕاش	راش
ڕام	رام
ڕان	ران
ڕانمێ	رانم
ڕانکی	رانکی
ڕانیل	رانیل
ڕانیە	رانی
ڕانە	ران
ڕاپۆرت	راپورت
ڕاپۆرتێ	راپورت
ڕاپۆرتە	راپورت
ڕاکێ	راک
ڕای	رای
ڕاینە	راین
ڕایی	رایی
ڕاە	را
ڕجا	رجا
ڕخت	رخت
ڕست	رست
ڕستە	رست
ڕستەنە	رستن
ڕستەی	رستی
ڕسەنێ	رسن
ڕشتەی	رشتی
ڕشید	رشید
ڕشیدی	رشیدی
ڕمان	رمان
ڕمز	رمز
ڕنگ	رنگ
ڕو	رو
ڕوا	روا
ڕوان	روان
ڕوانسەر	روانسر
ڕوانە	روان
ڕوانەی	روانی
ڕوایتی	روایتی
ڕوحی	روحی
ڕوز	روز
ڕوسی	روسی
ڕوشن	روشن
ڕوشنە	روشن
ڕوو	رو
ڕووا	روا
ڕووان	روان
ڕووانە	روان
ڕووبەرو	روبرو
ڕووبەروو	روبرو
ڕووبەرووێ	روبرو
ڕووبەرێ	روبر
ڕووبەرێوی	روبروی
ڕووبەڕوو	روبرو
ڕووبەڕووی	روبروی
ڕووبەڕووێ	روبرو
ڕووسی	روسی
ڕووی	روی
ڕووێ	رو
ڕووێش	روش
ڕووێشەنە	روشن
ڕووە	رو
ڕووەش	روش
ڕوی	روی
ڕوێ	رو
ڕوێو	رو
ڕوێوی	روی
ڕوێوە	رو
ڕوە	رو
ڕوەش	روش
ڕوەو	رو
ڕوەیە	روی
ڕژیمە	رژیم
ڕۆ	رو
ڕۆبێەرت	روبرت
ڕۆبەڕۆ	روبرو
ڕۆح	روح
ڕۆحانی	روحانی
ڕۆحی	روحی
ڕۆحێ	روح
ڕۆحە	روح
ڕۆدی	رودی
ڕۆزگار	روزگار
ڕۆزگاری	روزگاری
ڕۆزگارێ	روزگار
ڕۆزگارە	روزگار
ڕۆشن	روشن
ڕۆشنایی	روشنایی
ڕۆشنگەری	روشنگری
ڕۆشنی	روشنی
ڕۆشنە	روشن
ڕۆشەنە	روشن
ڕۆمانتیسم	رومانتیسم
ڕۆمانێوە	رومانو
ڕۆژانە	روژان
ڕۆی	روی
ڕۆیە	روی
ڕیز	ریز
ڕیزێ	ریز
ڕیش	ریش
ڕیشە	ریش
ڕیشەوە	ریشو
ڕێبە	رب
ڕێخەش	رخش
ڕێز	رز
ڕێزی	رضی
ڕێشە	رش
ڕێنە	رن
ڕێوە	رو
ڕێک	رک
ڕێکێ	رک
ڕێیەوە	ریو
ڕەجەب	رجب
ڕەحم	رحم
ڕەحمان	رحمان
ڕەحمی	رحمی
ڕەحمەت	رحمت
ڕەحمەتی	رحمتی
ڕەحمەنە	رحمن
ڕەحیمی	رحیمی
ڕەختێ	رخت
ڕەدا	ردا
ڕەز	رز
ڕەزا	رزا
ڕەزامەندی	رضامندی
ڕەزایی	رضایی
ڕەزایەت	رضایت
ڕەس	رس
ڕەستە	رست
ڕەسم	رسم
ڕەسول	رسول
ڕەسولی	رسولی
ڕەسەن	رسن
ڕەسەنێ	رسن
ڕەشت	رشت
ڕەشتەن	رشتن
ڕەشید	رشید
ڕەشیدی	رشیدی
ڕەشیدیان	رشیدیان
ڕەفت	رفت
ڕەفعەت	رفعت
ڕەفعەتی	رفعتی
ڕەفیق	رفیق
ڕەقس	رقص
ڕەقیبی	رقیبی
ڕەمز	رمز
ڕەمزی	رمزی
ڕەمەزان	رمضان
ڕەمەزانی	رمضانی
ڕەمەی	رمی
ڕەنج	رنج
ڕەنجی	رنجی
ڕەنگ	رنگ
ڕەنگین	رنگین
ڕەنگینێ	رنگین
ڕەنگینە	رنگین
ڕەنگینەی	رنگینی
ڕەنگیەن	رنگین
ڕەنگێ	رنگ
ڕەنگە	رنگ
ڕەهایی	رهایی
ڕەوا	روا
ڕەوان	روان
ڕەوانسەر	روانسر
ڕەوانشناسی	روانشناسی
ڕەوانی	روانی
ڕەوانێ	روان
ڕەوانە	روان
ڕەوشەن	روشن
ڕەوو	رو
ڕەویەی	رویی
ڕەوە	رو
ڕەوەند	روند
ڕەگ	رگ
ژان	ژان
ژاپنی	ژاپنی
ژاکۆب	ژاکوب
ژن	ژن
ژنێ	ژن
ژنێوو	ژنو
ژنێڤ	ژنو
ژنە	ژن
ژیان	ژیان
ژەرەژێ	ژرژ
ژەن	ژن
ژەنو	ژنو
ژەنێ	ژن
ژەنێوە	ژنو
ژەنە	ژن
ژەنەو	ژنو
ڤلادیمیر	ولادیمیر
ڤیتنامی	ویتنامی
ڤیس	ویس
ڤیەر	ویر
ڤیەرێ	ویر
ڤەداد	وداد
ڤەیسی	ویسی
کابینە	کابین
کات	کات
کاتب	کاتب
کاتۆلیک	کاتولیک
کاتێ	کات
کاتە	کات
کاخ	کاخ
کار	کار
کارا	کارا
کارت	کارت
کارد	کارد
کارم	کارم
کارمەندێ	کارمند
کارمەندە	کارمند
کاره	کاره
کاروان	کاروان
کارڵ	کارل
کارۆلین	کارولین
کاری	کاری
کارێ	کار
کارێل	کارل
کارێم	کارم
کارە	کار
کارەوانی	کاروانی
کارەکێ	کارک
کارەکە	کارک
کارەیە	کاری
کازم	کاظم
کاسێتێ	کاست
کاش	کاش
کاشی	کاشی
کاغەز	کاغذ
کافرێ	کافر
کام	کام
کامل	کامل
کامپو	کامپو
کامڵ	کامل
کامڵی	کاملی
کامیل	کامیل
کامیۆن	کامیون
کامیۆنێ	کامیون
کامە	کام
کامەران	کامران
کانادا	کانادا
کاناڵێ	کانال
کانتۆن	کانتون
کاندیدا	کاندیدا
کانه	کانه
کانی	کانی
کانێ	کان
کانە	کان
کاوەی	کاوی
کاپیتالیستی	کاپیتالیستی
کاکا	کاکا
کاکایی	کاکایی
کاکەیێ	کاکی
کاڵ	کال
کاڵا	کالا
کاڵی	کالی
کاڵێ	کال
کایە	کای
کایەنە	کاین
کتاب	کتاب
کتب	کتب
کتێب	کتب
کتێبی	کتبی
کتێبێ	کتب
کتێبە	کتب
کتە	کت
کران	کران
کرد	کرد
کردار	کردار
کردارێ	کردار
کردن	کردن
کردنە	کردن
کردی	کردی
کردێ	کرد
کردەن	کردن
کرمان	کرمان
کرمانجی	کرمانجی
کرند	کرند
کرندی	کرندی
کرکە	کرک
کرۆن	کرون
کری	کری
کریستیان	کریستیان
کریم	کریم
کریێ	کری
کرێ	کر
کرێمو	کرمو
کرێیێ	کری
کز	کز
کشاورزی	کشاورزی
کشی	کشی
کلارک	کلارک
کلاسیک	کلاسیک
کلاسیکێ	کلاسیک
کلاسیکە	کلاسیک
کلاسیەک	کلاسیک
کلام	کلام
کلدانی	کلدانی
کلسوومە	کلثوم
کلمە	کلم
کلید	کلید
کلیسا	کلیسا
کلیک	کلیک
کلیە	کلی
کلێ	کل
کمال	کمال
کمربند	کمربند
کنیا	کنیا
کنیزک	کنیزک
که	که
کهنە	کهن
کوارە	کوار
کوت	کوت
کوتە	کوت
کود	کود
کودەتا	کودتا
کور	کور
کورش	کورش
کورێ	کور
کورە	کور
کوشان	کوشان
کوشش	کوشش
کوشندە	کوشند
کوشی	کوشی
کوشیێ	کوشی
کوشەندێ	کوشند
کوشەی	کوشی
کون	کون
کونە	کون
کوودەکی	کودکی
کوورش	کورش
کوورێ	کور
کوچک	کوچک
کوچگری	کوچگری
کوچێ	کوچ
کوڕ	کور
کوڕی	کوری
کوڕیە	کوری
کوڕێ	کور
کوڕێش	کورش
کوڕە	کور
کوڕەی	کوری
کوک	کوک
کوڵ	کول
کوڵه	کوله
کوڵی	کولی
کوڵە	کول
کوە	کو
کوەیت	کویت
کڵاشی	کلاشی
کڵاشینکۆفێ	کلاشینکوف
کڵی	کلی
کۆ	کو
کۆبانی	کوبانی
کۆبانێ	کوبان
کۆبانێی	کوبانی
کۆبیێ	کوبی
کۆبیە	کوبی
کۆت	کوت
کۆر	کور
کۆسە	کوس
کۆشا	کوشا
کۆشان	کوشان
کۆشانە	کوشان
کۆشش	کوشش
کۆشکی	کوشکی
کۆشکێ	کوشک
کۆشیەمێ	کوشیم
کۆمار	کومار
کۆمارێ	کومار
کۆمارە	کومار
کۆن	کون
کۆنێ	کون
کۆنە	کون
کۆچ	کوچ
کۆچی	کوچی
کۆچەک	کوچک
کۆچەکەی	کوچکی
کۆڕ	کور
کۆڕی	کوری
کۆڕێ	کور
کۆکێ	کوک
کۆڵ	کول
کۆڵە	کول
کۆی	کوی
کۆیلێ	کویل
کۆیە	کوی
کی	کی
کیاست	کیاست
کیاستێ	کیاست
کیاستە	کیاست
کیانا	کیانا
کیانووش	کیانوش
کیانیان	کیانیان
کیش	کیش
کیلۆمەتر	کیلومتر
کیلۆمەترێ	کیلومتر
کیمیا	کیمیا
کیمیاوی	کیمیاوی
کیمیاویە	کیمیاوی
کیمیایی	کیمیایی
کیمەت	کیمت
کین	کین
کیو	کیو
کیپ	کیپ
کیۆ	کیو
کێسە	کس
کێش	کش
کێشتی	کشتی
کێشتێ	کشت
کێشتەن	کشتن
کێشتەیم	کشتیم
کێشۆ	کشو
کێشێ	کش
کێشە	کش
کێشەش	کشش
کێشەو	کشو
کێشەکە	کشک
کێشەکەی	کشکی
کێشەی	کشی
کێشەیە	کشی
کێلێ	کل
کێماسی	کماسی
کێن	کن
کێنێ	کن
کێنە	کن
کەئی	کی
کەئیسە	کیس
کەت	کت
کەجە	کج
کەجەکەی	کجکی
کەد	کد
کەر	کر
کەرامەت	کرامت
کەرامەتی	کرامتی
کەرامەتە	کرامت
کەران	کران
کەرانێ	کران
کەرانە	کران
کەربەلا	کربلا
کەرج	کرج
کەرد	کرد
کەردار	کردار
کەردن	کردن
کەردی	کردی
کەردیدێ	کردید
کەردێ	کرد
کەردێم	کردم
کەردێن	کردن
کەردێنێ	کردن
کەردێنە	کردن
کەردێێ	کرد
کەردە	کرد
کەردەن	کردن
کەردەنێ	کردن
کەردەنە	کردن
کەردەی	کردی
کەردەیە	کردی
کەردەێ	کرد
کەردەێنێ	کردن
کەرموو	کرمو
کەرمێ	کرم
کەرمێوە	کرمو
کەرمەی	کرمی
کەرون	کرون
کەرکوک	کرکوک
کەرۆن	کرون
کەرۆنە	کرون
کەری	کری
کەریم	کریم
کەریمی	کریمی
کەریێ	کری
کەرێ	کر
کەرێنا	کرنا
کەرە	کر
کەرەدن	کردن
کەرەستێ	کرست
کەرەسێ	کرس
کەرەسە	کرس
کەرەسەی	کرسی
کەرەمی	کرمی
کەس	کس
کەسانی	کسانی
کەسانەی	کسانی
کەسرەی	کسری
کەسما	کسما
کەسی	کسی
کەسیێ	کسی
کەسیە	کسی
کەسێ	کس
کەسێما	کسما
کەسە	کس
کەسەر	کسر
کەسەیە	کسی
کەش	کش
کەشتی	کشتی
کەشف	کشف
کەشو	کشو
کەشوو	کشو
کەشکۆڵی	کشکولی
کەشی	کشی
کەشێ	کش
کەشە	کش
کەشەکێ	کشک
کەشەکەی	کشکی
کەفالەت	کفالت
کەفەر	کفر
کەل	کل
کەلاس	کلاس
کەلاسە	کلاس
کەلام	کلام
کەلامی	کلامی
کەلرە	کلر
کەلمە	کلم
کەلو	کلو
کەلوو	کلو
کەلک	کلک
کەلیمە	کلیم
کەلیمەی	کلیمی
کەلێمێ	کلم
کەلەرە	کلر
کەم	کم
کەما	کما
کەمال	کمال
کەمان	کمان
کەماڵ	کمال
کەمترین	کمترین
کەمتەر	کمتر
کەمتەرین	کمترین
کەمتەرێ	کمتر
کەمپین	کمپین
کەمپینێ	کمپین
کەمپێوو	کمپو
کەمپەین	کمپین
کەمڕەنگ	کمرنگ
کەمی	کمی
کەمیابێ	کمیاب
کەمیابە	کمیاب
کەمین	کمین
کەمینێ	کمین
کەمینە	کمین
کەمێ	کم
کەمە	کم
کەمەتەرین	کمترین
کەمەر	کمر
کەمەرە	کمر
کەمەند	کمند
کەن	کن
کەنار	کنار
کەنشت	کنشت
کەنەی	کنی
کەهەن	کهن
کەوت	کوت
کەوتێ	کوت
کەوتە	کوت
کەپسولێ	کپسول
کەڕ	کر
کەڕت	کرت
کەڕەت	کرت
کەڕەتێ	کرت
کەڕەتە	کرت
کەڵام	کلام
کەڵو	کلو
کەڵک	کلک
کەڵکی	کلکی
کەڵکە	کلک
کەڵە	کل
کەی	کی
کەیانی	کیانی
کەیانیان	کیانیان
کەیل	کیل
کەین	کین
کەینە	کین
کەیهان	کیهان
کەیو	کیو
کەیوان	کیوان
کەیوانی	کیوانی
گابریەل	گابریل
گارەی	گاری
گازی	گازی
گازیێ	گازی
گازێ	گاز
گازە	گاز
گاو	گاو
گر	گر
گرافیک	گرافیک
گرامەر	گرامر
گران	گران
گرانش	گرانش
گرانی	گرانی
گرانەم	گرانم
گرد	گرد
گردش	گردش
گردو	گردو
گردوو	گردو
گردگیر	گردگیر
گردی	گردی
گردیێ	گردی
گردێ	گرد
گردە	گرد
گرسنگی	گرسنگی
گرفت	گرفت
گرفتار	گرفتار
گرفتارێ	گرفتار
گرفتن	گرفتن
گرفتی	گرفتی
گرفتێ	گرفت
گرفتە	گرفت
گرفتەی	گرفتی
گرم	گرم
گرمی	گرمی
گرووپە	گروپ
گروپێ	گروپ
گروپە	گروپ
گروە	گرو
گرێ	گر
گزاشتن	گذاشتن
گستره	گستره
گسێی	گسی
گشت	گشت
گشتی	گشتی
گفت	گفت
گفتن	گفتن
گفتند	گفتند
گل	گل
گلک	گلک
گلکە	گلک
گلۆبال	گلوبال
گلێرێ	گلر
گلەیێ	گلی
گم	گم
گمێ	گم
گمە	گم
گه	گه
گورە	گور
گوس	گوس
گوش	گوش
گوشت	گوشت
گوشه	گوشه
گوشە	گوش
گول	گول
گون	گون
گونه	گونه
گونەش	گونش
گونەی	گونی
گووتی	گوتی
گوڕ	گور
گوڵ	گول
گوڵێ	گول
گوڵە	گول
گویش	گویش
گڕوو	گرو
گڕوێ	گرو
گڕی	گری
گڵە	گل
گۆش	گوش
گۆشتان	گوشتان
گۆشی	گوشی
گۆشێ	گوش
گۆشە	گوش
گۆشەی	گوشی
گۆڕ	گور
گۆڕستانێ	گورستان
گۆڕە	گور
گۆڕەکانیان	گورکانیان
گیر	گیر
گیرا	گیرا
گیریێ	گیری
گیرێ	گیر
گیلان	گیلان
گیو	گیو
گیوم	گیوم
گێتە	گت
گێرا	گرا
گێردێ	گرد
گێردێش	گردش
گێرمێ	گرم
گێرمە	گرم
گێرو	گرو
گێرگەی	گرگی
گێرۆ	گرو
گێری	گری
گێریێنێرە	گرینر
گێرە	گر
گێڕمێ	گرم
گێڵۆە	گلو
گێڵی	گلی
گێڵێنێ	گلن
گێڵەنە	گلن
گەدا	گدا
گەر	گر
گەرد	گرد
گەردش	گردش
گەردن	گردن
گەردو	گردو
گەردوون	گردون
گەردی	گردی
گەردە	گرد
گەردەن	گردن
گەرم	گرم
گەرما	گرما
گەرمی	گرمی
گەرمێ	گرم
گەرمە	گرم
گەرو	گرو
گەرگی	گرگی
گەرگەر	گرگر
گەرگەری	گرگری
گەری	گری
گەز	گز
گەزیە	گزی
گەزەن	گزن
گەشت	گشت
گەشتی	گشتی
گەل	گل
گەلو	گلو
گەلوو	گلو
گەلی	گلی
گەلیەنە	گلین
گەلێ	گل
گەلە	گل
گەلەکێ	گلک
گەمە	گم
گەنج	گنج
گەنجانی	گنجانی
گەنجی	گنجی
گەنجێ	گنج
گەنجێوی	گنجوی
گەنجە	گنج
گەنێ	گن
گەورێ	گور
گەورە	گور
گەورەکان	گورکان
گەورەکێنە	گورکن
گەورەی	گوری
گەورەیە	گوری
گەورەێ	گور
گەوهەریە	گوهری
گەوەرێ	گور
گەڕ	گر
گەڕان	گران
گەڕوسی	گروسی
گەڤەر	گور
گەڤەری	گوری
گەڵابێ	گلاب
گەڵوە	گلو
گەیەڵان	گیلان
گەیەڵانی	گیلانی
ڵات	لات
ڵام	لام
ۆ	و
یا	یا
یاد	یاد
یادگاری	یادگاری
یادێ	یاد
یادە	یاد
یار	یار
یارا	یارا
یاران	یاران
یارانێ	یاران
یاری	یاری
یاسا	یاسا
یاساێ	یاسا
یاسر	یاسر
یاسری	یاسری
یاسین	یاسین
یاسێ	یاس
یاسەمی	یاسمی
یاشار	یاشار
یام	یام
یانەکەی	یانکی
یاوەری	یاوری
یحیی	یحیی
یوسف	یوسف
یوسفی	یوسفی
یون	یون
یونان	یونان
یونانی	یونانی
یونس	یونس
یونسکۆ	یونسکو
یووسف	یوسف
یوونانیان	یونانیان
یوەم	یوم
یوەمە	یوم
یک	یک
یکی	یکی
یۆرش	یورش
یۆم	یوم
یۆن	یون
یۆنان	یونان
یۆنانی	یونانی
یۆنێ	یون
یۆنە	یون
یۆهان	یوهان
یەخبەندان	یخبندان
یەدی	یدی
یەزدان	یزدان
یەزدانی	یزدانی
یەزدی	یزدی
یەعقوب	یعقوب
یەقین	یقین
یەمەن	یمن
یەواش	یواش
یەوەنە	یون
یەک	یک
یەکدەست	یکدست
یەکسان	یکسان
یەکسانی	یکسانی
یەکسەر	یکسر
یەکڕەنگ	یکرنگ
یەکی	یکی
یەکەم	یکم
یەکەمین	یکمین
یەکەمێ	یکم
یەگانە	یگان
ەوە	و