ئا	آ
ئاباد	آباد
ئابو	آبو
ئابی	آبي
ئابیەنە	آبين
ئات	آت
ئاتران	اطرآن
ئاخ	آخ
ئاخر	آخر
ئاخرش	اخرش
ئاخرە	آخر
ئاخور	اخور
ئاخۆ	اخو
ئاخێز	آخذ
ئاخێزی	آخذي
ئاخێزێ	آخذ
ئاخێزە	آخذ
ئاداب	آداب
ئادو	ادو
ئادوە	ادو
ئادەم	آدم
ئادەمنە	ادمن
ئادەن	ادن
ئار	آر
ئارام	آرام
ئارامی	آرامي
ئارد	ارد
ئاردێنێ	اردن
ئاردە	ارد
ئاردەن	اردن
ئاردەنە	اردن
ئاردەی	اردي
ئاردەینە	اردين
ئارسلان	ارسلان
ئارمی	آرمي
ئاروین	اروين
ئارۆ	ارو
ئارۆئینە	اروين
ئارۆنە	ارون
ئارۆی	اروي
ئارۆینە	اروين
ئارۆیەن	اروين
ئارۆیەنە	اروين
ئاری	آري
ئارین	آرين
ئاریە	آري
ئاریەن	آرين
ئارێز	ارض
ئارێنێ	ارن
ئارەب	آرب
ئارەبی	اربي
ئارەقە	آرق
ئازا	آضا
ئازار	آذار
ئازارێ	آذار
ئازارە	آذار
ئازیێنێ	آذين
ئازێ	آض
ئازەر	آزر
ئازەری	آذري
ئاساڵێ	آصال
ئاست	اسط
ئاستو	استو
ئاستوو	استو
ئاستوە	استو
ئاستی	اسطي
ئاستێ	اسط
ئاستێنێ	اسطن
ئاستێنە	اسطن
ئاستێوی	استوي
ئاستێوە	استو
ئاستێک	اصطك
ئاستێکی	اصطكي
ئاستە	اسط
ئاستەن	اسطن
ئاستەنە	اسطن
ئاستەکانە	اصطكان
ئاستەی	اسطي
ئاسمان	آثمان
ئاسمانە	آثمان
ئاسن	آسن
ئاسنی	اثني
ئاسنین	اثنين
ئاسهی	اسهي
ئاسو	اثو
ئاسودە	اسود
ئاسوری	اصوري
ئاسوودە	اسود
ئاسوودەئی	اسودي
ئاسڵەنە	آصلن
ئاسۆ	اثو
ئاسۆس	اسوس
ئاسۆیە	اثوي
ئاسیا	آسيا
ئاسین	آسين
ئاشت	اشت
ئاشتی	اشتي
ئاشتیە	اشتي
ئاشتێ	اشت
ئاشنا	اشنآ
ئاشنان	اشنآن
ئاشوری	آشوري
ئاشکر	اشكر
ئاشکرا	اشكرا
ئاشکران	اشكران
ئاشکراێ	اشكرا
ئاشکرێ	اشكر
ئاشەوە	اشو
ئافڕیێنێ	افرين
ئال	آل
ئام	آم
ئامادێ	آماد
ئامادێێ	آماد
ئامادە	آماد
ئامینێ	آمين
ئامینە	آمين
ئامێ	آم
ئامێتێ	امط
ئامێتە	امط
ئامێدی	آمدي
ئامێرێ	آمر
ئامێنا	آمنا
ئامێنی	آمني
ئامێنێ	آمن
ئامێنێنە	امنن
ئامێنە	آمن
ئامەد	آمد
ئامەدی	آمدي
ئامەینێ	آمين
ئان	آن
ئاندە	اند
ئانز	آنض
ئانزان	آنضان
ئانزانێ	آنضان
ئاننە	آنن
ئانه	انه
ئانوو	انو
ئانیە	آني
ئانێ	آن
ئانێشە	انش
ئانێنێ	آنن
ئانێنە	آنن
ئانێو	انو
ئانە	آن
ئانەبێ	انب
ئانەش	انش
ئانەشا	انشآ
ئانەشانە	انشآن
ئانەشە	انش
ئانەن	آنن
ئانەنە	آنن
ئانەهەر	انهر
ئانەکە	انك
ئانەی	آني
ئانەین	آنين
ئانەینە	آنين
ئانەیە	آني
ئانەیەنێ	آنين
ئانەیەنە	آنين
ئاه	آه
ئاو	آو
ئاومێنە	اومن
ئاوی	آوي
ئاوێ	آو
ئاوێنە	آون
ئاوێوە	آو
ئاوە	آو
ئاوەو	آو
ئاڕ	آر
ئاڕتی	ارتي
ئاڕوە	ارو
ئاڕۆ	ارو
ئاڕۆیە	اروي
ئاکام	آكام
ئاکتۆ	اكتو
ئاکرێ	آكر
ئاکرێن	آكرن
ئاکرێیەنە	اكرين
ئاکو	اكو
ئاکەس	اكس
ئاکەسی	اكسي
ئاکەسینە	اكسين
ئاکەسیە	اكسي
ئاکەسێ	اكس
ئاڵف	آلف
ئاڵمان	آلمان
ئاڵێ	آل
ئای	آي
ئایتن	ايتن
ئایتەنێ	ايتن
ئایتەنە	ايتن
ئایر	اير
ئایری	ايري
ئایرەی	ايري
ئایە	آي
ئاە	آ
ئبراق	براق
ئتر	طر
ئتمیز	تميز
ئجۆر	جور
ئدلب	دلب
ئزمیر	ضمير
ئعلان	علان
ئقباڵ	قبال
ئلوس	لوث
ئنسانێ	نصان
ئننە	نن
ئنە	ن
ئه	ه
ئو	و
ئورفا	ورفا
ئورفە	ورف
ئورمیە	ورمي
ئوسا	وصا
ئوستانێ	وسطان
ئوسن	وثن
ئوشیا	وشيا
ئوما	وما
ئومێد	ومد
ئومێنێ	ومن
ئوو	و
ئووتی	وتي
ئووسامە	وسام
ئۆ	و
ئۆجال	وجال
ئۆرەک	ورك
ئۆزان	وذان
ئۆزەر	وزر
ئۆزەن	وزن
ئۆف	وف
ئۆمێدە	ومد
ئۆمێنێ	ومن
ئۆوردەن	ووردن
ئی	ي
ئیبسن	يبسن
ئیتر	يطر
ئیجاب	يجاب
ئیجار	يجار
ئیجاریە	يجاري
ئیجارە	يجار
ئیجارەیەنە	يجارين
ئیجازە	يجاز
ئیجازەی	يجازي
ئیحسان	يحصان
ئیداری	يداري
ئیداریێ	يداري
ئیدارە	يدار
ئیدارەن	يدارن
ئیدارەکە	يدارك
ئیدارەی	يداري
ئیدارەیا	يداريا
ئیدارەیە	يداري
ئیدانە	يدان
ئیدر	يدر
ئیدری	يدري
ئیدریەن	يدرين
ئیدی	يدي
ئیرادە	يراد
ئیرادەن	يرادن
ئیراق	يراق
ئیراقنە	يراقن
ئیران	يران
ئیراننە	يرانن
ئیریەن	يرين
ئیزافە	يزاف
ئیزیدیە	يزيدي
ئیساس	يساس
ئیساق	يساق
ئیساقی	يساقي
ئیستە	يسط
ئیسفەهان	يسفهان
ئیسکان	يسكان
ئیسۆ	يصو
ئیسیێ	يسي
ئیسە	يس
ئیسەتێوە	يسطو
ئیسەن	يصن
ئیسەنە	يصن
ئیسەو	يصو
ئیسەولا	يسولا
ئیسەی	يسي
ئیسەیرە	يسير
ئیسەینە	يسين
ئیسەیە	يسي
ئیسەیەنە	يسين
ئیش	يش
ئیشارە	يشار
ئیشارەی	يشاري
ئیشک	يشك
ئیشێ	يش
ئیشە	يش
ئیشەوی	يشوي
ئیعلان	يعلان
ئیلا	يلا
ئیلام	يلام
ئیلان	يلان
ئیلهان	يلهان
ئیلیزێ	يليذ
ئیمام	يمام
ئیمان	يمان
ئیمانی	يماني
ئیمزا	يمضا
ئیمزێ	يمض
ئیمە	يم
ئیمەن	يمن
ئیمەنە	يمن
ئینارە	ينار
ئیناش	يناش
ئینایر	يناير
ئینجا	ينجآ
ئینجە	ينج
ئینسان	ينصان
ئینسانێ	ينصان
ئینسانە	ينصان
ئینه	ينه
ئینی	يني
ئینێ	ين
ئینێرە	ينر
ئینێشە	ينش
ئینێنێ	ينن
ئینێنە	ينن
ئینە	ين
ئینەتا	ينتا
ئینەشا	ينشا
ئینەشان	ينشان
ئینەشانە	ينشان
ئینەشە	ينش
ئینەمان	ينمان
ئینەن	ينن
ئینەنە	ينن
ئینەو	ينو
ئینەی	يني
ئینەیە	يني
ئیوەرو	يورو
ئیڤار	يوار
ئیڤری	يوري
ئیێن	ين
ئیێنێ	ين
ئیەنەفرە	ينفر
ئێای	آي
ئێتر	طر
ئێحساس	حساس
ئێحسان	حسان
ئێخڵاق	خلاق
ئێدامە	دام
ئێدی	دي
ئێدێعاێ	دعا
ئێر	ر
ئێراق	راق
ئێراقنە	راقن
ئێراقی	راقي
ئێراقیێ	راقي
ئێراقیە	راقي
ئێراقەنە	راقن
ئێران	ران
ئێرانێ	ران
ئێردا	ردا
ئێرس	رث
ئێرشاد	رشاد
ئێرشان	رشان
ئێرشی	رشي
ئێرو	رو
ئێریەن	رين
ئێرە	ر
ئێرەکە	رك
ئێرەکەی	ركي
ئێزدی	ضدي
ئێزدیێ	ضدي
ئێزیدی	زيدي
ئێزیدیێ	زيدي
ئێزیدێ	زيد
ئێس	ث
ئێسامی	سامي
ئێساڵ	سال
ئێساڵی	صالي
ئێستا	سطا
ئێستەی	سطي
ئێسە	ث
ئێش	ش
ئێشارە	شار
ئێشان	شان
ئێشای	شاي
ئێشێ	ش
ئێشێوش	شوش
ئێشە	ش
ئێشەو	شو
ئێشەکا	شكا
ئێلح	لح
ئێلحی	لحي
ئێلی	لي
ئێم	م
ئێملی	ملي
ئێمه	مه
ئێمە	م
ئێمەش	مش
ئێمەن	من
ئێمەنە	من
ئێمەوه	موه
ئێمەی	مي
ئێن	ن
ئێنرە	نر
ئێنسان	نصان
ئێننە	نن
ئێنە	ن
ئێوارەی	واري
ئێوە	و
ئێڕشاد	رشاد
ئەئا	آ
ئەئوونەنە	ونن
ئەئی	ي
ئەئیسه	يسه
ئەئیسە	يس
ئەئیسەیە	يسي
ئەئینە	ين
ئەئینەنە	ينن
ئەبری	بري
ئەبلێی	بلي
ئەبەد	بد
ئەت	ت
ئەتلەسینە	تلسين
ئەتەش	طش
ئەجناد	جناد
ئەجندا	جندا
ئەجندێ	جند
ئەجنەبی	جنبي
ئەجیێشان	جيشان
ئەجێ	ج
ئەجێش	جش
ئەجێم	جم
ئەجەل	جل
ئەجەندا	جندا
ئەجەوید	جويد
ئەحرار	حرار
ئەحسەن	حصن
ئەحمەد	حمد
ئەحمەدی	حمدي
ئەحواڵێ	حوال
ئەحەمەد	حمد
ئەخلاق	خلاق
ئەخلاقێ	خلاق
ئەخڵات	خلاط
ئەدا	دآ
ئەداو	داو
ئەداک	داك
ئەدبی	دبي
ئەدیب	ديب
ئەدیبان	ديبان
ئەدیبێ	ديب
ئەدیبە	ديب
ئەدەب	دب
ئەدەبی	دبي
ئەدەبیێ	دبي
ئەدەبیە	دبي
ئەدەنە	دن
ئەدەنەی	دني
ئەر	ر
ئەرتان	رطان
ئەرجان	رجان
ئەردە	رد
ئەردەم	ردم
ئەردەن	ردن
ئەرسین	رصين
ئەرمانێ	رمان
ئەرک	رك
ئەرکا	ركا
ئەرکان	ركان
ئەرکو	ركو
ئەرکوو	ركو
ئەرکی	ركي
ئەرکیە	ركي
ئەرکێ	رك
ئەرکێکی	رككي
ئەرکە	رك
ئەرکەن	ركن
ئەرکەکەیە	رككي
ئەرکەیە	ركي
ئەرۆڵ	رول
ئەرێ	ر
ئەرێنی	رني
ئەرێنیێ	رني
ئەرێنیێنێ	رنين
ئەرێنیە	رني
ئەرەمەزیێ	رمزي
ئەرەن	رن
ئەرەنیا	رنيا
ئەرەنیانە	رنيان
ئەرەک	رك
ئەرەی	ري
ئەز	ذ
ئەزهەری	ظهري
ئەزکیا	ذكيا
ئەزەغ	زغ
ئەزەڵەنە	زلن
ئەسارا	سارا
ئەسارەت	سارت
ئەسان	سان
ئەساوە	صاو
ئەستۆ	سطو
ئەستۆنە	ستون
ئەستێرەی	سطري
ئەستەر	ستر
ئەسرا	صرا
ئەسعە	سع
ئەسعەد	صعد
ئەسفەهان	سفهان
ئەسلوو	سلو
ئەسلەن	صلن
ئەسمەر	ثمر
ئەسناد	سناد
ئەسنیێنێ	سنين
ئەسکەنەن	سكنن
ئەسڵ	سل
ئەسڵان	صلان
ئەسڵو	سلو
ئەسڵوو	سلو
ئەسڵی	صلي
ئەسڵەن	صلن
ئەسڵەنە	صلن
ئەسیدا	سيدا
ئەسیر	سير
ئەسێنە	سن
ئەسەدی	ثدي
ئەسەرا	صرا
ئەش	ش
ئەشرەف	شرف
ئەشق	شق
ئەشقی	شقي
ئەشقیە	شقي
ئەشکان	شكان
ئەشۆم	شوم
ئەشیا	شيآ
ئەعزەمی	عظمي
ئەغڵەب	غلب
ئەفرادێ	فراد
ئەفسانە	فصان
ئەفسەر	فسر
ئەفسەری	فسري
ئەفسەرێ	فسر
ئەفسەرە	فسر
ئەقڵ	قل
ئەقڵو	قلو
ئەقڵی	قلي
ئەقڵین	قلين
ئەقڵە	قل
ئەل	ل
ئەلحەق	لحق
ئەلحەقا	لحقا
ئەلحەقێ	لحق
ئەلسانی	لساني
ئەلف	لف
ئەلک	لك
ئەلیت	ليت
ئەلیزێ	ليذ
ئەلێ	ل
ئەم	م
ئەمرە	مر
ئەمشێ	مش
ئەمن	من
ئەمنی	مني
ئەمنیێ	مني
ئەمنیە	مني
ئەمنە	من
ئەمنەنە	منن
ئەمڕۆ	مرو
ئەمڕۆی	مروي
ئەمیر	مير
ئەمیرێ	مير
ئەمە	م
ئەمەدی	مدي
ئەمەش	مش
ئەنارە	نار
ئەنبارنە	نبارن
ئەنباری	نباري
ئەنجو	نجو
ئەنجومنێ	نجومن
ئەنجومەن	نجومن
ئەنجومەنێ	نجومن
ئەنجومەنە	نجومن
ئەنجوومەنێ	نجومن
ئەنجۆمەنە	نجومن
ئەندام	ندام
ئەندامێ	ندام
ئەندامێنێ	ندامن
ئەندامە	ندام
ئەندامەن	ندامن
ئەندە	ند
ئەنسار	نثار
ئەنساری	نساري
ئەنفال	نفال
ئەنقسەت	نقسط
ئەنقەرە	نقر
ئەنقەرەی	نقري
ئەنقەست	نقسط
ئەنقەڕە	نقر
ئەننام	ننام
ئەنوارە	نوار
ئەنوەر	نور
ئەنی	ني
ئەنە	ن
ئەنەکەسە	نكث
ئەنەکەسەوە	نكسو
ئەنەکەسەیە	نكسي
ئەها	ها
ئەهل	هل
ئەهلی	هلي
ئەهلیێ	هلي
ئەهواز	هواز
ئەو	و
ئەوتەر	وتر
ئەوسا	وصا
ئەوستانە	وسطان
ئەولا	ولا
ئەوی	وي
ئەویە	وي
ئەوێ	و
ئەوێستا	وسطا
ئەوە	و
ئەوەجا	وجا
ئەوەجانێ	وجان
ئەوەجێ	وج
ئەوەجێنێ	وجن
ئەوەجە	وج
ئەوەجەما	وجما
ئەوەجەن	وجن
ئەوەجەی	وجي
ئەوەجەیە	وجي
ئەوەش	وش
ئەوەشی	وشي
ئەوەل	ول
ئەوەمەنەکێ	ومنك
ئەوەڵ	ول
ئەوەڵو	ولو
ئەوەڵوو	ولو
ئەوەڵۆ	ولو
ئەوەڵین	ولين
ئەوەڵینە	ولين
ئەوەی	وي
ئەوەیە	وي
ئەڕفان	رفان
ئەڕکەی	ركي
ئەڤرەن	ورن
ئەڤین	وين
ئەکتی	كتي
ئەکتەی	كتي
ئەکید	كيد
ئەکین	كين
ئەکەرەم	كرم
ئەکەم	كم
ئەڵبەت	لبط
ئەڵبەتە	لبط
ئەڵماس	لماس
ئەڵکان	لكان
ئەی	ي
ئەیلەم	يلم
ئەیمەن	يمن
ئەیهان	يهان
احمد	احمد
ارس	ارس
ارش	ارش
از	آض
اساس	آساس
است	اسط
اسم	اسم
اشک	اشك
الام	آلام
الحیاە	الحيا
الله	الله
الیە	آلي
امد	آمد
امین	آمين
ان	آن
اند	اند
انەکان	انكآن
اهل	آهل
اکبری	اكبري
ای	آي
اید	ايد
ایدن	ايدن
بئاش	باش
باب	باب
بابا	بابا
بابلی	بابلي
بابور	بابور
بابە	باب
باتڵ	باطل
باخ	باخ
باخا	باخا
باخە	باخ
بادیان	باديان
بادینان	بادينان
بار	بار
بارزان	بارزان
بارمێ	بارم
باری	باري
باریت	باريت
بارینە	بارين
بارێ	بار
بارێی	باري
بارە	بار
بارەت	بارت
بارەنە	بارن
بارەکێ	بارك
باز	باز
بازا	باضا
بازار	بازار
بازارێ	بازار
بازێ	باز
باس	باس
باستان	باسطان
باسل	باسل
باسم	باسم
باسێ	باص
باسێێ	باص
باسە	باص
باسەکە	باسك
باسەکەی	باسكي
باش	باش
باشە	باش
باعێس	باعث
باقی	باقي
بال	بال
بالا	بالا
بالی	بالي
بان	بان
بانێ	بان
بانێی	باني
بانە	بان
باک	باك
باکور	باكور
باڵا	بالا
باڵاو	بالاو
باڵی	بالي
باڵە	بال
باڵەنە	بالن
بت	بت
بخاری	بخاري
بخرێتە	بخرت
بخەنە	بخن
بدا	بدا
بدان	بدان
بدانێ	بدان
بدانە	بدان
بدونە	بدون
بدۆ	بدو
بدۆنە	بدون
بدە	بد
بدەن	بدن
بدەنێ	بدن
بدەورە	بدور
بدەی	بدي
بدەین	بدين
برا	برا
برای	براي
برایا	برايا
برایێ	براي
برایە	براي
برق	برق
برقی	برقي
برۆکسل	بروكسل
بریا	بريا
برینێ	برين
بریێ	بري
بریێنێ	برين
بریێنە	برين
برێ	بر
برێنێ	برن
بزانە	بضان
بزوەڕە	بذور
بزی	بذي
بزە	بض
بزەی	بذي
بشا	بشا
بشان	بشان
بشانە	بشان
بشە	بش
بغداد	بغداد
بلا	بلا
بلانە	بلان
بلبلێی	بلبلي
بلمێ	بلم
بلو	بلو
بلوغ	بلوغ
بلوو	بلو
بلووت	بلوط
بلوودێ	بلود
بلوونە	بلون
بلوە	بلو
بلۆ	بلو
بلۆنە	بلون
بلۆک	بلوك
بلۆکێ	بلوك
بلۆکە	بلوك
بلۊ	بلو
بلی	بلي
بلینە	بلين
بلێ	بل
بلە	بل
بلەی	بلي
بن	بن
بنا	بنا
بنج	بنج
بنجە	بنج
بنکێ	بنك
بنکە	بنك
بنیا	بنيا
بنیانێ	بنيان
بنە	بن
بنەما	بنما
بنەماێ	بنما
بنەو	بنو
بنەوا	بنوا
بنەی	بني
به	به
بهار	بهار
بهانە	بهان
بهجت	بهجت
بواری	بواري
بوارێ	بوار
بوارە	بوار
بوارەیە	بواري
بودی	بودي
بوزی	بوذي
بوش	بوش
بونە	بون
بوون	بون
بوونە	بون
بوڵە	بول
بوێوەنە	بون
بوەری	بوري
بوەرە	بور
بوەم	بوم
بڕ	بر
بڕشان	برشان
بڕۆکسێل	بروكسل
بڕی	بري
بڕیا	بريا
بڕین	برين
بڕیێنێ	برين
بڕیێنە	برين
بڕیە	بري
بڕیەم	بريم
بڕێ	بر
بڕە	بر
بڕەی	بري
بکر	بكر
بکرانە	بكران
بکرێت	بكرت
بکرێنێ	بكرن
بکرێنە	بكرن
بکی	بكي
بکەر	بكر
بکەرا	بكرا
بکەران	بكران
بکەرانێ	بكران
بکەرانە	بكران
بکەری	بكري
بکەرێنە	بكرن
بکەرە	بكر
بکەرەن	بكرن
بکەن	بكن
بکەین	بكين
بکەێ	بك
بڵی	بلي
بڵێم	بلم
بڵێین	بلين
بۆتان	بوتان
بۆر	بور
بۆرێ	بور
بۆرە	بور
بۆسنە	بوسن
بۆسە	بوس
بۆنێ	بون
بۆنە	بون
بۆنەی	بوني
بۆڵەی	بولي
بی	بي
بیانێ	بيان
بیت	بيت
بیدێ	بيد
بیدێنە	بيدن
بیر	بير
بیرێ	بير
بیرە	بير
بیس	بيص
بیست	بيست
بین	بين
بینۆ	بينو
بینی	بيني
بینێ	بين
بینێنێ	بينن
بینە	بين
بینەن	بينن
بینەو	بينو
بیڕێ	بير
بیێ	بي
بیێبانە	بيبان
بیێن	بين
بیێنا	بينا
بیێنه	بينه
بیێنی	بيني
بیێنێ	بين
بیێنێوە	بينو
بیێنە	بين
بیێنەو	بينو
بیێنەوە	بينو
بیێە	بي
بیە	بي
بیەبانە	بيبان
بیەن	بين
بیەنا	بينا
بیەنوە	بينو
بیەنۆ	بينو
بیەنێ	بين
بیەنەو	بينو
بیەنەوە	بينو
بێ	ب
بێت	بط
بێتاتە	بتات
بێدڵانە	بدلان
بێدێ	بد
بێدەر	بدر
بێرە	بر
بێزار	بذار
بێزارێ	بذار
بێسەران	بصران
بێسەرێ	بسر
بێمێ	بم
بێمێنە	بمن
بێن	بن
بێنا	بنا
بێنان	بنان
بێنی	بني
بێنێ	بن
بێنێما	بنما
بێنێوە	بنو
بێنە	بن
بێوادەی	بوادي
بێوێنەی	بوني
بێڕێزی	برزي
بێڕێزیە	برزي
بێڵ	بل
بێڵێ	بل
بێڵەی	بلي
بێیەنێ	بين
بێیەنەوە	بينو
بێێ	ب
بە	ب
بەان	بان
بەت	بط
بەتاڵ	بطال
بەتول	بتول
بەتڵان	بطلان
بەتین	بتين
بەتەر	بتر
بەحرەین	بحرين
بەحەر	بحر
بەختە	بخت
بەد	بد
بەدان	بدان
بەدر	بدر
بەدوور	بدور
بەدووە	بدو
بەدڵ	بدل
بەدی	بدي
بەدیعە	بديع
بەدیل	بديل
بەدیلێ	بديل
بەدیێ	بدي
بەدەر	بدر
بەدەرێ	بدر
بەدەل	بدل
بەدەن	بدن
بەر	بر
بەرا	برا
بەرابەر	برابر
بەرازیل	برازيل
بەران	بران
بەرانێ	بران
بەرانە	بران
بەربەر	بربر
بەرتا	برتا
بەرد	برد
بەردا	بردا
بەردن	بردن
بەردی	بردي
بەردێ	برد
بەردێنێ	بردن
بەردێنە	بردن
بەردە	برد
بەردەن	بردن
بەردەی	بردي
بەردەێنە	بردن
بەرز	برز
بەرزا	برزا
بەرزان	برزان
بەرزنە	برزن
بەرزی	برزي
بەرزێ	برز
بەرزە	برز
بەرزەن	برزن
بەرزەنە	برزن
بەرش	برش
بەرشا	برشا
بەرشێنە	برشن
بەرلین	برلين
بەرمێ	برم
بەرمێنە	برمن
بەرهەمی	برهمي
بەرهەمەیە	برهمي
بەروزا	بروزا
بەرکی	بركي
بەری	بري
بەریتانی	بريطاني
بەریتانیا	بريطانيا
بەریتانیێ	بريطاني
بەرینێ	برين
بەرێ	بر
بەرێنێ	برن
بەرێنە	برن
بەرە	بر
بەرەنە	برن
بەرەکێ	برك
بەرەکە	برك
بەرەکەی	بركي
بەرەی	بري
بەزری	بذري
بەزل	بذل
بەزم	بزم
بەزمێ	بزم
بەزمە	بزم
بەزنان	بضنان
بەزۆر	بذور
بەزیێ	بذي
بەسات	بساط
بەستێ	بسط
بەستە	بسط
بەستەری	بستري
بەستەم	بثتم
بەستەن	بسطن
بەستەی	بسطي
بەسرە	بسر
بەسی	بثي
بەسیر	بصير
بەسیێ	بثي
بەسەر	بسر
بەسەرێ	بسر
بەسەرەتا	بصرتا
بەش	بش
بەشا	بشا
بەشان	بشان
بەشش	بشش
بەشی	بشي
بەشیر	بشير
بەشیە	بشي
بەشێ	بش
بەشێن	بشن
بەشێوا	بشوا
بەشێوش	بشوش
بەشە	بش
بەشەر	بشر
بەشەرتێ	بشرت
بەشەری	بشري
بەشەی	بشي
بەشەیە	بشي
بەعزێ	بعض
بەغداد	بغداد
بەغدادی	بغدادي
بەلا	بلا
بەلجیکا	بلجيكا
بەلیتا	بليتا
بەم	بم
بەمن	بمن
بەمە	بم
بەند	بند
بەندەر	بندر
بەنزینێ	بنزين
بەنی	بني
بەنەما	بنما
بەها	بها
بەهانێ	بهان
بەهجەت	بهجت
بەهرە	بهر
بەهێز	بهظ
بەهێزینە	بهذين
بەهێزیەنە	بهذين
بەهێزێ	بهظ
بەهێزێنێ	بهظن
بەهێزەن	بهظن
بەورت	بورت
بەوێش	بوش
بەوەش	بوش
بەڕازیل	برازيل
بەڕبەر	بربر
بەڕێز	برز
بەڕێی	بري
بەڕەزا	برزا
بەکتریێ	بكتري
بەکر	بكر
بەکرا	بكرا
بەکری	بكري
بەڵا	بلا
بەڵێ	بل
بەڵێن	بلن
بەڵێنێ	بلن
بەڵێە	بل
بەڵە	بل
بەی	بي
بەیان	بيان
بەیانو	بيانو
بەیانێ	بيان
بەیانە	بيان
بەیتا	بيتا
بەیتێ	بيت
بەیتە	بيت
بەیدێ	بيد
بەین	بين
بەینا	بينا
بەینو	بينو
بەینوو	بينو
بەینێ	بين
بەینە	بين
بەینەتێ	بينت
تا	تا
تابون	طابون
تاج	تاج
تاجر	تاجر
تاد	طاد
تار	طار
تارا	طارا
تارش	طارش
تارق	طارق
تارک	تارك
تاریخ	تاريخ
تارە	طار
تاسە	طاس
تاسەە	طاس
تاش	طاش
تاق	تاق
تاقمێ	طاقم
تاقمە	طاقم
تاقێ	طاق
تاقە	طاق
تاقەت	تاقت
تاقەمە	طاقم
تالبی	طالبي
تام	تام
تان	تان
تانک	تانك
تانکێ	تانك
تانێک	تانك
تانە	تان
تاهێر	طاهر
تاون	تاون
تاوی	طاوي
تاکەسی	تاكسي
تاڵی	تالي
تاڵە	طال
تایبێ	طايب
تایبە	طايب
تایبەت	طايبت
تایبەتا	طايبتا
تایبەتێ	طايبت
تایبەتێنێ	طايبتن
تایبەتێنە	طايبتن
تایبەتە	طايبت
تایبەتەن	طايبتن
تایبەن	طايبن
تایبەنە	طايبن
تایبەی	تايبي
تایەبەی	تايبي
تبریزی	تبريزي
تخم	تخم
تر	تر
تراس	تراس
ترجمە	ترجم
ترخێنە	ترخن
تردا	تردا
تروق	تروق
ترک	ترك
ترکی	تركي
ترۆر	طرور
ترۆرێ	طرور
ترۆق	طروق
تری	طري
ترێ	طر
ترێنو	ترنو
ترەشتە	طرشت
ترەکێنێ	تركن
تزێ	تذ
تزە	تذ
تسلیم	تسليم
تسو	تسو
تشی	تشي
تشینە	تشين
تشە	طش
تفاق	تفاق
تفاقی	تفاقي
تفاقێ	تفاق
تفاقە	تفاق
تفڵیێ	تفلي
تفی	طفي
تفێ	تف
تفێوە	طفو
تفەکێ	تفك
تقدس	تقدس
تل	تل
تلاش	تلاش
تلافیا	تلافيا
تلیا	تليا
تمارێ	تمار
تمەن	تمن
تن	تن
تنان	تنان
تندو	تندو
تنو	تنو
ته	ته
تهران	تهران
تهرون	تهرون
تو	تو
توبێ	طوب
توتە	توت
توخمێ	توخم
توخوا	توخوا
تورک	تورك
تورکی	توركي
تورکینە	توركين
تورکیەنە	توركين
تورکێ	تورك
تورکە	تورك
توز	توذ
توزی	توذي
توشێ	توش
تومەنێ	تومن
تونس	تونس
توو	تو
تووتە	توت
تووتەی	توطي
توورەی	طوري
تووش	توش
تووشی	توشي
تووشێ	توش
توول	طول
توولە	طول
تووڕە	طور
تووڵ	طول
تووڵێ	طول
تووڵە	طول
توڕێ	طور
توڕە	طور
توڵی	تولي
تویتێنە	طويتن
توێتێنە	توطن
توێسی	طوسي
توە	تو
توەر	طور
توەن	تون
توەنی	توني
توەنیە	توني
توەو	تو
توەکا	توكآ
تڕو	طرو
تڤی	طوي
تکەو	تكو
تۆ	تو
تۆرە	طور
تۆف	طوف
تۆمەن	تومن
تۆنی	توني
تۆنە	تون
تۆڕێ	طور
تۆڕە	طور
تۆڕەکێ	تورك
تۆڵە	طول
تۆی	طوي
تی	تي
تیر	طير
تیری	طيري
تیرێ	طير
تیرە	طير
تیشا	طيشا
تیلەی	تيلي
تیمی	تيمي
تیمێ	تيم
تیمە	تيم
تیۆرە	طيور
تێئوریک	توريك
تێدا	تدا
تێر	طر
تێزەکێ	تزك
تێستو	تسطو
تێوری	طوري
تێکبدەن	تكبدن
تێکبشۆنە	تكبشون
تێکدان	تكدان
تێکدەدەن	تكددن
تێکدەر	تكدر
تێکدەرانێ	تكدران
تێکرار	تكرار
تێکشی	تكشي
تێکشیەن	تكشين
تێکنیکی	تكنيكي
تێکێدێنێ	تكدن
تێکەڵ	تكل
تێکەڵێ	تكل
تێکەڵە	تكل
تێکەڵەنە	تكلن
تە	ت
تەئویلی	تويلي
تەبارێ	تبار
تەبقا	طبقا
تەبێعی	طبعي
تەبێعەت	تبعت
تەبەری	طبري
تەتوانی	تطواني
تەتەو	تطو
تەجربە	تجرب
تەحریر	تحرير
تەحسین	تحسين
تەحەمل	تحمل
تەخت	تخت
تەختو	تخطو
تەختی	تخطي
تەختینە	تخطين
تەختە	تخت
تەختەی	تخطي
تەختەیرە	تختير
تەدمری	تدمري
تەر	طر
تەرا	طرا
تەربیەت	تربيت
تەربیەتێ	تربيت
تەرتیب	ترطيب
تەرجمەی	ترجمي
تەرخان	ترخان
تەرخانێ	ترخان
تەرخانە	ترخان
تەرز	طرز
تەرزان	طرزان
تەرزە	طرز
تەرزەوە	ترضو
تەرس	ترس
تەرسا	طرسا
تەرسان	طرسان
تەرسو	ترصو
تەرسی	طرسي
تەرسێ	ترس
تەرسە	ترس
تەرسەو	ترصو
تەرسەی	طرسي
تەرش	طرش
تەرشا	طرشا
تەرشان	ترشان
تەرفۆ	ترفو
تەرم	ترم
تەرما	ترما
تەرمان	ترمان
تەرمی	ترمي
تەرمێ	ترم
تەرنە	ترن
تەرهەن	ترهن
تەرو	طرو
تەروو	طرو
تەرک	ترك
تەرکو	تركو
تەرۆ	طرو
تەرۆر	طرور
تەرۆرە	طرور
تەری	طري
تەریئیسە	ترييث
تەریبە	تريب
تەریشا	تريشا
تەریشان	تريشان
تەرین	ترين
تەرینی	تريني
تەرینە	ترين
تەریەن	ترين
تەریەنە	ترين
تەرێ	طر
تەرێش	طرش
تەرێشان	ترشان
تەرێق	طرق
تەرێقەتی	ترقطي
تەرێنە	ترن
تەرە	طر
تەرەرە	طرر
تەرەن	ترن
تەرەنە	ترن
تەرەهەنە	ترهن
تەرەوە	طرو
تەرەی	طري
تەزویر	تزوير
تەزکی	تزكي
تەسلیم	تسليم
تەسلیمێ	تسليم
تەسک	تسك
تەسکێ	تسك
تەسەوف	تصوف
تەشتو	تشتو
تەشریف	تشريف
تەشک	تشك
تەشکو	تشكو
تەشکی	تشكي
تەشکیل	تشكيل
تەشکێوە	تشكو
تەشکە	تشك
تەشەرەم	تشرم
تەشەنە	تشن
تەشەنەی	تشني
تەشەکی	تشكي
تەعبیر	تعبير
تەعریب	تعريب
تەفسیر	تفسير
تەفسیڵ	تفصيل
تەقالا	تقالا
تەقانا	تقانا
تەقاو	تقاو
تەقلیل	تقليل
تەقنیان	تقنيان
تەقە	طق
تەقەش	تقش
تەقەشان	تقشان
تەقەلا	تقلا
تەقەلانە	تقلان
تەقەمەنی	تقمني
تەقەو	تقو
تەل	تل
تەلاش	تلاش
تەلان	طلان
تەلاو	تلاو
تەلخ	تلخ
تەلە	تل
تەلەفزیۆن	تلفزيون
تەلەفزیۆنە	تلفزيون
تەلەفون	تلفون
تەلەفۆن	تلفون
تەلەفۆنێ	تلفون
تەم	طم
تەما	تما
تەماتە	تمات
تەماشە	تماش
تەماعە	طماع
تەمام	تمام
تەمامە	تمام
تەمان	تمان
تەمانە	تمان
تەمری	تمري
تەمرێ	طمر
تەموز	تموز
تەموو	طمو
تەمیزی	تميزي
تەمە	طم
تەمەدنی	تمدني
تەمەدۆن	تمدون
تەمەن	تمن
تەمەنی	تمني
تەمەنێنێ	تمنن
تەن	تن
تەنانە	طنان
تەنیا	تنيا
تەنێ	تن
تەها	طها
تەوافق	توافق
تەور	طور
تەورە	طور
تەورەبێنێ	توربن
تەورەشان	تورشان
تەورەنە	طورن
تەوزیح	توضيح
تەوفیق	توفيق
تەوفێق	توفق
تەونە	تون
تەوێلی	تولي
تەوێڵی	تولي
تەوێڵێ	طول
تەوێڵێنە	طولن
تەوێڵەیەنە	تولين
تەوەر	طور
تەوەرین	تورين
تەوەرە	طور
تەوەن	تون
تەوەنی	توني
تەوەنینە	تونين
تەوەنێ	تون
تەوەنێونە	تونون
تەوەنە	تون
تەڕو	طرو
تەڕیشان	تريشان
تەڕەنە	ترن
تەکمان	تكمان
تەکمیل	تكميل
تەکنیکی	تكنيكي
تەکنیکیێ	تكنيكي
تەکوو	تكو
تەکەل	تكل
تەڵا	طلا
تەڵانە	طلان
تەیب	طيب
تەیمانە	تيمان
جادێ	جاد
جادە	جاد
جار	جار
جارا	جارا
جاران	جاران
جاری	جاري
جاریەن	جارين
جارێ	جار
جارێن	جارن
جارێنە	جارن
جارە	جار
جارەن	جارن
جاسم	جاسم
جاش	جاش
جاشێ	جاش
جاشە	جاش
جافن	جافن
جافی	جافي
جافە	جاف
جام	جام
جامع	جامع
جامعەنە	جامعن
جامعەی	جامعي
جامعەیە	جامعي
جامێ	جام
جان	جان
جانتێ	جانت
جانە	جان
جانەی	جاني
جاڕ	جار
جبهەت	جبهت
جبەر	جبر
جبەری	جبري
جددی	جددي
جددیێ	جددي
جدی	جدي
جستە	جصت
جل	جل
جلد	جلد
جلدی	جلدي
جلێ	جل
جلە	جل
جم	جم
جمال	جمال
جماڵ	جمال
جمعە	جمع
جمعەی	جمعي
جمنە	جمن
جمهووری	جمهوري
جمە	جم
جمەنە	جمن
جنس	جنس
جنسی	جنسي
جنوا	جنوا
جه	جه
جواب	جواب
جوان	جوان
جوانی	جواني
جوانیە	جواني
جوانێ	جوان
جوانە	جوان
جودی	جودي
جور	جور
جورئەت	جورت
جوری	جوري
جوریە	جوري
جورێ	جور
جورە	جور
جورەنە	جورن
جوق	جوق
جوقی	جوقي
جومعە	جومع
جوودی	جودي
جوڵی	جولي
جوڵێ	جول
جوڵە	جول
جوڵەی	جولي
جڵو	جلو
جڵەو	جلو
جۆر	جور
جۆرا	جورا
جۆری	جوري
جۆریە	جوري
جۆرێ	جور
جۆرێن	جورن
جۆرێنێ	جورن
جۆرە	جور
جۆرەنێ	جورن
جۆرەنە	جورن
جۆرەی	جوري
جۆش	جوش
جۆملە	جومل
جۆنسن	جونسن
جۆڕیە	جوري
جۆۆرێ	جوور
جۆی	جوي
جیاش	جياش
جیرە	جير
جیش	جيش
جیمس	جيمس
جیهان	جيهان
جیهانێ	جيهان
جیهانە	جيهان
جیێشان	جيشان
جێ	ج
جێرسی	جرسي
جێرمی	جرمي
جە	ج
جەئانەیە	جاني
جەئەدێ	جد
جەبار	جبار
جەبهە	جبه
جەبهەت	جبهت
جەدار	جدار
جەدلێ	جدل
جەدەس	جدث
جەر	جر
جەراح	جراح
جەراد	جراد
جەرج	جرج
جەرمانی	جرماني
جەستە	جصت
جەستەنە	جصتن
جەسیم	جسيم
جەسەی	جصي
جەش	جش
جەشمە	جشم
جەشن	جشن
جەعفەر	جعفر
جەعل	جعل
جەعلە	جعل
جەلا	جلا
جەلال	جلال
جەلاێ	جلا
جەلەسێ	جلس
جەم	جم
جەما	جما
جەمال	جمال
جەماڵ	جمال
جەمع	جمع
جەمعی	جمعي
جەمعەن	جمعن
جەمی	جمي
جەمیل	جميل
جەمێ	جم
جەندێن	جندن
جەنی	جني
جەنەراڵ	جنرال
جەهان	جهان
جەهل	جهل
جەهلی	جهلي
جەهەرە	جهر
جەو	جو
جەواد	جواد
جەوانی	جواني
جەوانێ	جوان
جەوهەری	جوهري
جەوێ	جو
جەوێش	جوش
جەڕوو	جرو
جەڵدی	جلدي
جەڵەبە	جلب
جەڵەبەی	جلبي
جەیش	جيش
جەە	ج
حاجی	حاجي
حاجەتێ	حاجت
حازر	حازر
حازرا	حاضرا
حازری	حاضري
حازم	حازم
حاشا	حاشا
حافر	حافر
حافزی	حافظي
حافێز	حافظ
حافێزەی	حافظي
حامد	حامد
حامی	حامي
حاکم	حاكم
حاکێمێ	حاكم
حاڵ	حال
حاڵی	حالي
حاڵەت	حالت
حاڵەتێ	حالت
حاڵەتە	حالت
حبوب	حبوب
حبیب	حبيب
حجاب	حجاب
حجاج	حجاج
حران	حران
حرمل	حرمل
حرکت	حركت
حزب	حزب
حزبی	حزبي
حزبیێ	حزبي
حزبە	حزب
حساب	حساب
حسابە	حساب
حسام	حسام
حسن	حسن
حسون	حسون
حسک	حسك
حسیب	حسيب
حسین	حصين
حسینی	حسيني
حسێن	حصن
حسێنی	حصني
حسەین	حصين
حق	حق
حقوق	حقوق
حقوقی	حقوقي
حقوقیە	حقوقي
حقوقێی	حقوقي
حقۆقی	حقوقي
حلوول	حلول
حماڵ	حمال
حمس	حمس
حمود	حمود
حمید	حميد
حواس	حواس
حوریە	حوري
حوسنا	حوسنا
حوسێن	حوسن
حوکم	حوكم
حکم	حكم
حکمەت	حكمت
حکومی	حكومي
حکومیێ	حكومي
حۆڕانە	حوران
حیرە	حير
حێفزێ	حفض
حەتتا	حطتا
حەجاب	حجاب
حەجی	حجي
حەدو	حدو
حەر	حر
حەرف	حرف
حەرفی	حرفي
حەرکە	حرك
حەریر	حرير
حەریری	حريري
حەرەکەت	حركت
حەز	حظ
حەزا	حظا
حەزف	حذف
حەزم	حزم
حەزو	حذو
حەزەیە	حظي
حەساب	حساب
حەسابێ	حساب
حەسن	حصن
حەسەن	حصن
حەسەنی	حصني
حەسەکە	حسك
حەشا	حشا
حەشار	حشار
حەشر	حشر
حەفارە	حفار
حەفت	حفت
حەفتا	حفتا
حەفتێ	حفت
حەفتەن	حفتن
حەفتەنە	حفتن
حەفید	حفيد
حەق	حق
حەقی	حقي
حەقێقەت	حققت
حەل	حل
حەلاج	حلاج
حەلب	حلب
حەلیم	حليم
حەلەب	حلب
حەلەسێ	حلس
حەما	حما
حەماسە	حماس
حەمام	حمام
حەمامی	حمامي
حەماە	حما
حەمزە	حمض
حەمزەی	حمضي
حەمید	حميد
حەمە	حم
حەمەد	حمد
حەمەو	حمو
حەمەی	حمي
حەنا	حنا
حەننانە	حننان
حەنیفە	حنيف
حەوت	حوت
حەوتی	حوطي
حەوزی	حوذي
حەوسەڵە	حوصل
حەوش	حوش
حەوێش	حوش
حەکیم	حكيم
حەڵەفی	حلفي
حەیاتی	حياتي
حەیدەر	حيدر
حەیف	حيف
حەیفا	حيفا
حەیوان	حيوان
حەیوانی	حيواني
حەیوانە	حيوان
خاترت	خاطرت
خار	خار
خاس	خاص
خاسما	خاصما
خاسێ	خاص
خاسە	خاص
خالا	خالا
خالد	خالد
خالێ	خال
خالێد	خالد
خالێس	خالص
خام	خام
خامێ	خام
خامە	خام
خان	خان
خانێ	خان
خانە	خان
خاوی	خاوي
خاڵ	خال
خاڵا	خالا
خاڵی	خالي
خاڵێ	خال
خاڵە	خال
خاڵەی	خالي
خبر	خبر
ختبە	خطب
ختم	ختم
ختی	خطي
خدر	خدر
خدری	خدري
خراب	خراب
خرابێ	خراب
خربەت	خربت
خرووسە	خروس
خرۆش	خروش
خزمێ	خضم
خزمەت	خضمت
خزمەتێ	خضمت
خستە	خست
خسر	خسر
خسلەتێ	خصلت
خسڵەتە	خصلت
خشتا	خشتا
خشتێ	خشت
خشیا	خشيا
خلیل	خليل
خمیس	خميس
خوا	خوا
خورشید	خورشيد
خول	خول
خولی	خولي
خولێ	خول
خون	خون
خوڵقنا	خولقنا
خوی	خوي
خویا	خويا
خوێن	خون
خوەی	خوي
خڕە	خر
خۆ	خو
خۆرشید	خورشيد
خۆسەر	خوصر
خۆی	خوي
خۆیان	خويان
خیار	خيار
خیام	خيام
خیاڵ	خيال
خیاڵی	خيالي
خیاڵیێ	خيالي
خێر	خر
خێرا	خرا
خێراش	خراش
خێری	خري
خێریێ	خري
خێرێ	خر
خێرەش	خرش
خێزانێ	خزان
خێزانە	خزان
خێزو	خزو
خێزینە	خزين
خێزێوە	خزو
خێمێ	خم
خێڵ	خل
خێڵۆ	خلو
خێڵێ	خل
خەبات	خباط
خەبەر	خبر
خەبەری	خبري
خەت	خط
خەتو	خطو
خەتوو	خطو
خەتی	خطي
خەتیا	خطيا
خەتیب	خطيب
خەتیێ	خطي
خەتیە	خطي
خەتێ	خط
خەتێوە	خطو
خەتە	خط
خەتەر	خطر
خەتەرا	خطرا
خەتەری	ختري
خەتەرەنە	خطرن
خەتەنە	ختن
خەتەو	خطو
خەتەی	خطي
خەر	خر
خەربانێ	خربان
خەرج	خرج
خەرجی	خرجي
خەردەل	خردل
خەرمان	خرمان
خەزان	خزان
خەزانێ	خزان
خەزەر	خضر
خەزەری	خضري
خەسان	خسان
خەشابێ	خشاب
خەفە	خف
خەفەت	خفت
خەلدون	خلدون
خەلیل	خليل
خەلە	خل
خەلەف	خلف
خەلەو	خلو
خەم	خم
خەمان	خمان
خەمت	خمت
خەمی	خمي
خەمێ	خم
خەمێوش	خموش
خەمەوەر	خمور
خەوف	خوف
خەوفێ	خوف
خەون	خون
خەڵات	خلاط
خەڵاتێ	خلاط
خەڵەف	خلف
خەڵەفە	خلف
خەیاڵ	خيال
خەیاڵی	خيالي
خەیر	خير
خەیرت	خيرت
خەیری	خيري
خەیلێ	خيل
خەیلێن	خيلن
دا	دآ
دائێم	دام
داب	داب
دابێ	داب
دابە	داب
داخێنە	داخن
داد	داد
دادی	دادي
دادە	داد
دار	دار
دارا	دارا
داری	داري
داریە	داري
دارێ	دار
دارە	دار
دارەن	دارن
دارەی	داري
دام	دام
دامنە	دامن
دامە	دام
دان	دان
دانا	دانا
دانی	داني
دانێ	دان
دانە	دان
دانەنە	دانن
داو	داو
داود	داود
داوە	داو
داینە	داين
دایەن	داين
دایەنە	داين
دبلۆماسی	دبلوماسي
درا	درا
درزێ	درز
دروس	دروس
دروسە	دروس
درک	درك
درکنێ	دركن
درۆس	دروس
درۆسە	دروس
دریا	دريا
دریێ	دري
دریێنێ	درين
درێ	در
درێبێنێ	دربن
درێعی	درعي
درێنێ	درن
درێی	دري
درە	در
دشەنە	دشن
دشەی	دشي
دفاع	دفاع
دلق	دلق
دلنێ	دلن
دلو	دلو
دلی	دلي
دلین	دلين
دلینێ	دلين
دلێ	دل
دلێنە	دلن
دلێو	دلو
دلێوە	دلو
دلێین	دلين
دما	دما
دمارە	دمار
دمدمی	دمدمي
دننە	دنن
دنی	دني
دنیا	دنيا
دنیانە	دنيان
دنێ	دن
دنە	دن
ده	ده
دهێ	ده
دو	دو
دوا	دوا
دور	دور
دورست	دورست
دوری	دوري
دورێ	دور
دورە	دور
دورەنا	دورنا
دوما	دوما
دومان	دومان
دونیا	دونيا
دوه	دوه
دوهەم	دوهم
دوو	دو
دوور	دوور
دووری	دوري
دوورێ	دور
دوورێنێ	دورن
دوورە	دور
دوورەن	دورن
دوورەنە	دورن
دوورەیە	دوري
دووم	دووم
دووهەم	دوهم
دووکان	دوكان
دووکانێ	دوكان
دووێ	دو
دووە	دو
دووەم	دوم
دووەمی	دومي
دووەمەنە	دومن
دوڕان	دوران
دوڕی	دوري
دوکان	دوكان
دوکانێ	دوكان
دوی	دوي
دوێ	دو
دوێنێ	دون
دوە	دو
دوەم	دوم
دوەمی	دومي
دڕی	دري
دڕیێ	دري
دڕیێنێ	درين
دڕەی	دري
دکتور	دكتور
دکتۆر	دكتور
دکتۆرە	دكتور
دکەن	دكن
دڵ	دل
دڵا	دلا
دڵانە	دلان
دڵت	دلت
دڵو	دلو
دڵوو	دلو
دڵی	دلي
دڵینە	دلين
دڵێ	دل
دڵەی	دلي
دۆ	دو
دۆخ	دوخ
دۆخەوا	دوخوا
دۆخەی	دوخي
دۆس	دوس
دۆسان	دوسان
دۆستێ	دوست
دۆل	دول
دۆلار	دولار
دۆلارێ	دولار
دۆن	دون
دۆنمێ	دونم
دۆڕنا	دورنا
دۆڕیا	دوريا
دۆڕیێ	دوري
دۆڕێ	دور
دۆڵ	دول
دۆڵی	دولي
دۆڵێ	دول
دۆڵەت	دولت
دۆینە	دوين
دی	دي
دیا	ديا
دیار	ديار
دیارێ	ديار
دیارە	ديار
دیدە	ديد
دیر	دير
دیسان	ديصان
دیسانێ	ديصان
دیل	ديل
دیلی	ديلي
دیلێ	ديل
دیم	ديم
دیمێ	ديم
دین	دين
دینار	دينار
دینارێ	دينار
دینامیت	ديناميت
دینی	ديني
دینەوەری	دينوري
دیوان	ديوان
دیوانە	ديوان
دیکتاتۆر	ديكتاتور
دیکتاتۆری	ديكتاتوري
دیکە	ديك
دیێنە	دين
دیەبێ	ديب
دیەن	دين
دێ	د
دێبێنێ	دبن
دێر	در
دێرک	درك
دێرکی	دركي
دێرین	درين
دێرینە	درين
دێرێک	درك
دێش	دش
دێنرە	دنر
دێنی	دني
دێنین	دنين
دێنێ	دن
دێنێت	دنت
دێنێوە	دنو
دێنە	دن
دێوە	دو
دە	د
دەبێ	دب
دەبێت	دبت
دەبێتە	دبت
دەبە	دب
دەبەن	دبن
دەخیلێ	دخيل
دەدەن	ددن
دەر	در
دەرا	درا
دەرس	درس
دەرسێ	درس
دەرعا	درعا
دەرقەت	درقت
دەرمان	درمان
دەرمانێ	درمان
دەرهەم	درهم
دەرویش	درويش
دەروێش	دروش
دەروێشان	دروشان
دەروێشی	دروشي
دەرک	درك
دەرکە	درك
دەری	دري
دەریا	دريا
دەریێ	دري
دەرێ	در
دەرە	در
دەرەن	درن
دەرەکی	دركي
دەرەکێ	درك
دەس	دس
دەسا	دسا
دەسانە	دسان
دەست	دست
دەستور	دستور
دەستوری	دستوري
دەستوور	دستور
دەستووری	دستوري
دەستێ	دست
دەستە	دست
دەستەن	دستن
دەسم	دسم
دەسما	دسما
دەسو	دسو
دەسور	دثور
دەسوو	دسو
دەسۆ	دسو
دەسی	دسي
دەسین	دسين
دەسینە	دسين
دەسیە	دسي
دەسیەنە	دسين
دەسێ	دس
دەسێوە	دسو
دەسە	دس
دەسەنە	دسن
دەسەو	دسو
دەسەوا	دسوا
دەشت	دشت
دەشتە	دشت
دەفتەر	دفتر
دەفتەرێ	دفتر
دەفە	دف
دەق	دق
دەقی	دقي
دەقێقەن	دققن
دەلاک	دلاك
دەلیل	دليل
دەم	دم
دەمنە	دمن
دەمی	دمي
دەمینە	دمين
دەمێنە	دمن
دەمە	دم
دەنێت	دنت
دەها	دها
دەهێنن	دهنن
دەهەو	دهو
دەوا	دوا
دەوت	دوت
دەور	دور
دەورانە	دوران
دەوری	دوري
دەوریە	دوري
دەورە	دور
دەورەنە	دورن
دەورەی	دوري
دەولەت	دولت
دەولەتە	دولت
دەوڵەت	دولت
دەوڵەتا	دولتا
دەوڵەتێ	دولت
دەوڵەتە	دولت
دەوێت	دوت
دەوەن	دون
دەڤەر	دور
دەڤەری	دوري
دەڤەرێ	دور
دەڤەرە	دور
دەڤەرەکێ	دورك
دەڤەرەکەنە	دوركن
دەکەن	دكن
دەکەنە	دكن
دەڵێت	دلت
دەڵێن	دلن
دەی	دي
دەیان	ديان
دەیانێ	ديان
دەیبێ	ديب
دەیدێ	ديد
دەیدەن	ديدن
دەیمێ	ديم
دەین	دين
را	رآ
رائدی	رادي
رادار	رادار
رادیۆ	راديو
رازی	راضي
راسا	راسا
راست	راست
راستە	راست
راسم	راسم
راسی	راسي
راشا	راشا
رحا	رحا
رده	رده
ردەی	ردي
رزم	رزم
رستەنە	رثتن
رشید	رشيد
رعد	رعد
رفت	رفت
رفتم	رفتم
رمانی	رماني
رمزی	رمزي
رو	رو
روا	روا
روحی	روحي
رود	رود
روز	روز
روسی	روسي
روسیا	روسيا
رولی	رولي
روو	رو
رووسیە	روسي
روون	رون
رووی	روي
روویان	رويان
رووە	رو
رووەش	روش
روێ	رو
روەش	روش
روەو	رو
رۆ	رو
رۆح	روح
رۆحی	روحي
رۆحە	روح
رۆحەی	روحي
رۆحەیە	روحي
رۆسەم	روسم
رۆشن	روشن
رۆلێ	رول
رۆڵی	رولي
رۆی	روي
ری	ري
ریش	ريش
ریشا	ريشا
ریشە	ريش
رین	رين
رینی	ريني
رێز	رز
رێم	رم
رێمێ	رم
رێک	رك
رێی	ري
رێیا	ريا
رەحمان	رحمان
رەحیم	رحيم
رەخنە	رخن
رەدیف	رديف
رەزا	رضا
رەسمی	رسمي
رەسمە	رسم
رەسولی	رسولي
رەسوڵ	رسول
رەسەدی	رصدي
رەسەن	رسن
رەسەنەن	رصنن
رەفعەت	رفعت
رەقیب	رقيب
رەمزی	رمزي
رەمەزان	رمضان
رەی	ري
رەیا	ريا
زا	ذا
زاتی	ذاتي
زاد	زاد
زادێ	ضاد
زادە	ضاد
زار	زار
زارعی	ضارعي
زاری	ضاري
زارێی	ضاري
زارە	ضار
زافەر	ظافر
زام	ذام
زامن	زامن
زان	زان
زانا	زانا
زانێ	ذان
زاهێر	زاهر
زاوڵان	زاولان
زاوڵە	زاول
زاوڵەی	زاولي
زاڵ	ذال
زاڵمانە	ظالمان
زاڵێ	ذال
زایڵەی	زايلي
زایەڵەی	زايلي
زبان	زبان
زخمە	ضخم
زدێ	ضد
زدە	ضد
زرار	زرار
زروو	ذرو
زریان	ذريان
زرین	ذرين
زعفران	زعفران
زلان	زلان
زلە	ظل
زمان	زمان
زمینە	ضمين
زه	زه
زهن	زهن
زوان	ذوان
زوانی	زواني
زوانیە	زواني
زوانێ	ذوان
زوانە	ذوان
زوانەی	زواني
زوانەیە	زواني
زورنا	زورنا
زوو	ذو
زووان	ذوان
زووانێ	ذوان
زووانە	ذوان
زووینە	ضوين
زووەن	زون
زوڕنا	زورنا
زوڵم	ظولم
زوۆن	ذوون
زوێڵ	زول
زوێڵی	زولي
زوەو	ذو
زوەوە	ذو
زکر	ذكر
زڵم	ظلم
زڵمی	ظلمي
زۆر	زور
زۆری	زوري
زۆڵم	ظولم
زیا	زيا
زیاتە	زيات
زیاد	زياد
زیار	زيار
زیان	ذيان
زیانێ	ذيان
زیانە	ذيان
زیاێ	زيا
زیدان	زيدان
زیلان	زيلان
زیلانێ	زيلان
زیلانە	زيلان
زین	ذين
زینان	زينان
زیننە	زينن
زینی	زيني
زینێ	ذين
زینە	ذين
زێ	ذ
زێد	ضد
زێرێ	زر
زێنێ	ضن
زێنەوە	ضنو
زێوەر	زور
زەبر	زبر
زەبری	زبري
زەحمەت	زحمت
زەحمەتا	زحمتا
زەحمەتەن	زحمتن
زەدەن	ضدن
زەرب	ذرب
زەرد	زرد
زەردە	زرد
زەرو	ذرو
زەروو	ذرو
زەریف	ذريف
زەرێ	زر
زەرەر	ضرر
زەرەو	ذرو
زەفەر	زفر
زەق	زق
زەقی	زقي
زەل	ظل
زەلی	ضلي
زەلیل	ظليل
زەمان	زمان
زەمانێ	زمان
زەمانە	زمان
زەمین	ضمين
زەمینێ	ضمين
زەمینە	ضمين
زەندی	زندي
زەوق	ذوق
زەوقی	زوقي
زەوی	ذوي
زەڕ	زر
زەڕتا	ضرطا
زەڕم	ضرم
زەڕو	ذرو
زەڕوا	زروا
زەڕی	ضري
زەڕیان	ذريان
زەڕێما	ضرما
زەڕە	زر
زەکی	ذكي
زەکەریا	زكريا
زەڵمی	ظلمي
زەیتون	زيتون
زەیتونێ	زيتون
زەیتوون	زيتون
زەید	زيد
زەیف	زيف
زەینی	زيني
زەینەب	زينب
زەینەبێ	زينب
زەینەبە	زينب
سائبە	صاب
سابت	سابت
سابقی	سابقي
سابون	صابون
سابێر	صابر
سات	صات
ساتا	صاتا
ساتانە	صاتان
ساتی	ساطي
ساتێ	صات
ساتە	صات
ساتەنە	صاتن
ساحب	ساحب
ساحبی	صاحبي
ساحبێ	صاحب
ساحبەنە	صاحبن
ساحێب	صاحب
ساحێل	ساحل
ساحە	صاح
ساخ	ساخ
ساخت	ساخت
ساختێ	ساخط
ساخێ	ساخ
ساداتێ	سادات
سادق	صادق
سادقی	صادقي
سادێ	صاد
سادە	صاد
سادەن	سادن
سادەی	سادي
سارا	سارا
ساری	صاري
سارین	سارين
ساریێ	صاري
سارێ	صار
ساسانی	ساساني
ساعبێ	صاعب
ساعەتێ	صاعت
ساف	صاف
سافی	صافي
ساق	ساق
ساقی	ساقي
ساقێ	ساق
ساقە	ساق
سالا	سالا
سالح	صالح
سالم	سالم
سالی	صالي
سالێ	سال
سالە	سال
سالەی	صالي
سامر	سامر
سامی	سامي
سامیر	سامير
سامیە	سامي
سان	سان
سانا	صانا
سانی	ثاني
سانیێ	ثاني
ساوە	صاو
ساڵ	سال
ساڵا	صالا
ساڵح	صالح
ساڵحی	صالحي
ساڵی	صالي
ساڵێ	سال
ساڵێما	سالما
ساڵێوا	صالوا
ساڵە	سال
ساڵەمان	سالمان
ساڵەکێ	سالك
ساڵەی	صالي
ستار	ستار
ستارە	ستار
ستۆکهۆلم	ستوكهولم
ستەور	ستور
سدان	سدان
سدیق	صديق
سدیقە	صديق
سدێق	صدق
سراب	سراب
سرابێ	سراب
سرودێ	صرود
سروە	سرو
سروەت	ثروت
سریان	سريان
سریلانکا	سريلانكا
سریە	ثري
سعد	سعد
سعدون	سعدون
سعودی	سعودي
سفت	سفت
سفتەم	سفتم
سفر	سفر
سفرە	سفر
سفی	صفي
سفەت	سفط
سلاح	سلاح
سلام	سلام
سلتان	سلطان
سلولێ	صلول
سلوک	سلوك
سلێمان	ثلمان
سلێمانێ	ثلمان
سلێنێ	صلن
سلێنە	صلن
سماع	سماع
سماق	سماق
سمری	سمري
سمیا	سميا
سمێڵ	سمل
سمەری	سمري
سندوقێ	صندوق
سندیێ	سندي
سنور	سنور
سنورێ	سنور
سنورە	سنور
سنوور	سنور
سنوورە	سنور
سنۆ	صنو
سنە	سن
سنەنە	سنن
سنەو	صنو
سنەی	ثني
سنەینە	سنين
سنەیە	ثني
سنەیەن	سنين
سنەیەنە	سنين
سه	سه
سهو	سهو
سوئات	سواط
سوات	سواط
سواری	صواري
سوارە	سوار
سوت	سوت
سوتێنێ	سوطن
سوتەی	سوطي
سوحبەت	صوحبت
سود	سود
سودان	سودان
سودانی	سوداني
سودی	سودي
سور	سور
سوری	سوري
سوریا	سوريا
سوریێ	سوري
سوریەنە	سورين
سورێ	ثور
سورێنێ	صورن
سورێی	سوري
سورەت	صورت
سورەن	صورن
سورەنا	صورنا
سورەنە	صورن
سورەی	سوري
سوفی	صوفي
سولو	سولو
سومر	سومر
سونە	صون
سوود	سوود
سوور	سوور
سووریا	سوريا
سوورێنێ	صورن
سوورە	ثور
سووک	سوك
سووکە	سوك
سووڵەو	سولو
سوویا	صويا
سوڕینێ	سورين
سوڕیێنێ	سورين
سوڕێنێ	صورن
سوک	سوك
سویان	صويان
سویت	صويت
سوید	سويد
سویسرا	سويسرا
سوەو	صو
سوەیل	سويل
سڕ	سر
سڕنا	صرنا
سڕو	سرو
سڤیل	سويل
سڤیلێ	سويل
سکاڵێ	ثكال
سکێ	سك
سڵ	سل
سڵام	سلام
سڵتان	سلطان
سڵیمان	سليمان
سڵێوە	سلو
سۆتێنێ	سوطن
سۆتەن	سوطن
سۆتەی	سوطي
سۆر	ثور
سۆرا	صورا
سۆران	ثوران
سۆفی	صوفي
سۆلا	سولا
سۆن	صون
سۆڵە	سول
سۆڵەی	سولي
سی	سي
سیاسی	صياصي
سیاسیێ	صياصي
سیاسیە	صياصي
سید	صيد
سیدیێ	صيدي
سیری	سيري
سیرێ	سير
سیستم	سيستم
سیستمێ	سيستم
سیستمە	سيستم
سیستێمە	سيستم
سیستەم	سيستم
سیستەمە	سيستم
سیسێ	سيس
سیفە	سيف
سیفەت	صيفت
سیفەتە	صيفت
سیفەی	صيفي
سیما	سيما
سینا	صينا
سیناتۆر	سيناتور
سیناریۆ	سيناريو
سینان	سينان
سینێ	سين
سینە	سين
سینەما	سينما
سینەی	صيني
سیێ	سي
سێ	ث
سێدارە	صدار
سێرت	صرط
سێرە	سر
سێمڕ	ثمر
سێن	سن
سێنتێ	سنط
سێیەم	صيم
سەباح	صباح
سەباەت	سبات
سەبری	صبري
سەبع	سبع
سەبکی	سبكي
سەبکێ	سبك
سەبەبا	سببا
سەتحە	سطح
سەحر	سحر
سەحەر	سحر
سەخت	سخط
سەختێنێ	سخطن
سەختەن	سخطن
سەختەنە	سخطن
سەد	سد
سەدام	ثدام
سەدان	سدان
سەدر	سدر
سەدی	ثدي
سەدە	سد
سەدەن	سدن
سەدەی	ثدي
سەدەیە	ثدي
سەر	سر
سەرا	صرا
سەرانێ	صران
سەرانە	صران
سەربە	سرب
سەرتا	سرطا
سەرد	صرد
سەردا	صردا
سەردە	صرد
سەردەن	صردن
سەرف	صرف
سەرنە	صرن
سەرو	سرو
سەروان	ثروان
سەروو	سرو
سەرووێ	سرو
سەروە	سرو
سەروەت	ثروت
سەروەر	سرور
سەروەرە	سرور
سەروەنە	سرون
سەرڕەوا	سرروا
سەرۆ	سرو
سەری	ثري
سەرین	سرين
سەرێنە	صرن
سەرە	سر
سەرەت	صرط
سەرەتا	سرطا
سەرەتانە	سرطان
سەرەر	سرر
سەرەرا	سررا
سەرەرە	سرر
سەرەم	صرم
سەرەن	صرن
سەرەنە	صرن
سەرەو	سرو
سەرەوە	سرو
سەرەڕا	سررا
سەرەک	سرك
سەعدی	صعدي
سەعید	صعيد
سەفا	صفا
سەفحە	صفح
سەفی	صفي
سەفیرە	سفير
سەفەری	سفري
سەفەرەن	صفرن
سەقەت	سقط
سەلاح	سلاح
سەلاس	ثلاث
سەلام	سلام
سەلدا	صلدا
سەلمان	ثلمان
سەلیم	سليم
سەلیمە	سليم
سەلەبی	سلبي
سەلەفی	سلفي
سەلەمنان	ثلمنان
سەلەمناێنێ	ثلمنان
سەلەیقەی	سليقي
سەما	صما
سەمۆ	سمو
سەمیح	سميح
سەمیر	سمير
سەمیرە	سمير
سەمەد	صمد
سەمەدی	صمدي
سەمەر	ثمر
سەمەرا	سمرا
سەمەرقەند	سمرقند
سەمەرقەندی	سمرقندي
سەمەرێ	ثمر
سەمەرە	ثمر
سەمەرەن	سمرن
سەندەن	سندن
سەو	صو
سەوا	سوا
سەواد	سواد
سەوادی	صوادي
سەودا	صودا
سەوڵی	سولي
سەی	سي
سەیارە	سيار
سەیاف	سياف
سەید	صيد
سەیدی	صيدي
سەیدیە	صيدي
سەیران	ثيران
سەیف	سيف
سەیفی	صيفي
شاخ	شاخ
شادی	شادي
شادێ	شاد
شار	شار
شارا	شارا
شاران	شاران
شارانە	شاران
شارنە	شارن
شاری	شاري
شارینە	شارين
شاریە	شاري
شاریەنێ	شارين
شاریەنە	شارين
شارێ	شار
شارێنێ	شارن
شارێنە	شارن
شارە	شار
شارەنە	شارن
شارەکا	شاركا
شارەکان	شاركان
شارەکانە	شاركان
شارەکێ	شارك
شارەکە	شارك
شارەکەنە	شاركن
شارەکەی	شاركي
شارەیە	شاري
شاعر	شاعر
شاعران	شاعران
شاعری	شاعري
شاعرێ	شاعر
شاعرە	شاعر
شاعێر	شاعر
شاعێران	شاعران
شاعێری	شاعري
شاعێرێ	شاعر
شام	شام
شامی	شامي
شان	شان
شانا	شانا
شانە	شان
شاها	شاها
شاهدێ	شاهد
شاهین	شاهين
شاهێدی	شاهدي
شاوری	شاوري
شاکر	شاكر
شاڵ	شال
شای	شاي
شایعی	شايعي
شت	شت
شتانە	شتان
شتەی	شتي
شدن	شدن
شده	شده
شریف	شريف
شعر	شعر
شعرا	شعرا
شعران	شعران
شعرێ	شعر
شعرەنە	شعرن
شعوور	شعور
شعێرێ	شعر
شما	شما
شماڵ	شمال
شمس	شمس
شممە	شمم
شمە	شم
شمەمان	شممان
شمەنان	شمنان
شمەنە	شمن
شمەی	شمي
شوتی	شوطي
شود	شود
شوم	شوم
شونی	شوني
شوو	شو
شووشان	شوشان
شووم	شوم
شوێنی	شوني
شوێنەی	شوني
شوە	شو
شڕ	شر
شک	شك
شکست	شكست
شکستێ	شكست
شکستەن	شكستن
شکم	شكم
شکڵ	شكل
شکۆ	شكو
شکە	شك
شکەنە	شكن
شۆت	شوط
شۆتی	شوطي
شۆتە	شوط
شۆر	شور
شۆن	شون
شۆنی	شوني
شۆنێنێ	شونن
شۆنە	شون
شۆک	شوك
شۆڵە	شول
شی	شي
شیار	شيار
شیاێ	شيآ
شیخ	شيخ
شیخا	شيخا
شیخان	شيخان
شیر	شير
شیراز	شيراز
شیرین	شيرين
شیش	شيش
شیشێ	شيش
شیشە	شيش
شیعە	شيع
شیوعی	شيوعي
شیکە	شيك
شیێ	شي
شیێش	شيش
شیێنێ	شين
شیێنە	شين
شیەن	شين
شیەنێ	شين
شێت	شت
شێتم	شتم
شێتە	شت
شێخ	شخ
شێخان	شخان
شێخێ	شخ
شێری	شري
شێعر	شعر
شێعری	شعري
شێعرێ	شعر
شێعرێن	شعرن
شێعرە	شعر
شێعرەنە	شعرن
شێعرەی	شعري
شێواز	شواظ
شێوازێ	شواظ
شێوازە	شواظ
شێوێ	شو
شێوێو	شو
شێوێوی	شوي
شێوێوە	شو
شێوە	شو
شێوەش	شوش
شێوەو	شو
شێوەکا	شوكا
شێوەی	شوي
شێوەیە	شوي
شێیەنێ	شين
شێەکان	شكان
شە	ش
شەبەک	شبك
شەبەکی	شبكي
شەبەکێ	شبك
شەخسی	شخصي
شەخسە	شخص
شەرا	شرا
شەرت	شرط
شەرحێ	شرح
شەردا	شردا
شەرعی	شرعي
شەرقی	شرقي
شەرم	شرم
شەرمنانە	شرمنان
شەری	شري
شەریف	شريف
شەریک	شريك
شەریکە	شريك
شەرەف	شرف
شەرەکان	شركان
شەرەکەی	شركي
شەس	شص
شەعبی	شعبي
شەعلان	شعلان
شەفیق	شفيق
شەفێعی	شفعي
شەفەق	شفق
شەق	شق
شەمال	شمال
شەماڵ	شمال
شەمری	شمري
شەمس	شمس
شەمسی	شمسي
شەممە	شمم
شەممەی	شممي
شەمە	شم
شەمەی	شمي
شەن	شن
شەنە	شن
شەهبا	شهبا
شەهلا	شهلا
شەهید	شهيد
شەهیدێ	شهيد
شەهیدە	شهيد
شەهیر	شهير
شەهین	شهين
شەهێدێ	شهد
شەو	شو
شەوارێ	شوار
شەوق	شوق
شەوی	شوي
شەوێ	شو
شەوێش	شوش
شەوێنە	شون
شەوێوە	شو
شەوێوەنە	شون
شەوە	شو
شەوەتان	شوطان
شەوەنە	شون
شەوەو	شو
شەوەکێ	شوك
شەڕ	شر
شەڕو	شرو
شەڕوو	شرو
شەڕی	شري
شەڕینە	شرين
شەڕێکی	شركي
شەڕە	شر
شەڤین	شوين
شەکەت	شكت
شەکەتێ	شكت
شەی	شي
شەیخی	شيخي
شەیدا	شيدا
شەیدێ	شيد
شەیش	شيش
عائشە	عاش
عابد	عابد
عابر	عابر
عاجز	عاجز
عادل	عادل
عادلی	عادلي
عادڵ	عادل
عادەت	عادت
عازم	عازم
عاسیە	عاصي
عال	عال
عالی	عالي
عالێ	عال
عالێنێ	عالن
عالەمەنێ	عالمن
عالەی	عالي
عام	عام
عامر	عامر
عامی	عامي
عان	عان
عانیە	عاني
عاکف	عاكف
عاڵەمی	عالمي
عایشێنە	عايشن
عایشە	عايش
عبد	عبد
عدس	عدس
عدنان	عدنان
عراق	عراق
عرفان	عرفان
عرەبی	عربي
عزەت	عزت
عسمەت	عصمت
عسکری	عسكري
عشب	عشب
عشق	عشق
علا	علا
علم	علم
علمی	علمي
علمەنە	علمن
على	على
علی	علي
عمار	عمار
عمر	عمر
عمران	عمران
عمید	عميد
عودە	عود
عومان	عومان
عیسا	عيثا
عێراق	عراق
عێلم	علم
عێلمی	علمي
عێلمیێ	علمي
عەباس	عباث
عەباسی	عباسي
عەبد	عبد
عەبدی	عبدي
عەبە	عب
عەتار	عطار
عەتری	عطري
عەتیە	عتي
عەدل	عدل
عەدلی	عدلي
عەدنان	عدنان
عەدوو	عدو
عەربانەی	عرباني
عەربەتێ	عربت
عەرز	عرض
عەرعەر	عرعر
عەرعەرێ	عرعر
عەرەب	عرب
عەرەبی	عربي
عەرەبیێ	عربي
عەرەبیە	عربي
عەرەبێ	عرب
عەرەبە	عرب
عەزاز	عضاض
عەزرەت	عذرت
عەزیز	عزيز
عەزیم	عزيم
عەزەڵێ	عذل
عەسر	عصر
عەسرا	عثرا
عەسران	عسران
عەسری	عصري
عەسکەر	عسكر
عەسەبی	عصبي
عەشق	عشق
عەفوەن	عفون
عەقلە	عقل
عەقڵ	عقل
عەقڵی	عقلي
عەقیدێ	عقيد
عەلی	علي
عەلەم	علم
عەلەوی	علوي
عەلەویێ	علوي
عەمر	عمر
عەمروو	عمرو
عەمەر	عمر
عەمەڵ	عمل
عەمەڵی	عملي
عەنان	عنان
عەنەبێ	عنب
عەوام	عوام
عەیاد	عياد
عەیارە	عيار
عەین	عين
عەینی	عيني
عەینەن	عينن
غازی	غازي
غافڵ	غافل
غالب	غالب
غربال	غربال
غرور	غرور
غلام	غلام
غوتە	غوط
غەدر	غدر
غەربی	غربي
غەریب	غريب
غەریبێ	غريب
غەریزەی	غريزي
غەزال	غزال
غەزلێ	غزل
غەزەلێ	غزل
غەزەڵ	غزل
غەزەڵێ	غزل
غەزەڵەنە	غزلن
غەفور	غفور
غەلەف	غلف
غەیبی	غيبي
غەیر	غير
غەیرە	غير
فاتح	فاتح
فاتمێ	فاطم
فاتمە	فاطم
فاتێح	فاتح
فارا	فارا
فارس	فارس
فارسی	فارسي
فارسیە	فارسي
فارسە	فارس
فاروق	فاروق
فاروقی	فاروقي
فازل	فاضل
فاسدا	فاسدا
فاسولیا	فاصوليا
فاش	فاش
فاشستی	فاشستي
فاعل	فاعل
فانۆس	فانوس
فاڕ	فار
فاڕا	فارا
فاڕیێ	فاري
فاڕە	فار
فت	فت
فتام	فطام
فتحی	فتحي
فتوح	فتوح
فتی	فتي
فتیمە	فطيم
فتەم	فطم
فتەی	فتي
فحش	فحش
فدراڵی	فدرالي
فدڕاڵی	فدرالي
فرات	فرات
فراتە	فرات
فراس	فراس
فرحان	فرحان
فرسەت	فرست
فرقە	فرق
فرقەت	فرقت
فره	فره
فرۆ	فرو
فریا	فريا
فرینە	فرين
فریێش	فريش
فرێ	فر
فرێش	فرش
فرێشا	فرشا
فرێشان	فرشان
فرێنێ	فرن
فرێو	فرو
فرێوە	فرو
فرێوەجە	فروج
فرە	فر
فرەجارێ	فرجار
فرەش	فرش
فرەشا	فرشا
فرەشان	فرشان
فرەفرە	فرفر
فرەن	فرن
فرەو	فرو
فرەوە	فرو
فرەی	فري
فرەینە	فرين
فرەیەرە	فرير
فرەێ	فر
فزی	فذي
فزەت	فذت
فعل	فعل
فعلیە	فعلي
فقە	فق
فلان	فلان
فندق	فندق
فنیقی	فنيقي
فهد	فهد
فوزی	فوزي
فولکلۆر	فولكلور
فولکلۆری	فولكلوري
فڕش	فرش
فڕشان	فرشان
فڕە	فر
فکر	فكر
فکری	فكري
فڵان	فلان
فڵانە	فلان
فۆلکلۆر	فولكلور
فۆلکلۆری	فولكلوري
فۆنیم	فونيم
فۆڕێست	فورست
فیت	فيت
فیدراڵی	فيدرالي
فیلم	فيلم
فیلمێ	فيلم
فێر	فر
فێراق	فراق
فێرش	فرش
فێرو	فرو
فێروو	فرو
فێری	فري
فێرێ	فر
فێرە	فر
فێعلیێ	فعلي
فێنک	فنك
فێڵێ	فل
فێڵێکی	فلكي
فەتاح	فتاح
فەتام	فطام
فەتحی	فتحي
فەتحیێ	فتحي
فەتحەی	فتحي
فەتۆش	فتوش
فەخر	فخر
فەرحان	فرحان
فەردا	فردا
فەرز	فرض
فەرق	فرق
فەرم	فرم
فەرهاد	فرهاد
فەرید	فريد
فەریدە	فريد
فەرە	فر
فەرەج	فرج
فەرەجی	فرجي
فەرەنسا	فرنسا
فەرەی	فري
فەساد	فساد
فەشەلا	فشلا
فەعال	فعال
فەقر	فقر
فەقی	فقي
فەقیرێ	فقير
فەقەت	فقط
فەلات	فلات
فەلسەفی	فلسفي
فەلسەفە	فلسف
فەلسەفەی	فلسفي
فەلەستینی	فلسطيني
فەلەسەفی	فلسفي
فەهمی	فهمي
فەهیمێ	فهيم
فەهەد	فهد
فەوتان	فوطان
فەوج	فوج
فەوزا	فوزا
فەوزی	فوزي
فەڕەنسا	فرنسا
فەڵەستینی	فلسطيني
فەڵەکی	فلكي
فەیروز	فيروز
فەیرۆز	فيروز
فەیزی	فيضي
فەیسەڵ	فيصل
فەیلی	فيلي
فەیلەسوف	فيلسوف
فەیلەسوفە	فيلسوف
فەیلەق	فيلق
فەیمە	فيم
قائم	قائم
قابل	قابل
قات	قات
قاتێ	قات
قاتێعانە	قاطعان
قادر	قادر
قادری	قادري
قارس	قارس
قارەر	قارر
قازی	قاضي
قاسم	قاسم
قاسمی	قاسمي
قاسمێ	قاسم
قانون	قانون
قانونی	قانوني
قانونێ	قانون
قانوون	قانون
قاڕە	قار
قاڵ	قال
قاڵبە	قالب
قاڵیێ	قالي
قبوول	قبول
قبوڵ	قبول
قبوڵێ	قبول
قبۆڵ	قبول
قدم	قدم
قدیم	قديم
قران	قران
قرشت	قرشت
قروەی	قروي
قسات	قساط
قسانە	قسان
قسم	قسم
قسمەت	قسمت
قسۆ	قثو
قسی	قسي
قسێ	قس
قسێت	قسط
قسێو	قثو
قسە	قس
قسەدە	قصد
قسەدەی	قصدي
قسەم	قسم
قمە	قم
قناع	قناع
قو	قو
قوتێ	قوت
قوتە	قوت
قورئان	قوران
قورس	قورص
قورسا	قورصا
قورسێ	قورص
قورسێنێ	قورصن
قورسەن	قورصن
قول	قول
قولە	قول
قووت	قوت
قووتێ	قوت
قوول	قوول
قووڵا	قولا
قوڵ	قول
قوڵی	قولي
قوڵێ	قول
قوەت	قوت
قڕ	قر
قڕان	قرآن
قڕێ	قر
قۆت	قوت
قۆم	قوم
قۆمی	قومي
قۆمێ	قوم
قیس	قيص
قین	قين
قەبوڵ	قبول
قەتار	قتار
قەتڵ	قتل
قەد	قد
قەدی	قدي
قەدیە	قدي
قەرار	قرار
قەرز	قرض
قەرس	قرص
قەرسی	قرصي
قەرەت	قرط
قەرەو	قرو
قەزا	قضا
قەزوا	قضوا
قەسر	قصر
قەسیم	قسيم
قەسەبی	قصبي
قەسەد	قصد
قەسەدە	قصد
قەسەدەی	قصدي
قەسەدەیەرە	قصدير
قەسەم	قسم
قەفەسی	قفصي
قەلا	قلا
قەلقەلی	قلقلي
قەلەم	قلم
قەمەر	قمر
قەناس	قناص
قەندیل	قنديل
قەوارە	قوار
قەوام	قوام
قەواڵ	قوال
قەوم	قوم
قەومی	قومي
قەومیە	قومي
قەومە	قوم
قەوڵ	قول
قەوی	قوي
قەڕنە	قرن
قەڵا	قلا
قەڵب	قلب
قەڵس	قلس
قەڵسی	قلصي
قەڵسێ	قلس
قەڵەم	قلم
قەڵەمی	قلمي
قەڵەمێ	قلم
قەڵەوی	قلوي
قەید	قيد
قەیسی	قيسي
قەیوم	قيوم
قەیومە	قيوم
قەیۆم	قيوم
لا	لا
لات	لات
لاتینی	لاتيني
لاتینیە	لاتيني
لادا	لادا
لادان	لادان
لازم	لازم
لازما	لازما
لازمەن	لازمن
لاش	لاش
لاشیەن	لاشين
لاشێ	لاش
لاشە	لاش
لاشەت	لاشت
لاشەنە	لاشن
لاشەی	لاشي
لاشەیت	لاشيت
لاشەیەنە	لاشين
لام	لام
لاما	لاما
لامرکەزی	لامركزي
لامێ	لام
لامە	لام
لامەرکەزی	لامركزي
لامەرکەزیە	لامركزي
لاهای	لاهاي
لاکەما	لاكما
لایق	لايق
لایقە	لايق
لایەن	لاين
لایەنا	لاينا
لایەنانە	لاينان
لایەنی	لايني
لایەنێ	لاين
لایەنە	لاين
لاێ	لا
لبان	لبان
لتێ	لط
لجمیع	لجميع
لحن	لحن
لزا	لزا
لسان	لسان
لغت	لغت
لقو	لقو
له	له
لهون	لهون
لو	لو
لوئەی	لوي
لوا	لوا
لوت	لوت
لوتی	لوطي
لوتێتەنە	لوطتن
لووبیا	لوبيا
لوی	لوي
لویس	لويس
لوێ	لو
لوێنێ	لون
لوێنە	لون
لوە	لو
لوەی	لوي
لڤین	لوين
لکا	لكا
لکان	لكان
لکی	لكي
لکیێ	لكي
لکە	لك
لۆبی	لوبي
لۆجستی	لوجستي
لۆنیە	لوني
لی	لي
لیبیا	ليبيا
لیترێ	ليتر
لیتە	ليت
لیجە	ليج
لیست	ليست
لێ	ل
لێئۆ	لو
لێم	لم
لێو	لو
لێویا	لويا
لێوە	لو
لێی	لي
لە	ل
لەتیف	لطيف
لەزەت	لذت
لەعنەت	لعنت
لەفزێ	لفظ
لەقوو	لقو
لەقی	لقي
لەقێ	لق
لەقێوە	لقو
لەقە	لق
لەم	لم
لەمەم	لمم
لەندەن	لندن
لەهجێن	لهجن
لەهجە	لهج
لەهجەی	لهجي
لەو	لو
لەونە	لون
لەوێ	لو
لەوە	لو
لەوەدا	لودا
لەوەی	لوي
لەکی	لكي
لەیل	ليل
لەیلێ	ليل
لەیەک	ليك
لەیەکێ	ليك
مئازا	ماذا
مئازی	ماضي
ما	ما
ماتڵ	ماطل
ماجد	ماجد
ماجدێ	ماجد
مادح	مادح
ماددێ	مادد
ماددە	مادد
مادی	مادي
مادیێ	مادي
مادە	ماد
مادەی	مادي
مادەیە	مادي
مارا	مارا
ماران	ماران
مارانە	ماران
مارتا	مارتا
مارسی	مارسي
مارسەی	مارسي
مارکسی	ماركسي
مارۆنە	مارون
ماری	ماري
ماریا	ماريا
مارەی	ماري
مازن	مازن
مازی	ماضي
ماس	ماس
ماسکێ	ماسك
ماسەر	مآثر
ماش	ماش
ماشین	ماشين
ماشینێ	ماشين
مالکیە	مالكي
مان	مان
مانێ	مان
ماهی	ماهي
ماویە	مآوي
ماوێ	ماو
ماوێو	ماو
ماوێوی	مآوي
ماوێوە	ماو
ماوە	ماو
ماوەو	ماو
ماوەی	مآوي
ماوەیە	مآوي
ماڕا	مارا
ماڕان	ماران
ماڕانێ	ماران
ماڕی	ماري
ماڕیا	ماريا
ماڕێ	مار
ماڕێنێ	مارن
ماڵ	مال
ماڵا	مالآ
ماڵی	مالي
ماڵە	مال
ماڵەی	مالي
مای	ماي
مایک	مايك
مایە	ماي
مایەو	مايو
مایەوە	مايو
مت	مت
متابقە	مطابق
متاوی	مطاوي
متە	مت
متەی	مطي
متەیرە	مطير
مجتەمع	مجتمع
مجلس	مجلس
مجیێر	مجير
مجیێرە	مجير
مجێێرە	مجر
مجەسە	مجس
محاڵە	محال
محلی	محلي
محمد	محمد
محمود	محمود
محمەد	محمد
محکەمە	محكم
محی	محي
محەمەد	محمد
مدا	مدا
مدان	مدان
مدانێ	مدان
مدانە	مدان
مدرێ	مدر
مدۆنە	مدون
مدێمێنە	مدمن
مدەونە	مدون
مرانە	مران
مرحلە	مرحل
مرد	مرد
مرغ	مرغ
مرو	مرو
مرونە	مرون
مرۆ	مرو
مرۆیێ	مروي
مریەم	مريم
مزاحم	مزاحم
مزاف	مضاف
مستمر	مستمر
مستەر	مسطر
مستەشار	مستشار
مستەشارە	مستشار
مستەوفی	مستوفي
مسر	مسر
مسرج	مسرج
مسری	مثري
مسعود	مسعود
مسقاڵە	مثقال
مسیا	مسيا
مسەلێ	مثل
مشار	مشار
مشانە	مشان
مشت	مشت
مشتێ	مشط
مشمەر	مشمر
مشیانە	مشيان
مشەمەرێ	مشمر
معنی	معني
معین	معين
مفاخر	مفاخر
مفتی	مفتي
مقدم	مقدم
مقدەم	مقدم
مقەدەم	مقدم
مل	مل
ملا	ملا
ملانە	ملآن
ملدێ	ملد
مللەتێ	مللت
ملم	ملم
ململانێ	ململان
ملمێ	ملم
ملونە	ملون
ملکی	ملكي
ملۆنە	ملون
ملی	ملي
ملیار	مليار
ملیارێ	مليار
ملیۆن	مليون
ملیۆنێ	مليون
ملەتە	ملط
ملەتەیە	ملطي
ملەد	ملد
ملەنە	ملن
من	من
منبع	منبع
منبەری	منبري
منی	مني
منیا	منيا
منیانە	منيان
منە	من
منەنە	منن
منەوەر	منور
مه	مه
مهم	مهم
مورفیم	مورفيم
مورفیمە	مورفيم
موری	موري
موس	موس
موسا	موسا
موسڵ	موصل
موسڵەنە	موثلن
موسیقی	موسيقي
موشک	موشك
موشی	موشي
موشەک	موشك
موشەکێ	موشك
مولەق	مولق
موهێمە	موهم
مووسڵ	موصل
مووشی	موشي
مووشیەنە	موشين
مووشەکێ	موشك
مووشەکە	موشك
موەقەتێ	موقت
مڕو	مرو
مڕێ	مر
مڕە	مر
مڕەن	مرن
مکەران	مكران
مکەرانە	مكران
مکەرمێ	مكرم
مڵ	مل
مڵک	ملك
مڵکێ	ملك
مڵیۆن	مليون
مڵەی	ملي
مۆد	مود
مۆرفیم	مورفيم
مۆرفیمە	مورفيم
مۆرە	مور
مۆسکۆ	موسكو
مۆمن	مومن
مۆناکۆ	موناكو
مۆهم	موهم
مۆهێم	موهم
مۆڵی	مولي
مۆڵێ	مول
می	مي
میا	ميا
میت	ميت
میتری	ميتري
میتی	ميطي
میتە	ميت
میدان	ميدان
میر	مير
میراس	ميراث
میراسێ	ميراث
میرێ	مير
میزان	ميزان
میسان	ميسان
میسر	ميسر
میلی	ميلي
میلەت	ميلت
میلەتە	ميلت
میونخ	ميونخ
میکانیکیێ	ميكانيكي
میە	مي
مێ	م
مێسر	مصر
مێللەت	مللت
مێللەتە	مللت
مێمڵ	ممل
مێنبەری	منبري
مێوانی	مواني
مە	م
مەئاست	ماست
مەئەیا	ميا
مەبارەک	مبارك
مەبروکە	مبروك
مەبەست	مبسط
مەترێ	متر
مەتن	متن
مەتڵوب	مطلوب
مەتی	مطي
مەتین	متين
مەتە	مت
مەتەرسە	مترس
مەتەڵی	متلي
مەجبور	مجبور
مەجبورێ	مجبور
مەجدی	مجدي
مەجرووم	مجروم
مەجنون	مجنون
مەجنوون	مجنون
مەجید	مجيد
مەحال	محال
مەحاڵێ	محال
مەحاڵە	محال
مەحفەل	محفل
مەحمدە	محمد
مەحمود	محمود
مەحموود	محمود
مەحمەد	محمد
مەحکوم	محكوم
مەحکومێ	محكوم
مەحکووم	محكوم
مەحکەمە	محكم
مەحیە	محي
مەحەمەد	محمد
مەخزەنێ	مخزن
مەخمور	مخمور
مەخموور	مخمور
مەخوور	مخور
مەد	مد
مەدا	مدا
مەداد	مداد
مەدادێ	مداد
مەدار	مدار
مەدان	مدان
مەدانێ	مدان
مەدرەسێ	مدرس
مەدرەسەی	مدرسي
مەدنیێ	مدني
مەدۆنە	مدون
مەدیۆنە	مديون
مەدێمێنە	مدمن
مەدەنی	مدني
مەدەنیێ	مدني
مەدەنیە	مدني
مەدەنێ	مدن
مەدەیمێ	مديم
مەر	مر
مەرابێ	مرآب
مەراسم	مراسم
مەراسمێ	مراسم
مەراسیم	مراسيم
مەراسیمێ	مراسيم
مەرام	مرام
مەرامی	مرامي
مەران	مران
مەرج	مرج
مەرجان	مرجان
مەرجێ	مرج
مەرجەعە	مرجع
مەرجەی	مرجي
مەرد	مرد
مەردا	مردا
مەردێنێ	مردن
مەردە	مرد
مەردەن	مردن
مەردەی	مردي
مەرز	مرض
مەرزی	مرضي
مەرزە	مرض
مەرعی	مرعي
مەرو	مرو
مەرکەز	مركز
مەرکەزی	مركزي
مەریەم	مريم
مەرەخەس	مرخص
مەرەزی	مرضي
مەرەزە	مرض
مەزار	مضار
مەزارێ	مضار
مەزاق	مذاق
مەزانێ	مضان
مەزبوت	مضبوط
مەزرێ	مذر
مەزلووم	مظلوم
مەزلۆم	مظلوم
مەزن	مضن
مەزنی	مضني
مەزنێ	مضن
مەزهەب	مذهب
مەزهەبێ	مذهب
مەزهەر	مزهر
مەزڵوم	مظلوم
مەزین	مزين
مەزە	مذ
مەزەی	مضي
مەست	مست
مەستوورە	مستور
مەسرەف	مصرف
مەسرەفی	مصرفي
مەسعود	مسعود
مەسفت	مسفط
مەسلێ	مثل
مەسلەک	مثلك
مەسوت	مصوت
مەسوولە	مثول
مەسیر	مصير
مەسەدەی	مسدي
مەسەلا	مسلا
مەسەلان	مثلان
مەسەلێ	مثل
مەسەلە	مثل
مەسەلەن	مسلن
مەسەلەکێ	مثلك
مەسەلەکە	مثلك
مەسەلەی	مثلي
مەسەڵەن	مسلن
مەش	مش
مەشا	مشا
مەشق	مشق
مەشقی	مشقي
مەشهەد	مشهد
مەشی	مشي
مەشیا	مشيا
مەعدووم	معدوم
مەعروف	معروف
مەعسوم	معصوم
مەعسووم	معصوم
مەعفی	معفي
مەعنەوی	معنوي
مەعەنەوی	معنوي
مەغرێبی	مغربي
مەفاهیمی	مفاهيمي
مەفاهیمە	مفاهيم
مەفتەم	مفطم
مەفعول	مفعول
مەفهومی	مفهومي
مەقالێ	مقال
مەقالەی	مقالي
مەقسەد	مقصد
مەلا	ملا
مەلاح	ملاح
مەلانە	ملآن
مەلوا	ملوا
مەلونە	ملون
مەلوک	ملوك
مەلۆنە	ملون
مەلیک	مليك
مەلیکە	مليك
مەلێ	مل
مەلەتی	ملطي
مەلەفێ	ملف
مەلەکان	ملكان
مەمدوح	ممدوح
مەمەد	ممد
مەن	من
مەنار	منار
مەنافی	منافي
مەندەبێ	مندب
مەنزومە	منظوم
مەنزڵ	منزل
مەنسوور	منصور
مەننەن	مننن
مەنیا	منيا
مەنیان	منيان
مەنێنی	منني
مەنێنێ	منن
مەنێنە	منن
مەنەن	منن
مەنەنا	مننا
مەنەی	مني
مەهد	مهد
مەهدی	مهدي
مەوات	موات
مەواتە	موات
مەواردێ	موارد
مەوج	موج
مەوجە	موج
مەوزۆنە	موزون
مەوسا	موسا
مەوسی	موصي
مەولان	مولان
مەولود	مولود
مەولی	مولي
مەولەوی	مولوي
مەوەرا	مورا
مەوەران	موران
مەوەرای	موراي
مەڕ	مر
مەڕاسیم	مراسيم
مەڕاسیمێ	مراسيم
مەڕمەڕە	مرمر
مەڕوو	مرو
مەڕێ	مر
مەڕەەنە	مرن
مەکان	مكان
مەکتەب	مكتب
مەکتەبە	مكتب
مەکرانێ	مكران
مەکریێ	مكري
مەکفی	مكفي
مەککەی	مككي
مەکۆکی	مكوكي
مەکین	مكين
مەکەر	مكر
مەکەرا	مكرا
مەکەران	مكران
مەکەرانێ	مكران
مەکەرانە	مكران
مەکەرمێ	مكرم
مەکەری	مكري
مەکەرێ	مكر
مەکەرێنێ	مكرن
مەکەرێنە	مكرن
مەکەرە	مكر
مەکەن	مكن
مەکەوت	مكوت
مەکەوتە	مكوت
مەڵا	ملا
مەڵێ	مل
مەی	مي
مەیا	ميا
مەیدان	ميدان
مەیدانێ	ميدان
مەیسەر	ميسر
مەیمێنە	ميمن
مەێ	م
نائب	نائب
نابێت	نابت
ناتقەن	ناطقن
ناجح	ناجح
ناجع	ناجع
ناجی	ناجي
ناجە	ناج
ناحیە	ناحي
نادر	نادر
نادەن	نادن
نارا	نارا
ناز	ناض
نازا	ناضا
نازمە	ناظم
نازک	نازك
نازی	نازي
ناسر	ناثر
ناسری	ناصري
ناسریە	ناصري
ناسک	ناسك
ناشدە	ناشد
نافع	نافع
نالان	نالان
نالی	نالي
نام	نام
ناما	ناما
نامان	نامان
نامش	نامش
نامق	نامق
نامووس	ناموس
نامی	نامي
نامیێ	نامي
نامێ	نام
نامێش	نامش
نامێق	نامق
نامێن	نامن
نامێنە	نامن
نامە	نام
نامەی	نامي
نامەیە	نامي
ناهەق	ناهق
ناوی	ناوي
ناوەش	ناوش
ناوەشی	ناوشي
ناڵە	نال
ناڵەی	نالي
نایف	نايف
نایل	نايل
نایەف	نايف
نبیل	نبيل
نتم	نتم
نجاری	نجاري
نجی	نجي
ندیم	نديم
نرخو	نرخو
نرخوو	نرخو
نریێ	نري
نریێنێ	نرين
نزار	نزار
نزمی	نظمي
نزمیەنە	نذمين
نساری	نساري
نسبەت	نصبت
نسێبین	نسبين
نش	نش
نشین	نشين
نشینا	نشينا
نعمە	نعم
نفر	نفر
نفرین	نفرين
نفووس	نفوس
نقشە	نقش
نقم	نقم
نقمێ	نقم
نما	نما
نمارە	نمار
نماکەر	نماكر
نمو	نمو
نمونا	نمونا
نمونێ	نمون
نمونە	نمون
نموونێ	نمون
نموونە	نمون
نموونەن	نمونن
نمک	نمك
نمێ	نم
نمەلدێ	نملد
نمەو	نمو
نمەی	نمي
نمەیا	نميا
نمەیانێ	نميان
نمەیانە	نميان
نمەینە	نمين
نه	نه
نهاد	نهاد
نوام	نوام
نود	نود
نورا	نورا
نوری	نوري
نوسخێ	نوسخ
نوسخە	نوسخ
نوسرە	نوسر
نوش	نوش
نوعی	نوعي
نوقل	نوقل
نونە	نون
نوورانی	نوراني
نووری	نوري
نووسەر	نوسر
نووسەرە	نوسر
نوی	نوي
نوین	نوين
نویەنە	نوين
نوێ	نو
نوێسنا	نوسنا
نوێسە	نوس
نوێشان	نوشان
نوێنی	نوني
نوێی	نوي
نوە	نو
نوەی	نوي
نڕخ	نرخ
نڕخە	نرخ
نۆبە	نوب
نۆش	نوش
نۆشا	نوشا
نۆع	نوع
نۆعێ	نوع
نۆقتە	نوقت
نۆکەرێ	نوكر
نۆکەرە	نوكر
نۊ	نو
نۊش	نوش
نۊشان	نوشان
نۊی	نوي
نۊین	نوين
نۊینێ	نوين
نی	ني
نیا	نيا
نیابیێ	نيابي
نیارە	نيار
نیان	نيان
نیروز	نيروز
نیشا	نيشا
نیشانێ	نيشان
نیشانە	نيشان
نیشت	نيشت
نیشتێ	نيشت
نیلسۆن	نيلسون
نیلوفەر	نيلوفر
نیم	نيم
نیمێ	نيم
نیمە	نيم
نیمەن	نيمن
نیمەنە	نيمن
نین	نين
نیه	نيه
نیۆیۆرکی	نيويوركي
نیێ	ني
نیێبێ	نيب
نیێبێنێ	نيبن
نیێر	نير
نیێرە	نير
نیێنێ	نين
نیێنە	نين
نیێوە	نيو
نیە	ني
نیەن	نين
نیەنان	نينان
نیەنێ	نين
نیەنە	نين
نیەو	نيو
نێ	ن
نێبیێ	نبي
نێت	نت
نێتجە	نتج
نێتی	نتي
نێتیەنە	نطين
نێر	نر
نێرو	نرو
نێری	نري
نێزامی	نظامي
نێزامە	نظام
نێعمەتا	نعمتا
نێعمەتم	نعمتم
نێمەو	نمو
نە	ن
نەئامێنێ	نامن
نەبا	نبآ
نەباتێ	نبات
نەبان	نبان
نەبانێ	نبان
نەبانە	نبان
نەبرێت	نبرت
نەبرێن	نبرن
نەبونە	نبون
نەبووە	نبو
نەبڕیێ	نبري
نەبڕیێنە	نبرين
نەبۆ	نبو
نەبۆنە	نبون
نەبۆی	نبوي
نەبی	نبي
نەبینێ	نبين
نەبیێ	نبي
نەبیێنێ	نبين
نەبیێنە	نبين
نەبیەن	نبين
نەبێ	نب
نەبێنا	نبنا
نەبێنێ	نبن
نەبێنە	نبن
نەبەتی	نبطي
نەبەردێنێ	نبردن
نەبەردە	نبرد
نەبەز	نبذ
نەترازیێنە	نتراضين
نەتەرس	نطرس
نەتەرسە	نطرس
نەتەوا	نتوا
نەتەوانە	نتوان
نەتەوێ	نتو
نەتەوێونە	نتون
نەتەوێوە	نتو
نەتەوە	نتو
نەتەوەو	نتو
نەتەوەى	نطوى
نەتەوەی	نطوي
نەتەوەینە	نطوين
نەتەوەیێ	نطوي
نەتەوەیە	نطوي
نەتەوەیەنە	نطوين
نەتەوەێوە	نتو
نەتەوەەی	نطوي
نەجات	نجات
نەجاح	نجاح
نەجدەت	نجدت
نەجلا	نجلا
نەجیب	نجيب
نەجیبە	نجيب
نەجەف	نجف
نەجەفو	نجفو
نەخا	نخا
نەخاسە	نخاس
نەخش	نخش
نەخشش	نخشش
نەخشنێ	نخشن
نەخشە	نخش
نەخشەش	نخشش
نەخشەی	نخشي
نەدا	ندا
نەدار	ندار
نەداری	نداري
نەدارینە	ندارين
نەداریەن	ندارين
نەدان	ندان
نەدانە	ندان
نەدریێنێ	ندرين
نەدریێنە	ندرين
نەدۆنە	ندون
نەدیم	نديم
نەدیەن	ندين
نەدێبێنێ	ندبن
نەدێنێ	ندن
نەدەیمێ	نديم
نەرم	نرم
نەرمی	نرمي
نەرمین	نرمين
نەروی	نروي
نەرویج	نرويج
نەرێنی	نرني
نەرێنیە	نرني
نەرەی	نري
نەزان	نزان
نەزانێنە	نزانن
نەزانەن	نزانن
نەزم	نظم
نەزیرێ	نزير
نەزەری	نظري
نەزەریێ	نظري
نەزەرەو	نذرو
نەسر	نسر
نەسروو	نسرو
نەسری	نصري
نەسرە	نسر
نەسلی	نصلي
نەسڵ	نصل
نەسڵەو	نسلو
نەسیم	نسيم
نەسین	نصين
نەسەبی	نسبي
نەشۆنە	نشون
نەشێونێ	نشون
نەفرەت	نفرت
نەفسو	نفسو
نەفسی	نفسي
نەفی	نفي
نەفەران	نفران
نەفەری	نفري
نەفەرێ	نفر
نەفەرێنێ	نفرن
نەفەرە	نفر
نەقش	نقش
نەقشی	نقشي
نەقشێ	نقش
نەقڵ	نقل
نەقڵی	نقلي
نەقیب	نقيب
نەلان	نلان
نەلۆ	نلو
نەلی	نلي
نەلێ	نل
نەلێنێ	نلن
نەما	نما
نەمام	نمام
نەمامێ	نمام
نەمامە	نمام
نەمسا	نمسا
نەملەکێ	نملك
نەمو	نمو
نەمی	نمي
نەمەدەن	نمدن
نەمەن	نمن
نەمەنا	نمنا
نەمەنێنێ	نمنن
نەمەنێنە	نمنن
نەمەنە	نمن
نەمەنەن	نمنن
نەمەنەی	نمني
نەهادینە	نهادين
نەهایەتەن	نهايطن
نەو	نو
نەوا	نوا
نەوت	نوط
نەوتێ	نوط
نەوتەن	نوطن
نەوتەی	نوتي
نەورۆز	نوروز
نەوینان	نوينان
نەویێبێ	نويب
نەویەن	نوين
نەوێ	نو
نەوێوە	نو
نەوە	نو
نەوەدی	نودي
نەوەدینە	نودين
نەوەش	نوش
نەوەشا	نوشا
نەوەشی	نوشي
نەوەشیێ	نوشي
نەوەشیە	نوشي
نەوەشێ	نوش
نەوەشە	نوش
نەوەشەن	نوشن
نەوەشەکێ	نوشك
نەوەو	نو
نەوەی	نوي
نەکا	نكآ
نەکات	نكات
نەکریێ	نكري
نەکریێنێ	نكرين
نەکریێنە	نكرين
نەکرێبێنێ	نكربن
نەکرێن	نكرن
نەکڕیێنێ	نكرين
نەکەرا	نكرا
نەکەرانێ	نكران
نەکەرانە	نكران
نەکەرۆ	نكرو
نەکەرۆنە	نكرون
نەکەری	نكري
نەکەرێ	نكر
نەکەرێنێ	نكرن
نەکەفتەن	نكفتن
نەی	ني
نەیار	نيار
نەیانە	نيان
نەیجیریا	نيجيريا
نەیۆ	نيو
نەیۆنە	نيون
ها	ها
هات	هات
هادی	هادي
هار	هار
هارەق	هارق
هارەقە	هارق
هاز	هاز
هازی	هاذي
هازێ	هاز
هاست	هاثت
هاشم	هاشم
هاشمی	هاشمي
هام	هام
هامتا	هامتا
هامسا	هامسا
هامشی	هامشي
هامڕا	هامرا
هامڕان	هامران
هامڕی	هامري
هامڕێ	هامر
هان	هان
هانا	هانا
هانی	هاني
هانێ	هان
هانە	هان
هانەی	هاني
هاوەنێ	هاون
هاڕوون	هارون
هاڵی	هالي
هایتی	هايتي
هجووم	هجوم
هر	هر
هرێمێ	هرم
هزار	هزار
هزر	هزر
هزرە	هذر
هست	هست
هفت	هفت
هفتن	هفتن
همان	همان
همە	هم
هندی	هندي
هنری	هنري
هنی	هني
هنە	هن
هه	هه
هوتەرە	هوتر
هور	هور
هوری	هوري
هوز	هوز
هولی	هولي
هون	هون
هوور	هور
هوون	هوون
هوونی	هوني
هوڵ	هول
هویت	هويط
هویەت	هويط
هکتارێ	هكتار
هۆ	هو
هۆر	هور
هۆرمۆنێ	هورمون
هۆرە	هور
هۆز	هوز
هۆزان	هوزان
هۆزێ	هوز
هۆش	هوش
هۆشی	هوشي
هۆشەیێ	هوشي
هۆلەندا	هولندا
هۆنیێ	هوني
هۆنەی	هوني
هۆڕ	هور
هۆڵ	هول
هۆڵێ	هول
هۆڵەندا	هولندا
هۆی	هوي
هیتان	هيطان
هیج	هيج
هیزی	هيضي
هیزێ	هيض
هیزە	هيض
هیسی	هيثي
هیشتا	هيشتا
هیما	هيما
هیمان	هيمان
هینێ	هين
هێرسک	هرسك
هێرش	هرش
هێرشا	هرشا
هێرشان	هرشان
هێرشانە	هرشان
هێرشی	هرشي
هێرشێ	هرش
هێرشە	هرش
هێز	هز
هێزا	هذا
هێزانە	هذان
هێزمێ	هزم
هێزی	هذي
هێزێ	هز
هێزە	هز
هێشا	هشا
هێشتا	هشتا
هێلەکێ	هلك
هێمێ	هم
هێمەت	همت
هێنا	هنا
هێنان	هنان
هێندی	هندي
هێندە	هند
هێندەی	هندي
هێڕشیە	هرشي
هێڕشێ	هرش
هێکتارێ	هكتار
هێڵ	هل
هێڵانێ	هلان
هێڵی	هلي
هێڵێ	هل
هێڵە	هل
هێڵەی	هلي
هەبوو	هبو
هەبووە	هبو
هەتا	هتا
هەج	هج
هەجێجی	هججي
هەدن	هدن
هەدیا	هديا
هەدەف	هدف
هەر	هر
هەرئی	هري
هەرتا	هرتا
هەرجە	هرج
هەرد	هرد
هەرس	هرس
هەرسی	هرسي
هەرسێن	هرسن
هەرمان	هرمان
هەرمانێ	هرمان
هەرمانە	هرمان
هەرمە	هرم
هەروڵی	هرولي
هەری	هري
هەرێ	هر
هەرێم	هرم
هەرێمنە	هرمن
هەرێمی	هرمي
هەرێمیێ	هرمي
هەرێمێ	هرم
هەرێمە	هرم
هەرێمەنە	هرمن
هەرێمەیێ	هرمي
هەرێمەیە	هرمي
هەرە	هر
هەرەشا	هرشا
هەرەمە	هرم
هەزار	هزار
هەزارێ	هزار
هەزر	هذر
هەس	هس
هەسان	هسان
هەست	هست
هەستێ	هست
هەستەنە	هستن
هەسێنە	هسن
هەسەن	هسن
هەشت	هشت
هەشتێ	هشت
هەفت	هفت
هەفتا	هفتا
هەفتێ	هفت
هەفتە	هفت
هەفتەن	هفتن
هەفتەنە	هفتن
هەل	هل
هەلەن	هلن
هەم	هم
هەما	هما
هەمامێ	همام
هەمان	همان
هەمانێ	همان
هەمزە	همز
هەمشە	همش
هەمین	همين
هەمیەت	هميت
هەمێشە	همش
هەمە	هم
هەمەدان	همدان
هەن	هن
هەنا	هنا
هەنت	هنت
هەند	هند
هەندت	هندت
هەندم	هندم
هەندی	هندي
هەندێ	هند
هەنری	هنري
هەنی	هني
هەنێ	هن
هەنێتا	هنتا
هەنە	هن
هەنەن	هنن
هەو	هو
هەوا	هوا
هەواس	هواس
هەواش	هواش
هەواڵەکە	هوالك
هەور	هور
هەوڵ	هول
هەوڵی	هولي
هەوڵێ	هول
هەوڵێنە	هولن
هەوڵە	هول
هەوڵەنە	هولن
هەوڵەی	هولي
هەویە	هوي
هەوێڵ	هول
هەڕ	هر
هەڕێمی	هرمي
هەڕە	هر
هەڕەبان	هربان
هەڕەشا	هرشا
هەڕەشێ	هرش
هەڕەشە	هرش
هەڵا	هلا
هەڵێ	هل
هەڵە	هل
هەڵەن	هلن
هەڵەنە	هلن
هەڵەکێ	هلك
هەڵەی	هلي
هەڵەیە	هلي
هەی	هي
هەیئەت	هيت
هەیفا	هيفا
هەین	هين
هەیە	هي
هەیەر	هير
و	و
وئا	وا
وا	وا
واتا	واطآ
واتێنێ	واطن
واتێنە	واطن
واتەن	واطن
واتەنی	واطني
واحد	واحد
وادە	واد
وار	وار
وارد	وارد
واردێ	وارد
واردێنە	واردن
واردەن	واردن
واردەی	واردي
واری	واري
وارین	وارين
وارە	وار
واز	واز
وازی	وازي
وازە	وآض
واستێ	واسط
واستە	واسط
واقعنە	واقعن
واقعی	واقعي
واقێعی	واقعي
واقێعەنە	واقعن
والی	والي
وانی	واني
واوی	واوي
واوەی	واوي
واڕ	وار
واڵ	وال
واڵێ	وال
واڵە	وال
واڵەی	والي
وبە	وب
وبەش	وبش
وت	وط
وتارێ	وتار
وتارە	وتار
وتن	وتن
وتی	وتي
وتە	وط
وتەن	وطن
وتەنی	وطني
وتەی	وتي
وجه	وجه
وجوود	وجود
وجوودی	وجودي
وجە	وج
ور	ور
ورد	ورد
وردی	وردي
وردە	ورد
وردەن	وردن
وردەی	وردي
ورشە	ورش
ورف	ورف
ورمێ	ورم
ورک	ورك
ورکە	ورك
وریا	وريا
ورێشان	ورشان
ورە	ور
ورەتێنە	ورطن
ورەش	ورش
وزا	وذا
وزمێ	وذم
وزمێنە	وضمن
وزنی	وزني
وزو	وذو
وزوو	وذو
وزۆ	وذو
وزی	وذي
وزیا	وذيا
وزینێ	وذين
وزیێرێ	وزير
وزیێنێ	وذين
وزیێنە	وذين
وزێ	وز
وزێنێ	وزن
وزە	وز
وس	وص
وسات	وساط
وست	وست
وستێ	وسط
وستێنێ	وسطن
وستەن	وسطن
وستەنە	وسطن
وستەی	وسطي
وسینە	وصين
وشک	وشك
وشکێ	وشك
وشکە	وشك
وشە	وش
ول	ول
ولا	ولا
ولی	ولي
ولیان	وليان
ون	ون
ونی	وني
ونێ	ون
ونە	ون
وو	و
ووڵات	ولات
ووڵاتە	ولات
وڕێ	ور
وڕێنێ	ورن
وڵات	ولات
وڵاتێ	ولات
وڵاتە	ولات
وڵک	ولك
وڵێ	ول
وڵە	ول
ویس	ويس
ویه	ويه
وێ	و
وێت	وط
وێتا	وطا
وێتان	وتان
وێتانە	وتان
وێحەن	وحن
وێر	ور
وێرە	ور
وێزینێ	وذين
وێزە	وز
وێسەر	وثر
وێسەرانە	وثران
وێسەری	وثري
وێش	وش
وێشین	وشين
وێشەرە	وشر
وێشەن	وشن
وێشەنە	وشن
وێما	وما
وێنێ	ون
وێنە	ون
وێنەی	وني
وێورەشێ	ورش
وێورەشە	ورش
وێڵ	ول
وێڵۆ	ولو
وە	و
وەبەر	وبر
وەتەن	وطن
وەتەنی	وطني
وەحشی	وحشي
وەحشەتم	وحشتم
وەحید	وحيد
وەخت	وخط
وەختا	وخطا
وەختنە	وخطن
وەختێ	وخط
وەختێنە	وخطن
وەختە	وخط
وەختەنە	وخطن
وەر	ور
وەرتێ	ورط
وەرد	ورد
وەردەی	وردي
وەرف	ورف
وەرم	ورم
وەرما	ورما
وەرمی	ورمي
وەرمەنە	ورمن
وەرنە	ورن
وەروەکێ	وروك
وەرۆرە	ورور
وەری	وري
وەریان	وريان
وەرین	ورين
وەرینان	ورينان
وەرینە	ورين
وەرێ	ور
وەرێسە	ورس
وەرێما	ورما
وەرێنە	ورن
وەرە	ور
وەرەوەرەی	وروري
وەرەکا	وركا
وەز	وز
وەزعەی	وضعي
وەزی	وذي
وەزیر	وزير
وەزیرێ	وزير
وەزیفەی	وظيفي
وەزیە	وذي
وەستان	وسطان
وەسف	وصف
وەسفی	وثفي
وەسفێن	وصفن
وەسێن	وثن
وەش	وش
وەشت	وشت
وەشما	وشما
وەشی	وشي
وەشیتا	وشيتا
وەشین	وشين
وەشێ	وش
وەشە	وش
وەشەن	وشن
وەشەنە	وشن
وەشەکان	وشكان
وەفا	وفا
وەفد	وفد
وەل	ول
وەلا	ولا
وەلات	ولات
وەلاتە	ولات
وەلی	ولي
وەلێ	ول
وەلێم	ولم
وەلەدی	ولدي
وەن	ون
وەنی	وني
وەنێنێ	ونن
وەنە	ون
وەنەن	ونن
وەنەنێ	ونن
وەنەی	وني
وەهابی	وهابي
وەهابیێ	وهابي
وەهم	وهم
وەهما	وهما
وەڵ	ول
وەڵا	ولا
وەڵات	ولات
وەڵاتێ	ولات
وەڵاتە	ولات
وەڵی	ولي
وەڵین	ولين
وەڵینە	ولين
وەڵێ	ول
وەڵێنە	ولن
وەڵێو	ولو
وەڵە	ول
وەڵەد	ولد
وەی	وي
وەیلان	ويلان
ڕا	رآ
ڕائدی	رادي
ڕادار	رادار
ڕادیو	راديو
ڕادیکاڵی	راديكالي
ڕادیۆ	راديو
ڕادێ	راد
ڕاز	راض
ڕازا	راضا
ڕازی	راضي
ڕازیێ	راضي
ڕازێ	راض
ڕازە	راض
ڕازەم	رازم
ڕازەیە	راضي
ڕاس	راص
ڕاسا	راسا
ڕاست	راست
ڕاستێ	راست
ڕاستە	راست
ڕاسی	راسي
ڕاسێ	راص
ڕاسێنێ	راسن
ڕاسە	راص
ڕاسەن	راسن
ڕاش	راش
ڕاشا	راشا
ڕام	رام
ڕامەن	رامن
ڕان	ران
ڕانە	ران
ڕاکێم	راكم
ڕاە	رآ
ڕبەق	ربق
ڕتوو	رتو
ڕجا	رجا
ڕحا	رحا
ڕحاب	رحاب
ڕخت	رخت
ڕزقت	رزقت
ڕست	رثت
ڕستە	رثت
ڕستەما	رثتما
ڕستەنە	رثتن
ڕسەنێ	رسن
ڕشا	رشا
ڕشفەت	رشفت
ڕشید	رشيد
ڕمان	رمان
ڕمز	رمز
ڕو	رو
ڕوا	روا
ڕوبە	روب
ڕوحی	روحي
ڕوز	روض
ڕوسی	روسي
ڕوسیا	روسيا
ڕوشن	روشن
ڕوشنە	روشن
ڕومانێ	رومان
ڕوو	رو
ڕووا	روا
ڕووبە	روب
ڕووت	روت
ڕووتە	روت
ڕووسی	روسي
ڕووسیا	روسيا
ڕووشان	روشان
ڕووی	روي
ڕووێ	رو
ڕووێش	روش
ڕووێشان	روشان
ڕووێشەنە	روشن
ڕووێن	رون
ڕووێنە	رون
ڕووە	رو
ڕووەش	روش
ڕووەشان	روشان
ڕووەن	رون
ڕوی	روي
ڕوینە	روين
ڕوێ	رو
ڕوێما	روما
ڕوێن	رون
ڕوێنە	رون
ڕوێو	رو
ڕوێوی	روي
ڕوێوە	رو
ڕوێوەن	رون
ڕوێوەنە	رون
ڕوە	رو
ڕوەداێ	رودا
ڕوەش	روش
ڕوەشا	روشا
ڕوەمان	رومان
ڕوەنە	رون
ڕوەو	رو
ڕوەیە	روي
ڕۆ	رو
ڕۆبێەرت	روبرت
ڕۆح	روح
ڕۆحانی	روحاني
ڕۆحی	روحي
ڕۆحێ	روح
ڕۆحە	روح
ڕۆدی	رودي
ڕۆسەم	روسم
ڕۆشن	روشن
ڕۆشنە	روشن
ڕۆشین	روشين
ڕۆشەنە	روشن
ڕۆمان	رومان
ڕۆمانسیێ	رومانسي
ڕۆمانێ	رومان
ڕۆمانە	رومان
ڕۆنە	رون
ڕۆڵ	رول
ڕۆڵی	رولي
ڕۆڵێ	رول
ڕۆڵە	رول
ڕۆی	روي
ڕۆیە	روي
ڕۆیەنە	روين
ڕیز	ريض
ڕیزێ	ريض
ڕیش	ريش
ڕیشە	ريش
ڕیشەی	ريشي
ڕێ	ر
ڕێباز	رباض
ڕێبازێ	رباض
ڕێبە	رب
ڕێخەو	رخو
ڕێخەی	رخي
ڕێز	رز
ڕێزان	رزان
ڕێزوو	رضو
ڕێزی	رضي
ڕێزەوە	رضو
ڕێسۆ	رسو
ڕێسیا	رصيا
ڕێشە	رش
ڕێشەی	رشي
ڕێنە	رن
ڕێوە	رو
ڕێک	رك
ڕێکوزێ	ركوض
ڕێکێ	رك
ڕێکەوتن	ركوتن
ڕێکەون	ركون
ڕێیان	ريان
ڕەت	رت
ڕەتێ	رت
ڕەجەب	رجب
ڕەحم	رحم
ڕەحمان	رحمان
ڕەحمی	رحمي
ڕەحمەت	رحمت
ڕەحمەنە	رحمن
ڕەحەت	رحت
ڕەحەتەن	رحتن
ڕەختێ	رخت
ڕەخسنا	رخصنا
ڕەخنە	رخن
ڕەدا	ردا
ڕەز	رز
ڕەزا	رضا
ڕەزان	رزان
ڕەس	رث
ڕەسانە	رصان
ڕەسانەێ	رصان
ڕەستە	رثت
ڕەسم	رسم
ڕەسمی	رسمي
ڕەسول	رسول
ڕەسولی	رسولي
ڕەسەن	رسن
ڕەسەنی	رصني
ڕەسەنێ	رسن
ڕەشت	رشت
ڕەشتەن	رشتن
ڕەشۆ	رشو
ڕەشید	رشيد
ڕەشەمە	رشم
ڕەفت	رفت
ڕەفعەت	رفعت
ڕەفیق	رفيق
ڕەق	رق
ڕەقا	رقا
ڕەقس	رقص
ڕەققا	رققا
ڕەقەنە	رقن
ڕەمز	رمز
ڕەمزی	رمزي
ڕەمێنێ	رمن
ڕەمەزان	رمضان
ڕەمەی	رمي
ڕەوا	روا
ڕەوت	روت
ڕەوتە	روت
ڕەوشی	روشي
ڕەوشەن	روشن
ڕەوشەی	روشي
ڕەون	رون
ڕەوو	رو
ڕەوە	رو
ڕەوەند	روند
ڤاتەن	واطن
ڤرەشی	ورشي
ڤیس	ويس
ڤەداد	وداد
ڤەر	ور
کابرا	كابرا
کات	كات
کاتب	كاتب
کاتۆلیک	كاتوليك
کاتێ	كات
کاتە	كات
کار	كار
کارا	كارا
کارت	كارت
کارم	كارم
کاره	كاره
کارڵ	كارل
کاری	كاري
کارێ	كار
کارێل	كارل
کارێم	كارم
کارە	كار
کارەیە	كاري
کازاخستان	كازاخستان
کازم	كاظم
کاس	كاس
کاسی	كاسي
کاسێتێ	كاست
کافرا	كافرا
کافرێ	كافر
کامل	كامل
کامڵ	كامل
کامی	كامي
کامێنێ	كامن
کامەن	كامن
کامەنە	كامن
کانتۆن	كانتون
کانێ	كان
کانە	كان
کاوەی	كاوي
کاڵ	كال
کاڵا	كالا
کاڵی	كالي
کاڵێ	كال
کاڵەبەی	كالبي
کتاب	كتاب
کتام	كتام
کتب	كتب
کتیب	كتيب
کتیبێ	كتيب
کتێب	كتب
کتێبی	كتبي
کتێبێ	كتب
کتێبە	كتب
کتێن	كتن
کتە	كت
کحول	كحول
کرا	كرا
کران	كران
کردی	كردي
کرما	كرما
کرمان	کرمان
کرکە	كرك
کرکەی	كركي
کرۆن	كرون
کری	كري
کریا	كريا
کریاێ	كريا
کریستیان	كريستيان
کریم	كريم
کرینێ	كرين
کریێ	كري
کریێن	كرين
کریێنێ	كرين
کریێنە	كرين
کریێێنێ	كرين
کریەنێ	كرين
کرێ	كر
کرێش	كرش
کرێنێ	كرن
کرێیێ	كري
کز	كز
کزنێ	كزن
کزی	كذي
کزەی	كذي
کسم	كثم
کشی	كشي
کفری	كفري
کفەی	كفي
کلارک	كلارك
کلاسیکی	كلاسيكي
کلاسیکەی	كلاسيكي
کلام	كلام
کلدانی	كلداني
کلسوومە	كلثوم
کلمن	كلمن
کلمە	كلم
کلیل	كليل
کلیە	كلي
کلێ	كل
کمال	كمال
کمامە	كمام
کنیا	كنيا
کهنە	كهن
کوبرا	كوبرا
کوت	كوت
کوتە	كوت
کود	كود
کودی	كودي
کور	كور
کورت	كورت
کورتە	كورت
کورتەنە	كورتن
کورێ	كور
کورە	كور
کورەمن	كورمن
کون	كون
کونجو	كونجو
کونە	كون
کونەن	كونن
کونەی	كوني
کوورێ	كور
کوڕ	كور
کوڕی	كوري
کوڕیە	كوري
کوڕێ	كور
کوڕە	كور
کوڕەی	كوري
کوک	كوك
کوە	كو
کوەیت	كويت
کڕو	كرو
کڵی	كلي
کۆ	كو
کۆت	كوت
کۆتا	كوتا
کۆر	كور
کۆرت	كورت
کۆسە	كوس
کۆسەی	كوسي
کۆشا	كوشا
کۆشەر	كوشر
کۆشەرێ	كوشر
کۆم	كوم
کۆما	كوما
کۆن	كون
کۆنت	كونت
کۆنفدڕالی	كونفدرالي
کۆنفوشیوس	كونفوشيوس
کۆنفوشیوسی	كونفوشيوسي
کۆنفۆشیوسی	كونفوشيوسي
کۆنی	كوني
کۆنێ	كون
کۆنە	كون
کۆنەن	كونن
کۆڕ	كور
کۆڕی	كوري
کۆڕێ	كور
کۆکێ	كوك
کۆی	كوي
کۆیلێ	كويل
کۆیلێنێ	كويلن
کۆیلەن	كويلن
کۆیە	كوي
کی	كي
کیری	كيري
کیرێت	كيرت
کیلۆمەتر	كيلومتر
کیلۆمەترێ	كيلومتر
کیمیاوی	كيمياوي
کیمیاویە	كيمياوي
کین	كين
کینیا	كينيا
کێ	ك
کێبێنێ	كبن
کێسە	كث
کێش	كش
کێشا	كشا
کێشان	كشان
کێشتێ	كشط
کێشتەن	كشطن
کێشێ	كش
کێشێنێ	كشن
کێشە	كش
کێشەکە	كشك
کێشەی	كشي
کێشەیە	كشي
کێلێ	كل
کێن	كن
کێنێ	كن
کێنە	كن
کە	ك
کەئی	كي
کەئیسە	كيس
کەئینا	كينا
کەباس	كباس
کەبسولە	كبسول
کەت	كت
کەتەن	كتن
کەد	كد
کەدێنێ	كدن
کەدەن	كدن
کەر	كر
کەرا	كرا
کەران	كران
کەرانێ	كران
کەرانە	كران
کەردی	كردي
کەردەی	كردي
کەردەیە	كردي
کەرمێ	كرم
کەرمێنە	كرمن
کەرمەی	كرمي
کەرو	كرو
کەروش	كروش
کەرون	كرون
کەروو	كرو
کەرووە	كرو
کەروە	كرو
کەرۆ	كرو
کەرۆش	كروش
کەرۆن	كرون
کەرۆنە	كرون
کەری	كري
کەریم	كريم
کەرینە	كرين
کەریێ	كري
کەریەنە	كرين
کەرێ	كر
کەرێنا	كرنا
کەرێنێ	كرن
کەرێوە	كرو
کەرە	كر
کەرەستێ	كرست
کەرەسێ	كرس
کەرەسە	كرس
کەرەسەی	كرسي
کەرەمی	كرمي
کەرەوەو	كرو
کەزبان	كذبان
کەس	كث
کەسا	كسا
کەسان	كثان
کەسانێ	كثان
کەسانە	كثان
کەسرەی	كثري
کەسما	كثما
کەسو	كسو
کەسوو	كسو
کەسۆ	كسو
کەسی	كثي
کەسیێ	كثي
کەسیە	كثي
کەسێ	كث
کەسێما	كثما
کەسێنێ	كثن
کەسێو	كسو
کەسێوی	كسوي
کەسێوە	كسو
کەسێوەنە	كسون
کەسێوەی	كسوي
کەسە	كث
کەسەر	كسر
کەسەن	كثن
کەسەنە	كثن
کەسەیە	كثي
کەش	كش
کەشف	كشف
کەشی	كشي
کەشێ	كش
کەشە	كش
کەشەکێ	كشك
کەفت	كفت
کەفتەن	كفتن
کەفەر	كفر
کەل	كل
کەلام	كلام
کەلمە	كلم
کەلک	كلك
کەلیمە	كليم
کەلێمێ	كلم
کەم	كم
کەما	كما
کەمال	كمال
کەمان	كمان
کەماڵ	كمال
کەمتە	كمت
کەمش	كمش
کەمشان	كمشان
کەمما	كمما
کەمی	كمي
کەمین	كمين
کەمینێ	كمين
کەمینە	كمين
کەمێ	كم
کەمێش	كمش
کەمێما	كمما
کەمە	كم
کەمەن	كمن
کەمەنە	كمن
کەن	كن
کەنەدا	كندا
کەنەی	كني
کەهەن	كهن
کەوت	كوت
کەوتا	كوتا
کەوتێ	كوت
کەوتێبێنێ	كوتبن
کەوتە	كوت
کەوتەبێ	كوتب
کەڕ	كر
کەڕت	كرت
کەڕەت	كرت
کەڕەتێ	كرت
کەڕەتە	كرت
کەکلە	ككل
کەڵام	كلام
کەڵک	كلك
کەڵکە	كلك
کەڵە	كل
کەی	كي
کەیل	كيل
کەین	كين
کەینە	كين
ڵات	لات
ڵام	لام
ۊزیا	وذيا
یا	يا
یادی	يادي
یاسر	ياسر
یاسری	ياسري
یاسین	ياسين
یاسەمین	ياسمين
یاومێ	ياوم
یتەر	يطر
یحق	يحق
یحیی	يحيي
یش	يش
یشان	يشان
یشمان	يشمان
یشەوە	يشو
یمان	يمان
ین	ين
ینک	ينك
ینە	ين
یه	يه
یوتەرەن	يوترن
یوجەل	يوجل
یورشان	يورشان
یوسف	يوسف
یوسفی	يوسفي
یون	يون
یونان	يونان
یونس	يونس
یوهە	يوه
یوهەم	يوهم
یووسف	يوسف
یوەم	يوم
یوەمی	يومي
یوەمە	يوم
یوەمەنە	يومن
یۆتەر	يوتر
یۆجە	يوج
یۆرش	يورش
یۆرە	يور
یۆش	يوش
یۆشیێ	يوشي
یۆم	يوم
یۆن	يون
یۆنان	يونان
یۆنێ	يون
یۆنە	يون
یۆهان	يوهان
یۆهەم	يوهم
یۆوەم	يووم
یێخۆ	يخو
یێنە	ين
یە	ي
یەبەشە	يبش
یەدی	يدي
یەرسەد	يرصد
یەرمی	يرمي
یەرۆم	يروم
یەری	يري
یەریێ	يري
یەرێ	ير
یەرێی	يري
یەرە	ير
یەرەشەمە	يرشم
یەرەم	يرم
یەرەمش	يرمش
یەرەمی	يرمي
یەرەمین	يرمين
یەرەمیەنە	يرمين
یەرەکە	يرك
یەزدان	يضدان
یەزیدی	يزيدي
یەسنە	يصن
یەسنەو	يسنو
یەعقوب	يعقوب
یەقین	يقين
یەمەن	يمن
یەمەنینە	يمنين
یەن	ين
یەنی	يني
یەنێ	ين
یەنە	ين
یەنەکە	ينك
یەنەکەی	ينكي
یەهەر	يهر
یەهەرش	يهرش
یەوەنە	يون
یەکتری	يكتري
یەکدانە	يكدان
یەکدەس	يكدس
یەکسان	يكثان
یەکسەر	يكسر
یەکو	يكو
یەکۆمەنە	يكومن
یەکەس	يكث
یەکەم	يكم
یەکەمی	يكمي
یەکەمین	يكمين
یەکەمێ	يكم
یەکەمەن	يكمن
یەکەمەنە	يكمن
یەکەو	يكو
یەکەوم	يكوم
ەوە	و
ەکە	ك
ەی	ي