آب	آب
آباد	آباد
آبادٖ	آباد
آبادی	آبادی
آبہٕ	آبَہ
آثار	آثار
آثارِ	آثارِ
آخری	آخری
آر	آر
آرتی	آرتی
آرٹ	آرٹ
آزاد	آزاد
آزادی	آزادی
آسان	آسان
آسمان	آسمان
آسن	آسن
آسَان	آسان
آسَن	آسَن
آشا	آشا
آشی	آشی
آصف	آصف
آصِف	آصف
آغاز	آغاز
آف	آف
آفتاب	آفتاب
آفرٛیٖدی	آفریدی
آل	آل
آلہ	آلہ
آلہٕ	آلَہ
آم	آم
آمنہ	آمنہ
آمِر	آمِر
آمِنا	آمنا
آنند	آنند
آنٛنَد	آنند
آنچل	آنچل
آواز	آواز
آکاش	آکاش
آکسیجن	آکسیجن
آکسیجَن	آکسیجن
آکسیٖجَن	آکسیجن
آگُر	آگر
آیت	آیت
ا	ا
اباسی	اباسی
ابراہیم	ابراہیم
ابن	ابن
ابو	ابو
ابی	ابی
اتحاد	اتحاد
اثاثہ	اثاثہ
اثر	اثر
اثنا	اثنا
احد	احد
احمد	احمد
اخباری	اخباری
اختر	اختر
ادا	ادا
ادارہ	ادارہ
اداکار	اداکار
اداکارہ	اداکارہ
ادبی	ادبی
ادَب	ادب
اربعین	اربعین
ارجُمَند	ارجمند
اردو	اردو
از	از
اس	اس
اسلام	اسلام
اسلامک	اسلامک
اسلامی	اسلامی
اسلم	اسلم
اسم	اسم
اسماعیل	اسماعیل
اسمبلی	اسمبلی
اسود	اسود
اسکیم	اسکیم
اسی	اسی
اشعری	اشعری
اصل	اصل
اصلی	اصلی
اصول	اصول
اصولی	اصولی
اعدادِ	اعداد
اعظم	اعظم
اعلا	اعلا
اعلان	اعلان
اعمال	اعمال
افغان	افغان
اقبال	اقبال
اقوام	اقوام
الامین	الامین
البتہ	البتّہ
البدن	البدن
الثانی	الثانی
الدّیٖن	الدَین
الدین	الدین
الدیٖن	الدَین
الرحمن	الرحمن
السلام	السلام
العالم	العالم
العین	العین
اللہ	اللہ
المظفر	المظفر
الگ	الگ
الی	الی
الیاس	الیاس
ام	ام
امام	امام
امان	امان
امجد	امجد
امریکی	امریکی
امس	امس
امن	امن
امنا	امنا
امِک	امک
امہ	امہ
امہِ	امّہ
امہٕ	امّہ
امیر	امیر
امیرالمومنین	امیرالمومنین
امین	امین
امیٖن	امین
امیہ	امیہ
انترا	انترا
انجام	انجام
انجم	انجم
انجیل	انجیل
اندر	اندر
اندرانی	اندرانی
انس	انس
انسائیکلوپیڈیا	انسائیکلوپیڈیا
انسان	انسان
انصاری	انصاری
انعام	انعام
انقلاب	انقلاب
انو	انو
انوپم	انوپم
انَنت	اننت
انٛدٕ	اند
انٛگریٖزی	انْگریزی
انگریزی	انگریزی
انیس	انیس
اور	اور
اوزار	اوزار
اوس	اوس
اوشا	اوشا
اوفی	اوفٰی
اولاد	اولاد
اولُو	اولو
اوم	اوم
اونی	اونی
اَباسی	اباسی
اَبرو	ابرو
اَثر	اثر
اَثَر	اَثَر
اَجَنٹ	اجنْٹ
اَحمَد	احمد
اَحَمَد	احمد
اَخبار	اخبار
اَداکار	اَداکار
اَداکارٰ	اداکار
اَداکارہ	اداکارہ
اَدبی	ادبی
اَدَب	اَدَب
اَز	اَز
اَس	اس
اَشرَف	اشرف
اَصٕل	اصل
اَعظَم	اعظم
اَعٔظم	اعظم
اَلگ	الگ
اَلہٕ	الٰہ
اَمریٖکی	امریکی
اَمُک	امک
اَمِس	امس
اَمہِ	امّہ
اَنجام	اَنجام
اَننت	اننت
اَنور	انور
اَنوشی	انوشی
اَنٖگرَیزی	انْگریزی
اَنٛدٕ	اند
اَنٛگریٖزی	انْگریزی
اَنگریزی	انْگریزی
اَپریل	اَپْرَیل
اَپریٖل	اَپْرَیل
اَکرَم	اَکْرَم
اَگَست	اَگَسْت
اَہَم	اَہَم
اَیس	اَیس
اُجاگر	اُجاگر
اُردوٗ	اردو
اُردُو	اُردُو
اِبتِدا	ابتدا
اِتِفاق	اِتِفاق
اِرشاد	ارشاد
اِستعمال	استعمال
اِستِعمال	استعمال
اِسرا	اسرا
اِسلام	اِسلام
اِسلامُک	اسلامک
اِسلامی	اسلامی
اِسلاَم	اسلام
اِقبال	اقبال
اِلزام	الزام
اِمام	اِمام
اِمان	امان
اِنتِظام	انتظام
اِنجَکشَن	انجکشن
اِندِرا	اندرا
اِنسان	اِنسان
اِنصاف	انصاف
اِنٛدِرا	اندرا
اِی	ای
اٗردوٗ	اردو
اپاسنا	اپاسنا
اپرنا	اپرنا
اپریل	اپریل
اپریٖل	اَپْرَیل
اکبر	اکبر
اکتوبر	اکتوبر
اگروال	اگروال
اگست	اگست
اگنی	اگنی
اہل	اہل
اہم	اہم
اہَم	اَہَم
ای	ای
ایجاز	ایجاز
ایجنٹ	ایجنٹ
ایرانی	ایرانی
ایس	ایس
ایشِیا	ایشْیا
ایشیا	ایشیا
ایل	ایل
ایلا	ایلا
ایلن	ایلن
ایلیا	ایلیا
ایم	ایم
ایما	ایما
ایمی	ایمی
این	این
اینٹی	اینٹی
اینڈ	اینڈ
اینی	اینی
ایوان	ایوان
ایچ	ایچ
ایڈیسَن	ایڈیسن
اے	اے
بابا	بابا
باتھ	باتھ
باد	باد
بار	بار
بارہ	بارہ
باغ	باغ
باقی	باقی
بال	بال
بالا	بالا
بانو	بانو
بانڈ	بانڈ
بانی	بانی
باہ	باہ
ببر	ببر
بحر	بحر
بدر	بدر
برا	برا
برصغیر	برصغیر
بروے	بروے
بری	بری
بزرگ	بزرگ
بشیر	بشیر
بطور	بطور
بغداد	بغداد
بل	بل
بلاول	بلاول
بلبل	بلبل
بلوچ	بلوچ
بن	بن
بنت	بنت
بندو	بندو
بندیا	بندیا
بنیاد	بنیاد
بول	بول
بَب	بب
بَتہٕ	بتّہ
بَجہٕ	بجّہ
بَرِاعَظٕم	براعظم
بَرِصَغیٖر	برصغیر
بَستہٕ	بستہ
بَشِیٖر	بشیر
بَطَخ	بَطَخ
بَطُخ	بطخ
بَل	بَل
بَند	بَند
بَنٛگال	بنْگال
بَنٛگلہ	بنْگلہ
بَٹ	بَٹ
بَچاو	بَچاو
بَچَن	بَچَن
بَچہِ	بَچَہ
بَہرا	بَہْرا
بَین	بَین
بُخاری	بُخاری
بُدھ	بُدھ
بُلبُل	بُلبُل
بُنیاد	بُنیاد
بُچا	بُچا
بُک	بُک
بُہر	بَہْر
بِجلی	بِجلی
بِل	بِل
بِلہٕ	بلہ
بِہار	بَہار
بٔڈ	بُڈ
بٕرجی	برجی
بٕہٕر	بَہْر
بٹ	بٹ
بھارتی	بھارتی
بھارَتی	بھارتی
بھاونا	بھاونا
بھوجن	بھوجن
بھومی	بھومی
بھَجَن	بَھجَن
بھگت	بھگت
بہ	بہ
بہل	بہل
بی	بی
بیان	بیان
بیروٗنی	بَیرُونی
بیس	بیس
بیضا	بیضا
بیل	بیل
بیلا	بیلا
بین	بین
بینِش	بینش
بینک	بینک
بیٖم	بِیم
بیٹی	بیٹی
بیک	بیک
بیگم	بیگم
بے	بے
تا	تا
تاج	تاج
تارا	تارا
تارُک	تارَک
تارک	تارک
تاریخ	تاریخ
تال	تال
تام	تام
تامل	تامل
تان	تان
تانا	تانا
تاپسی	تاپسی
تاکِہ	تاکِہ
تاکہِ	تاکِہ
تبریزی	تبریزی
تبسم	تبسم
تحریٖکِ	تحریک
تحریک	تحریک
تحصیٖل	تحصیل
تر	تر
ترجمہ	ترجمہ
ترٛےٚ	تِرے
ترکی	ترکی
ترین	ترین
ترے	تِرے
ترےٚ	تِرے
تس	تس
تشیع	تشیع
تعالی	تعالٰی
تعلق	تعلق
تعلیم	تعلیم
تعمیٖر	تعمیر
تقریبا	تقریبا
تقریباً	تقریباً
تقسیم	تقسیم
تقلید	تقلید
تقی	تقی
تلوار	تلوار
تم	تم
تمام	تمام
تمن	تمن
تنا	تنا
تنظیم	تنظیم
تنظیٖم	تنظیم
تَبدیٖل	تبدیل
تَبیر	تبیر
تَحصیٖل	تحصیل
تَحَت	تحت
تَخلیٖق	تخلیق
تَر	تَر
تَس	تس
تَشخیٖص	تشخیص
تَصویٖر	تصویر
تَصَوُر	تَصَوُر
تَل	تَل
تَمام	تَمام
تَنظیٖم	تنظیم
تَکنیٖک	تَکْنِیک
تُرکی	ترْکی
تُل	تُل
تِجارَت	تِجارَت
تِلہٕ	تلّہ
تِم	تم
تِمن	تمن
تِمَن	تمن
تِہ	تِہ
تٔ	ت
تٔحریٖک	تحریک
تٔہذیٖب	تَہذِیب
تٕہ	تَہ
تھامسن	تھامسن
تھیٹر	تھیٹر
تھیٹَر	تھیٹَر
تہ	تہ
تہِ	تہِ
تہٕ	تَہ
تیز	تیز
تیزٕآب	تیزآب
تیٖزی	تیزی
ثابت	ثابت
ثانِیا	ثانِیاً
ثقلین	ثقلین
ثور	ثور
ثَنا	ثَنا
جابر	جابر
جابِر	جابِر
جادۂ	جادۂ
جاریہ	جاریہ
جان	جان
جانا	جانا
جانباز	جانبازِ
جانسن	جانسن
جانشین	جانشین
جانور	جانور
جانوَر	جانور
جاوید	جاوید
جایا	جایا
جبار	جبار
جبر	جبر
جعفر	جعفر
جغرافیہ	جغرافیہ
جلالُ	جلال
جماعت	جماعت
جماعتِ	جماعت
جمالی	جمالی
جمعہ	جمعہ
جناب	جناب
جناح	جناح
جنت	جنت
جنوری	جنوری
جنگ	جنگ
جو	جو
جواد	جواد
جوان	جوان
جوش	جوش
جوشی	جوشی
جون	جون
جوٗن	جون
جوہر	جوہر
جوہی	جوہی
جَدیٖد	جدید
جَرمَن	جرمن
جَل	جَل
جَلال	جَلال
جَماعت	جماعت
جَنتا	جنتا
جَنٛگ	جنْگ
جَنٛگلی	جنْگلی
جَنگل	جنْگل
جَواہَر	جَواہَر
جَہان	جَہان
جُلَے	جلے
جُمعہ	جمعہ
جُگَن	جَگَن
جٔنوٗبی	جنوبی
جھا	جھا
جھلکا	جھلکا
جہاں	جہاں
جی	جی
جیا	جیا
جین	جین
جینا	جینا
جیوتی	جیوتی
جے	جے
حارث	حارث
حاصل	حاصل
حباب	حباب
حبیب	حبیب
حجر	حجر
حدیث	حدیث
حرام	حرام
حریت	حریت
حریم	حریم
حزب	حزب
حزم	حزم
حسام	حسام
حسان	حسان
حسن	حسن
حسین	حسین
حسینی	حسینی
حصل	حصل
حصہ	حصہ
حصہٕ	حصّہ
حضرت	حضرت
حق	حق
حلیم	حلیم
حمار	حمار
حمید	حمید
حمیر	حمیر
حنا	حنا
حنیف	حنیف
حنیٖف	حنیف
حویلی	حویلی
حَج	حَج
حَسن	حسن
حَسَن	حَسَن
حَضْرَت	حَضْرَت
حَق	حَق
حَملہٕ	حملہ
حَوالہٕ	حوالہ
حَیات	حَیات
حَیاتِیات	حَیاتِیات
حُریت	حرّیت
حُریِت	حرّیت
حُسین	حسین
حُکَم	حُکم
حِساب	حِساب
حِصَن	حصن
حِصہٕ	حصّہ
حکومت	حکومت
حکیم	حکیم
حیدری	حیدری
حیٖدر	حَیدَر
خاتون	خاتون
خارجہ	خارجہ
خاص	خاص
خالد	خالد
خالِد	خالِد
خان	خان
خاندان	خاندان
خانقاہ	خانقاہ
خانٚقاہ	خانقاہ
خدا	خدا
خدمت	خدمت
خراش	خراش
خطاب	خطاب
خطر	خطر
خطمی	خطمی
خطیب	خطیب
خلاف	خلاف
خلافت	خلافت
خلیفہ	خلیفہ
خلیل	خلیل
خواجہ	خواجہ
خوش	خوش
خوشبو	خوشبو
خولی	خولی
خوٗن	خون
خَر	خَر
خَرگوش	خَرگوش
خَط	خَط
خَلاف	خلاف
خُشی	خشی
خٔلیٖفہٕ	خلیفہ
خٕلاف	خلاف
خیبر	خیبر
دار	دار
دارالحکومت	دارالحکومت
داس	داس
داستان	داستان
دان	دان
دانش	دانش
داوٕ	داو
دتا	دتا
در	در
درگاہ	درگاہ
دستور	دستور
دسمبر	دسمبر
دعا	دعا
دعائے	دعائے
دفن	دفن
دمن	دمن
دور	دور
دوران	دوران
دورِ	دورِ
دولت	دولت
دون	دون
دوٗر	دور
دَرٕج	درج
دَرٕم	درم
دَسَمبَر	دسمبر
دَفتَر	دفتر
دَل	دَل
دِل	دِل
دِلارا	دلارا
دِوٕ	دو
دٕریافَت	درْیافْت
دٕس	دس
دٕستِیاب	دستیاب
دھر	دھر
دھَر	دَھر
دیا	دیا
دیبا	دیبا
دین	دین
دینا	دینا
دیو	دیو
دیوان	دیوان
دیوی	دیوی
دے	دے
ذوالفقار	ذوالفقار
ذکر	ذکر
ذکی	ذکی
ذیابیٖطٔس	ذِیابَیطِسِ
راج	راج
راجَستھان	راجستھان
راجہٕ	راجَہ
رادھا	رادھا
راز	راز
رازٕ	راز
راس	راس
راضی	راضی
رافع	رافع
رام	رام
رانا	رانا
رانی	رانی
راو	راو
راوُل	راول
راکھی	راکھی
راگنی	راگنی
راہ	راہ
رایَت	رایَت
ربا	ربا
ربعی	ربعی
ربیع	ربیع
رتن	رتن
رتی	رتی
رحمان	رحمان
رحمانی	رحمانی
رحمت	رحمت
رحمن	رحمٰن
رحیم	رحیم
رخسار	رخسار
رسم	رسم
رسول	رسول
رضا	رضا
رضی	رضی
رمانی	رمانی
رمبھا	رمبھا
رمضان	رمضان
رمی	رمی
رنگ	رنگ
روح	روح
روحانی	روحانی
رود	رود
روزَن	روزَن
روزُن	روزن
روشن	روشن
روشنی	روشنی
روشَن	روشَن
رولَٹ	رولٹ
رومَن	رومَن
رونی	رونی
روٗد	رود
روٗس	روس
روٗسی	روسی
روٗمی	رومی
روٗپ	روپ
روپا	روپا
رَجب	رجب
رَسمِ	رَسمِ
رَسوُل	رسول
رَمَضان	رَمَضان
رَنٛگ	رنْگ
رَوی	رَوی
رَگ	رَگ
رَہنُما	رَہْنُما
رُخ	رُخ
رُکُن	رُکَن
رِیٖشی	رِیشی
رِیٖڈَر	رِیڈَر
رچنا	رچنا
رہنما	رہنما
رہنُما	رہنُما
ریا	ریا
ریاستی	ریاستی
ریلوے	ریلوے
ریٖشی	رِیشی
ریڈی	ریڈی
ریڈیو	ریڈیو
ریکھا	ریکھا
رے	رے
ز	ز
زبان	زبان
زبانہِ	زبانہ
زبیر	زبیر
زرگر	زرگر
زرینہ	زرینہ
زمیٖن	زمین
زن	زن
زندگی	زندگی
زور	زور
زوٗن	زون
زَبان	زَبان
زَبانَ	زبان
زَبانہِ	زبانہ
زَبانہٕ	زبانہ
زَر	زَر
زَمان	زَمان
زَن	زَن
زَنان	زَنان
زَکات	زکات
زِ	زِ
زِندگی	زندگی
زِنٛدَگی	زندگی
زِنٛدگی	زندگی
زٔمیٖن	زمین
زٕ	ز
زہ	زہ
زہر	زہر
زہرا	زہرا
زہرہ	زہرہ
زیادِ	زِیاد
زیادہ	زیادہ
زیارت	زیارت
زیبا	زیبا
زیرِ	زیرِ
زینت	زینت
زینَب	زینب
زیٖبا	زیبا
زیٛادٕ	زِیاد
سارا	سارا
ساز	ساز
ساس	ساس
سالانہٕ	سالانَہ
سالم	سالم
سان	سان
ساہی	ساہی
ستارہ	ستارہ
ستمبر	ستمبر
ستون	ستون
ستی	ستی
سر	سر
سربراہ	سربراہ
سردار	سردار
سرزمین	سرزمین
سرکار	سرکار
سرگم	سرگم
سری	سری
سریش	سریش
سریع	سریع
سسٹم	سسٹم
سطح	سطح
سعت	سعتِ
سعد	سعد
سعید	سعید
سفینہ	سفینہ
سلم	سلم
سلمان	سلمان
سلمہ	سلمہ
سلمی	سلمیٰ
سلونی	سلونی
سلیم	سلیم
سمارٹ	سمارٹ
سمرتی	سمرتی
سمرن	سمرن
سمن	سمن
سمندر	سمندر
سمیرا	سمیرا
سنایا	سنایا
سنجیدہ	سنجیدہ
سند	سند
سنڈی	سنڈی
سنی	سنی
سو	سو
سواتی	سواتی
سواد	سواد
سورُس	سورس
سورہ	سورہ
سوسن	سوسن
سوفی	سوفی
سوٗدی	سودی
سوہا	سوہا
سَب	سَب
سَبا	سَبا
سَبزی	سبزی
سَبٕز	سبز
سَتَمبر	ستمبر
سَتَمبَر	ستمبر
سَجاد	سَجاد
سَر	سَر
سَرس	سرس
سَروٕ	سرو
سَرَس	سرس
سَلطَنَت	سلطنت
سَلفیٹ	سلفیٹ
سَلمان	سلمان
سَنَسکرٕٛت	سنسکرت
سَنٛس	سنس
سَنٛسکرِت	سنسکرت
سَوارِ	سوار
سَویرا	سَویرا
سُرخ	سُرخ
سُلطان	سُلطان
سُند	سند
سُنٛد	سند
سُنی	سُنی
سُپر	سُپَر
سُہ	سِہ
سِری	سِری
سِلسِلہٕ	سلسلہ
سِندھ	سندھ
سِنٛگھ	سنْگھ
سِنگھ	سنْگھ
سِکھ	سِکھ
سِگنَل	سِگْنَل
سِیاسَت	سِیاسَت
سِیاہ	سِیاہ
سِیر	سَیر
سِیٖد	سَیَد
سٔتی	ستی
سٕتی	ستی
سٕندِ	سند
سٕندِس	سندس
سٕہہ	سہہ
سٖی	سی
سپریم	سپریم
سکندر	سکندر
سکوٹر	سکوٹر
سہ	سہ
سہروردی	سہروردی
سہل	سہل
سہنا	سہنا
سی	سی
سیاسی	سیاسی
سیتا	سیتا
سید	سید
سیرت	سیرت
سیریل	سیریل
سیلی	سیلی
سیما	سیما
سیمی	سیمی
سین	سین
سینی	سینی
سیٖنَس	سینس
سیٖنُک	سَینْک
سیٖنہٕ	سِینَہ
سیٹھ	سیٹھ
سیٹھی	سیٹھی
سیکورٹی	سیکورٹی
سیے	سیے
شاخ	شاخ
شاد	شاد
شاعر	شاعر
شاعری	شاعری
شال	شال
شامل	شامل
شاہ	شاہ
شاہانہ	شاہانہ
شاہِ	شاہِ
شاہِد	شاہِد
شاہین	شاہین
شبانہ	شبانہ
شبہ	شبہ
شبیر	شبّیر
شداد	شداد
شر	شر
شرمیلا	شرمیلا
شروتی	شروتی
شروع	شروع
شریف	شریف
شریٖف	شرِیف
شفق	شفق
شمارندہ	شمارندہ
شمس	شمس
شمع	شمع
شمیم	شمیم
شور	شور
شومی	شومی
شوکت	شوکت
شَبنَم	شبنم
شَمشاد	شمشاد
شَہباز	شَہباز
شَہر	شَہر
شَہَر	شَہَر
شُروع	شروع
شُعبہٕ	شعبہ
شُمار	شُمار
شِکرا	شَکْرا
شکل	شکل
شہادت	شہادت
شہادَت	شَہادَت
شہر	شہر
شہید	شہید
شیب	شیب
شیخ	شیخ
شیر	شیر
شیطان	شیطان
شیعہ	شیعہ
شیلا	شیلا
شیٖن	شَین
شیٖنہٕ	شِینَہ
صامت	صامت
صبا	صبا
صدر	صدر
صدی	صدی
صراف	صراف
صفر	صفر
صلی	صلی
صوٗبہٕ	صوبہ
صوٗفی	صوفی
صَدرِ	صدر
صَدٕر	صدر
صَفہٕ	صفّہ
صُحابی	صحابی
صُوفی	صُوفی
صِرِف	صرف
صٔدی	صدی
ضبع	ضبع
ضحاک	ضحاک
طالب	طالب
طبَیعیات	طبیعیات
طبیب	طبیب
طرفہٕ	طرفہ
طفیل	طفیل
طور	طور
طوری	طوری
طَرفہٕ	طرفہ
طِب	طِب
طِبی	طِبی
طٔریٖقہٕ	طریقہ
طیب	طیب
ظالم	ظالم
ظریف	ظریف
ظفر	ظفر
عاشورہ	عاشورہ
عاشُر	عاشر
عاصم	عاصم
عاقل	عاقل
عالم	عالم
عالمہ	عالمہ
عالمی	عالمی
عالیہ	عالیہ
عام	عام
عبادت	عبادت
عباس	عباس
عبد	عبد
عبداللہ	عبداللہ
عبید	عبید
عتبہ	عتبہ
عثمان	عثمان
عراق	عراق
عرب	عرب
عربی	عربی
عزیز	عزیز
عسکری	عسکری
عشری	عشری
عصر	عصر
عظیم	عظیم
عقبہ	عقبہ
علاقہٕ	علاقہ
علامہ	علامہ
علاوہ	علاوہ
علم	علم
علی	علی
علیہ	علیہ
علیہم	علیہم
عمارہ	عمارہ
عمرو	عمرو
عنہ	عنہ
عَثمان	عثمان
عَربی	عَربی
عَلاقہ	علاقہ
عَلاقہٕ	علاقہ
عَلی	عَلی
عَلیم	علیم
عَمل	عَمل
عُمان	عُمان
عُمران	عمران
عُمَر	عُمَر
عُنصَر	عنصر
عُنصُر	عنصر
عِمران	عمران
عٔظیٖم	عظیم
عٔلم	علم
عٔلمِ	علم
عٔلِم	علم
عہد	عہد
عیاش	عیاش
عیسوی	عیسوی
عیسیٰ	عیسیٰ
غزل	غزل
غزلہ	غزلہ
غلام	غلام
غَزٕل	غزل
غُلام	غُلام
غیر	غیر
فارسی	فارسی
فاروق	فاروق
فاضل	فاضل
فاطمہ	فاطمہ
فاطِمہ	فاطمہ
فتوی	فتوٰی
فرات	فرات
فرانسیٖسی	فرانسیسی
فرح	فرح
فردوسی	فردوسی
فرزند	فرزند
فرقہ	فرقہ
فرنٛٹ	فرنْٹ
فروری	فروری
فرید	فرید
فقہٕ	فقْہ
فقیہ	فقیہ
فلم	فلم
فلک	فلک
فلکِیات	فلکیات
فوج	فوج
فون	فون
فوٹوٗ	فوٹو
فوٹوٗگرٛافَر	فوٹوگرافر
فوٹوٗگرٛافی	فوٹوگرافی
فَن	فَن
فَنِ	فَنِ
فَواد	فواد
فَیاض	فَیاض
فِرقہٕ	فرقہ
فِلاسفی	فلاسفی
فِلمی	فلمی
فِلِم	فلم
فِلِمی	فلمی
فِنی	فنّی
فِہرسَت	فَہرِسْتِ
فِہرِست	فَہرِسْتِ
فٹ	فٹ
فیاض	فیاض
فیروز	فیروز
فیس	فیس
فیض	فیض
فیلڈ	فیلڈ
قاضی	قاضی
قاطُر	قاطر
قبل	قبل
قدر	قدر
قدرتی	قدرتی
قدیم	قدیم
قرآن	قرآن
قسم	قسم
قسٕم	قسم
قصبہٕ	قصبہ
قلم	قلم
قوم	قوم
قومی	قومی
قَصبہٕ	قصبہ
قَلَم	قَلَم
قَیوم	قَیُوم
قُرآن	قُرآن
قُرت	قرت
قٕسم	قسم
قٕسٕم	قسم
قیام	قیام
قیس	قیس
لا	لا
لارا	لارا
لارنس	لارنس
لال	لال
لالہ	لالہ
لانچ	لانچ
لعین	لعین
لفظ	لفظ
لفٕظ	لفظ
لقب	لقب
لقمان	لقمان
لنچ	لنچ
لنڈا	لنڈا
لو	لو
لون	لون
لَفظٕ	لفظ
لَفٕظ	لفظ
لَمبَر	لمبر
لَکشمی	لَکْشْمی
لَگان	لَگان
لَگن	لَگَن
لُغَت	لُغَت
لُکھ	لَکھ
لٔٹ	لَٹ
لکشمی	لکشمی
لکھ	لکھ
لہجہٕ	لَہْجَہ
لیاقت	لیاقت
لیلا	لیلا
لیلاوتی	لیلاوتی
لیلی	لَیلٰی
لیلے	لیلےٰ
لین	لین
لینا	لینا
لینٖن	لِینَن
لیو	لیو
لیٖگ	لَیگ
لیڈر	لیڈر
لیڈی	لیڈی
ما	ما
ماحول	ماحول
ماحوٗل	ماحول
ماحوٗلِیات	ماحولیات
مادٕ	ماد
مار	مار
مارٕچ	مارْچ
مارچ	مارچ
مارک	مارک
ماریہ	ماریہ
مالا	مالا
مالک	مالک
مالی	مالی
مانی	مانی
ماگھ	ماگھ
ماہ	ماہ
ماہر	ماہر
ماہی	ماہی
مایا	مایا
مبارک	مبارک
متحدہ	متحدہ
مترا	مترا
متعلق	متعلق
متن	متن
مجتہد	مجتہد
مجمع	مجمع
مجید	مجید
محبت	محبت
محبوٗب	محبوب
محرم	محرم
محصن	محصن
محفوظ	محفوظ
محمد	محمد
محمدؐ	محمد
محمود	محمود
محی	محی
مختار	مختار
مخدوٗم	مخدوم
مخصوص	مخصوص
مدد	مدد
مدن	مدن
مدھر	مدھر
مدھو	مدھو
مدیر	مدیر
مدینہ	مدینہ
مذہبی	مذہبی
مراجع	مراجع
مردم	مردم
مرزا	مرزا
مرچنٹ	مرچنٹ
مریَم	مرْیم
مزید	مزید
مسجد	مسجد
مسطح	مسطح
مسعود	مسعود
مسلم	مسلم
مسلمان	مسلمان
مسلمہ	مسلمہ
مسور	مسور
مسک	مسک
مسیح	مسیح
مشرب	مشرب
مشرق	مشرق
مشہور	مشہور
مشہوٗر	مشْہور
مصطفی	مصطفٰی
مصنف	مصنف
مطابق	مطابق
مظفر	مظفر
معاذ	معاذ
معبد	معبد
معراج	معراج
معروف	معروف
معصوم	معصوم
معلیٰ	معلیٰ
معمر	معمر
معن	معن
معنی	معنی
معنیٰ	معنٰی
معوذ	معوذ
معیار	معیار
معین	معین
مغربی	مغربی
مغفل	مغفل
مفت	مفت
مقال	مقال
مقام	مقام
مقبرہ	مقبرہ
مقبول	مقبول
مقدس	مقدس
مقصد	مقصد
ملِک	ملَک
ملک	ملک
ممتا	ممتا
ممتاز	ممتاز
منازل	منازل
منتخب	منتخب
منجری	منجری
منجو	منجو
منداکنی	منداکنی
مندرا	مندرا
مندِر	مندر
منذر	منذر
منی	منی
موبائل	موبائل
موتی	موتی
موج	موج
موجود	موجود
مود	مود
مودی	مودی
مور	مور
موسی	موسی
موسیٖقی	موسِیقی
موسیٰ	موسیٰ
موشَن	موشَن
مول	مول
مولانا	مولانا
مولوی	مولوی
مولہ	مولہ
مولی	مولی
مون	مون
مونا	مونا
موندی	موندی
موٗد	مود
موہن	موہن
مَت	مَت
مَحاورٕ	محاور
مَحفوٗظ	محفوظ
مَحل	محل
مَحمود	محمود
مَخصوٗص	مخصوص
مَذہَب	مذْہب
مَر	مَر
مَروا	مروا
مَرٕد	مرد
مَرکَز	مرْکز
مَرکَزی	مرْکزی
مَرکٔزی	مرْکزی
مَریَم	مرْیم
مَسرَت	مسرت
مَشال	مَشال
مَشرِقی	مشرقی
مَشہوٗر	مشْہور
مَشیٖن	مشین
مَضموٗن	مضمون
مَطلَب	مطلب
مَعلوٗمات	معلومات
مَعنٰی	معنٰی
مَغرَبی	مغربی
مَقصد	مقصد
مَلِک	مَلِک
مَلِکا	مَلِکا
مَمتاز	ممتاز
مَنصوٗب	منصوب
مَواد	مَواد
مَٹَر	مَٹَر
مَگر	مَگَر
مَگَر	مَگَر
مَہاتما	مَہاتْما
مَہام	مَہام
مَہان	مَہان
مَہجوٗر	مَہْجُور
مُتعلِق	متعلق
مُج	مج
مُحمد	محمد
مُحمَّد	محمد
مُحَمَد	مُحَمَد
مُحَمَّد	محمد
مُختَلِف	مختلف
مُرَکَب	مُرَکَب
مُسرت	مسرت
مُسلمان	مسلمان
مُسلِم	مسلم
مُسَلمان	مسلمان
مُفُت	مفت
مُقابلہٕ	مقابلہ
مُقام	مُقام
مُلُک	ملَک
مُلک	ملَک
مُمتاز	ممتاز
مُنسَلِق	منسلق
مُنیر	منیر
مِثال	مِثال
مِسر	مسر
مِشیٖن	مشین
مِلیَن	ملین
مٔی	می
مٕلِک	ملَک
مٕلٕک	ملَک
مٗوجٗود	موجود
مکتا	مکتا
مکتی	مکتی
مگر	مگر
مہاجر	مہاجر
مہام	مہام
مہتا	مہتا
مہجور	مہجور
مہر	مہر
مہرا	مہرا
مہرین	مہرین
مہوِش	مہوش
مہک	مہک
میر	میر
میرا	میرا
میرِی	مِیری
میری	میری
میسی	میسی
میشا	میشا
میلا	میلا
میلان	میلان
میمی	میمی
مینا	مینا
مینڈی	مینڈی
میٖر	مَیَر
میٖرا	مِیرا
میٖل	مَیل
میٖٹَر	مِیٹَر
میٖڈیا	مِیڈِیا
میٹر	میٹر
میچ	میچ
میگھا	میگھا
ن	ن
ناؤ	ناؤ
ناب	ناب
نات	نات
ناتھ	ناتھ
نادِر	نادِر
نادیہ	نادیہ
نار	نار
ناراین	ناراین
ناز	ناز
ناساز	ناساز
ناظم	ناظم
نافع	نافع
نالہِ	نالَہ
نالہٕ	نالَہ
نام	نام
نامہ	نامہ
نامہٕ	نامَہ
نانَک	نانَک
ناو	ناو
ناول	ناول
ناوَل	ناول
ناوٕ	ناو
ناوک	ناوک
ناگ	ناگ
نبی	نبی
نجات	نجات
نجف	نجف
ندیم	ندیم
نش	نش
نشانہٕ	نشانہ
نشہ	نشہ
نصرت	نصرت
نظام	نظام
نظر	نظر
نظریہ	نظریہ
نعمان	نعمان
نفر	نفر
نفیس	نفیس
نفیسہ	نفیسہ
نقوی	نقوی
نقی	نقی
نل	نل
نماز	نماز
نمرتا	نمرتا
نند	نند
نندن	نندن
نواب	نواب
نواز	نواز
نور	نور
نورا	نورا
نوروز	نوروز
نوشین	نوشین
نوفل	نوفل
نومبر	نومبر
نون	نون
نوٗل	نول
نوٗن	نون
نویٖن	نوین
نَب	نَب
نَباتیات	نباتیات
نَر	نَر
نَرِ	نر
نَرٛک	نرک
نَرگِس	نرْگس
نَس	نَس
نَسرین	نسرین
نَسلی	نسلی
نَفسِیات	نفسیات
نَفَر	نَفَر
نَمبَر	نمبر
نَواز	نَواز
نَوَمبَر	نومبر
نَڈال	نِڈال
نَگَر	نَگَر
نُنٛدٕ	نند
نِدا	نِدا
نِرما	نرما
نِس	نِس
نِش	نِش
نِظام	نِظام
نِظامِ	نِظامِ
نِگہت	نَگْہَت
نِگیٖن	نَگِین
نِیازی	نِیازی
نٔر	نر
نٔو	نو
نٔویٖس	نویس
نکول	نکول
نکی	نکی
نگار	نگار
نگر	نگر
نہ	نہ
نہٕ	نَہ
نیران	نیران
نیشنل	نیشنل
نیشنَل	نَیشْنَل
نیلم	نیلم
نینا	نینا
نیٖلم	نِیلَم
نیٖلَم	نِیلَم
نیگی	نیگی
و	و
وابَستہٕ	وابستہ
واجب	واجب
وادی	وادی
وار	وار
واعظ	واعظ
واعِظ	واعِظ
واقع	واقع
والدہ	والدہ
وانی	وانی
واپس	واپس
واپَس	واپَس
وج	وجِ
وجہ	وجہ
وری	وری
وزن	وزن
وصی	وصی
وفات	وفات
ولادت	ولادت
ولایت	ولایت
وَجَہ	وَجَہ
وَر	وَر
وَری	وَری
وَزَن	وزن
وَسطی	وسطٰی
وَقٕت	وقت
وَن	وَن
وَژٗن	وژن
وُن	ون
وُڈ	وُڈ
وکٹوریہ	وکٹوریہ
ویب	ویب
وینا	وینا
وے	وے
ٹاپ	ٹاپ
ٹرمپ	ٹرمپ
ٹرنک	ٹرنک
ٹرٛیکٹر	ٹریکْٹر
ٹلی	ٹلی
ٹنڈن	ٹنڈن
ٹونی	ٹونی
ٹَنَل	ٹَنَل
ٹِشو	ٹشو
ٹھاکر	ٹھاکر
ٹھیٖک	ٹِھیک
ٹی	ٹی
ٹیا	ٹیا
ٹیسٹ	ٹیسٹ
ٹیلا	ٹیلا
ٹیلر	ٹیلر
ٹیلی	ٹیلی
ٹینا	ٹینا
ٹینِس	ٹینِس
ٹیٖم	ٹِیم
ٹیٖوب	ٹِیُوب
ٹیکسی	ٹیکسی
پادَر	پادر
پارٹی	پارٹی
پاریکھ	پاریکھ
پاس	پاس
پاشا	پاشا
پال	پال
پالا	پالا
پاولی	پاولی
پاٹھک	پاٹھک
پاٹھی	پاٹھی
پاک	پاک
پاکستان	پاکستان
پاکِستان	پاکِستان
پاکھی	پاکھی
پایل	پایل
پب	پب
پتھ	پتھ
پتہ	پتہ
پتہٕ	پتّہ
پدما	پدما
پدمنی	پدمنی
پر	پر
پران	پران
پرتاب	پرتاب
پردیش	پردیش
پرساد	پرساد
پرنسپل	پرنسپل
پرنہ	پرنہ
پرنہٕ	پرنہ
پروفیسر	پروفیسر
پرویز	پرویز
پرَدیش	پردیش
پرَٛدیش	پردیش
پرَٛسَو	پرسو
پرٛوگرٛام	پروگرام
پرکاش	پرکاش
پریا	پریا
پریال	پریال
پریت	پریت
پریزاد	پریزاد
پریس	پریس
پسند	پسند
پلہٕ	پلّہ
پلین	پلین
پنجاب	پنجاب
پنجابی	پنجابی
پنٛڈِت	پنْڈت
پنڈت	پنڈت
پوجا	پوجا
پور	پور
پورن	پورن
پورچ	پورچ
پوری	پوری
پوش	پوش
پوشہِ	پوشَہ
پونم	پونم
پوٗر	پور
پوٗرٕ	پور
پوٚت	پوت
پَتا	پَتا
پَتھ	پَتھ
پَتہٕ	پتّہ
پَسند	پسند
پَلہٕ	پلّہ
پَلیٹ	پَلیٹ
پَنَس	پنس
پَنٛجاب	پنجاب
پَنٛجال	پنجال
پَنٛڈِت	پنْڈت
پَنہٕ	پنہ
پَٹیل	پُٹیل
پَیِک	پَیک
پُرتَگال	پرتگال
پُٹِن	پَٹَن
پِیا	پِیا
پٔر	پر
پٹیل	پٹیل
پھاگُن	پھاگن
پھٕرٕ	پُھر
پھٕلَے	پَھلے
پی	پی
پیدائش	پیدائش
پیر	پیر
پیرزادہ	پیرزادہ
پیرس	پیرس
پیشہٕ	پیشَہ
پیغمبر	پیغمبر
پیٖر	پَیر
پیٖرزادہ	پِیرزادَہ
پیٖٹھ	پِیٹھ
پیٖکو	پیکو
پیٹھ	پیٹھ
چ	چ
چارٕج	چارج
چاکلیٹ	چاکلیٹ
چندرا	چندرا
چنٛد	چند
چودری	چودری
چودھری	چودھری
چوپڑا	چوپڑا
چوک	چوک
چوہان	چوہان
چوہدری	چوہدری
چَنٛڈی	چنْڈی
چَک	چَک
چَھ	چَھ
چَہار	چَہار
چُھ	چَھ
چِھ	چَھ
چِھٚ	چَھ
چٔھتٕر	چَھتَر
چک	چک
چھ	چھ
چھؙ	چَھ
چھایا	چھایا
چھَ	چَھ
چھَتیٖس	چَھتِّیس
چھُ	چَھ
چھِ	چَھ
چھٕ	چَھ
چھٗ	چَھ
چہ	چہ
چہل	چہل
چیز	چیز
چیٖز	چِیز
چیٖن	چَین
ڈ	ڈ
ڈار	ڈار
ڈالی	ڈالی
ڈاکٹر	ڈاکٹر
ڈاکٹَر	ڈاکْٹر
ڈولی	ڈولی
ڈَل	ڈَل
ڈِکشَنری	ڈِکْشْنَری
ڈِی	ڈی
ڈھلی	ڈھلی
ڈی	ڈی
ڈیم	ڈیم
کار	کار
کارکُن	کارْکن
کاشت	کاشت
کاظم	کاظم
کافی	کافی
کال	کال
کالج	کالج
کامنا	کامنا
کامَن	کامَن
کانٛگرٛیس	کانْگْریس
کاک	کاک
کاہ	کاہ
کبوتر	کبوتر
کبیر	کبیر
کتاب	کتاب
کر	کر
کربلا	کربلا
کردار	کردار
کرسٹل	کرسٹل
کرشمہ	کرشمہ
کرم	کرم
کرن	کرن
کرنی	کرنی
کروٗم	کروم
کرٕٛم	کرم
کری	کری
کریم	کریم
کس	کس
کشمیر	کشمیر
کشمیرا	کشمیرا
کشمیری	کشمیری
کشمیٖر	کشمیر
کلام	کلام
کلو	کلو
کلپنا	کلپنا
کلچر	کلچر
کلیان	کلیان
کلیسا	کلیسا
کلیش	کلیش
کم	کم
کمار	کمار
کماری	کماری
کمرا	کمرا
کمپیوٹر	کمپیوٹر
کن	کن
کنی	کنی
کنیت	کنیت
کور	کور
کورٹ	کورٹ
کوشش	کوشش
کول	کول
کولی	کولی
کومَل	کومَل
کونی	کونی
کوکو	کوکو
کویل	کویل
کَرن	کرن
کَرَن	کَرَن
کَرُن	کرن
کَشمیٖر	کشمیر
کَل	کَل
کَلس	کلس
کَلہٕ	کلّہ
کَم	کَم
کَمَر	کَمَر
کَمپَنی	کمْپنی
کَمپیوٗٹَر	کمْپیوٹر
کَن	کَن
کَنٹراسٹ	کنْٹراسْٹ
کَنگنا	کنْگْنا
کَٹھ	کَٹھ
کَپ	کَپ
کُرسی	کرسی
کُل	کُل
کُن	کُن
کُنٛز	کنز
کُک	کُک
کِتاب	کِتاب
کِرن	کِرن
کِرَن	کِرَن
کِرٛکَٹ	کرْکٹ
کِرکٹ	کرْکٹ
کِس	کِس
کِن	کِن
کِہ	کِہ
کٔر	کر
کپور	کپور
ککڑ	ککڑ
کھَرِ	کُھر
کھیر	کھیر
کھیل	کھیل
کہ	کہ
کہَ	کِہ
کہِ	کِہ
کی	کی
کیری	کیری
کیش	کیش
کیف	کیف
کیلی	کیلی
کیمرا	کیمرا
کیمپ	کیمپ
کیُٛس	کَیِس
کیٖمِیا	کِیمِیا
کیٹ	کیٹ
کیٹس	کیٹس
کے	کے
گائے	گائے
گام	گام
گامی	گامی
گاندھی	گاندھی
گانٛدھی	گاندھی
گانٛٹھ	گانْٹھ
گاو	گاو
گرَٛد	گرد
گرٛان	گران
گرٛینٛڈ	گرینْڈ
گرے	گرے
گل	گل
گلزار	گلزار
گو	گو
گوتم	گوتم
گور	گور
گول	گول
گوہر	گوہر
گَردن	گردن
گَردَن	گردن
گَردِش	گردش
گَرٕ	گر
گَو	گَو
گَڑھ	گَڑھ
گُجرات	گُجرات
گُر	گُر
گُل	گُل
گُلاب	گُلاب
گُلو	گلو
گُلوکار	گلوکار
گُلہِ	گلّہ
گُپت	گُپَت
گِنٛد	گند
گٔر	گر
گٔیہِ	گیہ
گٗروُ	گرو
گپتا	گپتا
گڑھ	گڑھ
گیم	گیم
گیٖری	گِیری
گیہ	گیہ
ہائی	ہائی
ہار	ہار
ہاسن	ہاسن
ہاشم	ہاشم
ہان	ہان
ہجری	ہجری
ہدایت	ہدایت
ہرن	ہرن
ہری	ہری
ہضم	ہضم
ہلالی	ہلالی
ہما	ہما
ہمیشہ	ہمیشہ
ہند	ہند
ہندِ	ہند
ہندی	ہندی
ہوائی	ہوائی
ہور	ہور
ہوٚس	ہوس
ہَر	ہَر
ہَری	ہَری
ہَزار	ہَزار
ہَضٕم	ہضم
ہَم	ہَم
ہُر	ہر
ہُم	ہم
ہُند	ہند
ہُنٛد	ہند
ہِند	ہِند
ہِندوُ	ہندو
ہِندی	ہندی
ہِنٛد	ہند
ہِنٛدی	ہندی
ہٕند	ہند
ہٕنٛد	ہند
ہٕنٛدِ	ہند
ہیرا	ہیرا
یا	یا
یاد	یاد
یادگار	یادگار
یاسر	یاسر
یاسمین	یاسمین
یاسیٖن	یاسِین
یزید	یزید
یسار	یسار
یعنی	یعنی
یمن	یمن
یوسف	یوسف
یوسُف	یوسف
یونیورسٹی	یونیورسٹی
یَن	ین
یُن	یُن
یُک	یَک
یِمن	یمن
یِمَن	یمن
یٰسِین	یٰسِین
یہ	یہ
یہِ	یِہ
یہٕ	یِہ