آئین	آئین
آب	آب
آباد	آباد
آباده	آباده
آبادی	آبادی
آبان	آبان
آبراهام	آبراهام
آبسرد	آبسرد
آبسکون	آبسکون
آبشار	آبشار
آبه	آبه
آتاترک	آتاترک
آتاتورک	آتاتورک
آتش	آتش
آتلانتا	آتلانتا
آتلانتیک	آتلانتیک
آتن	آتن
آثار	آثار
آثاری	آثاری
آجر	آجر
آجیل	آجیل
آخر	آخر
آخرسر	آخرسر
آخری	آخری
آخرین	آخرین
آداب	آداب
آدام	آدام
آدامز	آدامز
آدرس	آدرس
آدریاتیک	آدریاتیک
آدریان	آدریان
آدم	آدم
آدمی	آدمی
آدمیزاد	آدمیزاد
آدولف	آدولف
آدِم	آدم
آذر	آذر
آذربایجان	آذربایجان
آذربایجانی	آذربایجانی
آذری	آذری
آذوقه	آذوقه
آرا	آرا
آراء	آراء
آرارات	آرارات
آرال	آرال
آرام	آرام
آرامش	آرامش
آرامگاه	آرامگاه
آرامی	آرامی
آران	آران
آراگون	آراگون
آرتمیس	آرتمیس
آرتور	آرتور
آرد	آرد
آرزو	آرزو
آرسنال	آرسنال
آرش	آرش
آرم	آرم
آرمان	آرمان
آرون	آرون
آرژانتین	آرژانتین
آرژانتینی	آرژانتینی
آرگون	آرگون
آریایی	آریایی
آریزونا	آریزونا
آریل	آریل
آزاد	آزاد
آزادسازی	آزادسازی
آزادِ	آزاد
آزادی	آزادی
آزادیبخش	آزادیبخش
آزار	آزار
آزمایش	آزمایش
آزمایشات	آزمایشات
آزمایشگاه	آزمایشگاه
آزمون	آزمون
آسا	آسا
آساهی	آساهی
آستارا	آستارا
آستان	آستان
آستانه	آستانه
آسفالت	آسفالت
آسمان	آسمان
آسپرین	آسپرین
آسیا	آسیا
آسیایی	آسیایی
آسیب	آسیب
آسیه	آسیه
آش	آش
آشتی	آشتی
آشغال	آشغال
آشفته	آشفته
آشنا	آشنا
آشنایی	آشنایی
آشوب	آشوب
آشور	آشور
آشوراده	آشوراده
آشوری	آشوری
آغاز	آغاز
آغازگر	آغازگر
آغازین	آغازین
آغوز	آغوز
آفتاب	آفتاب
آفریقا	آفریقا
آفریقایی	آفریقایی
آفرینش	آفرینش
آق	آق
آقا	آقا
آقاخان	آقاخان
آقاسی	آقاسی
آل	آل
آلاباما	آلاباما
آلات	آلات
آلاسکا	آلاسکا
آلاشت	آلاشت
آلبانی	آلبانی
آلبانیایی	آلبانیایی
آلبر	آلبر
آلبرت	آلبرت
آلبرتو	آلبرتو
آلبوم	آلبوم
آلزاس	آلزاس
آلزایمر	آلزایمر
آلفا	آلفا
آلفرد	آلفرد
آلفونسو	آلفونسو
آلماتی	آلماتی
آلمان	آلمان
آلمانِ	آلمان
آلمانی	آلمانی
آلن	آلن
آلوده	آلوده
آلونسو	آلونسو
آلپ	آلپ
آلکساندر	آلکساندر
آلی	آلی
آلیس	آلیس
آماده	آماده
آمادگی	آمادگی
آمار	آمار
آمازون	آمازون
آمد	آمد
آمده	آمده
آمریکا	آمریکا
آمریکایی	آمریکایی
آمستردام	آمستردام
آمل	آمل
آمور	آمور
آموز	آموز
آموزش	آموزش
آمون	آمون
آمپر	آمپر
آمیز	آمیز
آمیزش	آمیزش
آن	آن
آنا	آنا
آناتولی	آناتولی
آناتومی	آناتومی
آنارشیسم	آنارشیسم
آنالیز	آنالیز
آنان	آنان
آنتوان	آنتوان
آنتونی	آنتونی
آنتونیو	آنتونیو
آنتیل	آنتیل
آنجا	آنجا
آنجایی	آنجایی
آنجل	آنجل
آنجلس	آنجلس
آنجلینا	آنجلینا
آند	آند
آندرس	آندرس
آندره	آندره
آندورا	آندورا
آنری	آنری
آنقدر	آنقدر
آنلاین	آنلاین
آنها	آنها
آنچه	آنچه
آنکارا	آنکارا
آنکه	آنکه
آنگلا	آنگلا
آنگولا	آنگولا
آنی	آنی
آهن	آهن
آهنگ	آهنگ
آهنگر	آهنگر
آهنگساز	آهنگساز
آهنگسازی	آهنگسازی
آهنگی	آهنگی
آهنی	آهنی
آهو	آهو
آوا	آوا
آواره	آواره
آواز	آواز
آوازه	آوازه
آور	آور
آورد	آورد
آوردن	آوردن
آورده	آورده
آوری	آوری
آوریل	آوریل
آپارتاید	آپارتاید
آپولو	آپولو
آژانس	آژانس
آژاکس	آژاکس
آکادمی	آکادمی
آکادمیک	آکادمیک
آکسفورد	آکسفورد
آگاه	آگاه
آگاهی	آگاهی
آگوست	آگوست
آی	آی
آیا	آیا
آیات	آیات
آیت	آیت
آیدا	آیدا
آیزاک	آیزاک
آینده	آینده
آینه	آینه
آیه	آیه
آیی	آیی
آیین	آیین
ئیران	ایران
ائتلاف	ائتلاف
ابتدا	ابتدا
ابتلا	ابتلا
ابد	ابد
ابداع	ابداع
ابر	ابر
ابراز	ابراز
ابراهیم	ابراهیم
ابراهیمی	ابراهیمی
ابررسانا	ابررسانا
ابررسانایی	ابررسانایی
ابرقدرت	ابرقدرت
ابریشم	ابریشم
ابزار	ابزار
ابعاد	ابعاد
ابن	ابن
ابنیه	ابنیه
ابو	ابو
ابوالحسن	ابوالحسن
ابوالعباس	ابوالعباس
ابوالفضل	ابوالفضل
ابوالقاسم	ابوالقاسم
ابوبکر	ابوبکر
ابوجهل	ابوجهل
ابوریحان	ابوریحان
ابوسفیان	ابوسفیان
ابوطالب	ابوطالب
ابوظبی	ابوظبی
ابوعلی	ابوعلی
ابومسلم	ابومسلم
ابوموسی	ابوموسی
ابوکالیجار	ابوکالیجار
ابی	ابی
اتاق	اتاق
اتحاد	اتحاد
اتحادیه	اتحادیه
اتریش	اتریش
اتریشی	اتریشی
اتصال	اتصال
اتفاق	اتفاق
اتفاقات	اتفاقات
اتفاقی	اتفاقی
اتلتیکو	اتلتیکو
اتم	اتم
اتهام	اتهام
اتهامات	اتهامات
اتومبیل	اتومبیل
اتیوپی	اتیوپی
اثبات	اثبات
اثر	اثر
اثرات	اثرات
اثیر	اثیر
اجاره	اجاره
اجازه	اجازه
اجبار	اجبار
اجباری	اجباری
اجتماعی	اجتماعی
اجتناب	اجتناب
اجداد	اجداد
اجرا	اجرا
اجراء	اجراء
اجرام	اجرام
اجرایی	اجرایی
اجسام	اجسام
اجلاس	اجلاس
اجماع	اجماع
احادیث	احادیث
احترام	احترام
احتمال	احتمال
احتمالا	احتمالا
احتمالاً	احتمالاً
احداث	احداث
احزاب	احزاب
احساس	احساس
احساسات	احساسات
احسان	احسان
احمد	احمد
احمدی	احمدی
احمدیه	احمدیه
احکام	احکام
احیا	احیا
اخبار	اخبار
اختراع	اختراع
اختراعات	اختراعات
اختصار	اختصار
اختصاراً	اختصارا
اختصاص	اختصاص
اختلاف	اختلاف
اختلافات	اختلافات
اختلال	اختلال
اختلالات	اختلالات
اختیار	اختیار
اختیارات	اختیارات
اخذ	اخذ
اخراج	اخراج
اخلاق	اخلاق
اخلاقی	اخلاقی
اخوان	اخوان
اخیر	اخیر
اخیراً	اخیراً
ادا	ادا
ادارات	ادارات
اداره	اداره
ادارهٔ	اداره
اداری	اداری
ادامه	ادامه
ادامهٔ	ادامه
ادب	ادب
ادبی	ادبی
ادبیات	ادبیات
ادراک	ادراک
ادریس	ادریس
ادعا	ادعا
ادغام	ادغام
ادل	ادل
ادهمی	ادهمی
ادوار	ادوار
ادوارد	ادوارد
ادوین	ادوین
ادگار	ادگار
ادیان	ادیان
ادیب	ادیب
ادیسون	ادیسون
ادینبورگ	ادینبورگ
اذیت	اذیت
ارائه	ارائه
اراده	اراده
اراضی	اراضی
ارامنه	ارامنه
اراک	اراک
ارایه	ارایه
ارباب	ارباب
اربابی	اربابی
اربیل	اربیل
ارتباط	ارتباط
ارتباطات	ارتباطات
ارتداد	ارتداد
ارتدوکس	ارتدوکس
ارتدکس	ارتدکس
ارتش	ارتش
ارتعاش	ارتعاش
ارتفاع	ارتفاع
ارتفاعات	ارتفاعات
ارتقا	ارتقا
ارتقاء	ارتقاء
ارتودوکس	ارتودوکس
ارتکاب	ارتکاب
ارث	ارث
ارجاع	ارجاع
اردبیل	اردبیل
اردستان	اردستان
اردشیر	اردشیر
اردلان	اردلان
اردن	اردن
اردو	اردو
اردوغان	اردوغان
اردوگاه	اردوگاه
اردک	اردک
اردکان	اردکان
اردیبهشت	اردیبهشت
ارزروم	ارزروم
ارزش	ارزش
ارزیابی	ارزیابی
ارس	ارس
ارسال	ارسال
ارسطو	ارسطو
ارسلان	ارسلان
ارسنجان	ارسنجان
ارشاد	ارشاد
ارشد	ارشد
ارم	ارم
ارمنستان	ارمنستان
ارمنی	ارمنی
ارمنیان	ارمنیان
ارنست	ارنست
ارومیه	ارومیه
اروپا	اروپا
اروپایی	اروپایی
اروپاییان	اروپاییان
اروگوئه	اروگوئه
ارکستر	ارکستر
اریتره	اریتره
اریک	اریک
از	از
ازجمله	ازجمله
ازدواج	ازدواج
اساتید	اساتید
اسارت	اسارت
اساس	اساس
اساسا	اساسا
اساطیر	اساطیر
اسامه	اسامه
اسامی	اسامی
اسانس	اسانس
اسب	اسب
است	است
استاد	استاد
استادی	استادی
استادیوم	استادیوم
استار	استار
استارت	استارت
استالین	استالین
استامبول	استامبول
استامبولی	استامبولی
استان	استان
استانبول	استانبول
استاندار	استاندار
استاندارد	استاندارد
استانداری	استانداری
استتار	استتار
استثنایی	استثنایی
استحکام	استحکام
استخدام	استخدام
استخر	استخر
استخراج	استخراج
استدلال	استدلال
استرآباد	استرآباد
استراتژی	استراتژی
استراتژیک	استراتژیک
استراحت	استراحت
استراسبورگ	استراسبورگ
استرالیا	استرالیا
استرالیایی	استرالیایی
استرس	استرس
استریت	استریت
استعداد	استعداد
استعفا	استعفا
استعفاء	استعفاء
استعمار	استعمار
استعماری	استعماری
استفاده	استفاده
استفان	استفان
استقبال	استقبال
استقرار	استقرار
استقلال	استقلال
استناد	استناد
استنفورد	استنفورد
استهبان	استهبان
استوا	استوا
استوار	استوار
استوانه	استوانه
استوایی	استوایی
استودیویی	استودیویی
استون	استون
استونی	استونی
استکهلم	استکهلم
استیضاح	استیضاح
استیفن	استیفن
استیل	استیل
استیو	استیو
استیون	استیون
اسحاق	اسحاق
اسحاقی	اسحاقی
اسد	اسد
اسدالله	اسدالله
اسرائیل	اسرائیل
اسرائیلی	اسرائیلی
اسراییل	اسراییل
اسطوره	اسطوره
اسعد	اسعد
اسفند	اسفند
اسفندیار	اسفندیار
اسفندیاری	اسفندیاری
اسلام	اسلام
اسلامبول	اسلامبول
اسلامی	اسلامی
اسلحه	اسلحه
اسلو	اسلو
اسلواکی	اسلواکی
اسلونی	اسلونی
اسلوواکی	اسلوواکی
اسلوونی	اسلوونی
اسم	اسم
اسماعیل	اسماعیل
اسمیت	اسمیت
اسمیتِ	اسمیت
اسناد	اسناد
اسنادی	اسنادی
اسپارت	اسپارت
اسپارتاکوس	اسپارتاکوس
اسپانیا	اسپانیا
اسپانیایی	اسپانیایی
اسپرانتو	اسپرانتو
اسپرم	اسپرم
اسپرینگ	اسپرینگ
اسپند	اسپند
اسپهبد	اسپهبد
اسپهبدی	اسپهبدی
اسپهبدیه	اسپهبدیه
اسپینوزا	اسپینوزا
اسکات	اسکات
اسکاتلند	اسکاتلند
اسکار	اسکار
اسکان	اسکان
اسکاندیناوی	اسکاندیناوی
اسکلت	اسکلت
اسکندر	اسکندر
اسکندرون	اسکندرون
اسکندریه	اسکندریه
اسکی	اسکی
اسکیزوفرنی	اسکیزوفرنی
اسکینر	اسکینر
اسید	اسید
اسیر	اسیر
اشاره	اشاره
اشباع	اشباع
اشتباه	اشتباه
اشتباهاً	اشتباهاً
اشتباهی	اشتباهی
اشتراک	اشتراک
اشتغال	اشتغال
اشخاص	اشخاص
اشراف	اشراف
اشرافی	اشرافی
اشرف	اشرف
اشرفی	اشرفی
اشرفیه	اشرفیه
اشعار	اشعار
اشعه	اشعه
اشغال	اشغال
اشمیت	اشمیت
اشک	اشک
اشکال	اشکال
اشکان	اشکان
اشکانی	اشکانی
اشکانیان	اشکانیان
اشیا	اشیا
اشیاء	اشیاء
اصالت	اصالت
اصحاب	اصحاب
اصرار	اصرار
اصطلاح	اصطلاح
اصطلاحات	اصطلاحات
اصطلاحاً	اصطلاحاً
اصغر	اصغر
اصفهان	اصفهان
اصفهانی	اصفهانی
اصل	اصل
اصلا	اصلا
اصلاح	اصلاح
اصلاحات	اصلاحات
اصلاندوز	اصلاندوز
اصلاً	اصلاً
اصلی	اصلی
اصلیت	اصلیت
اصول	اصول
اصولی	اصولی
اصیل	اصیل
اضافه	اضافه
اضافی	اضافی
اضداد	اضداد
اضطراب	اضطراب
اطاعت	اطاعت
اطاق	اطاق
اطراف	اطراف
اطلاع	اطلاع
اطلاعات	اطلاعات
اطلاعی	اطلاعی
اطلاق	اطلاق
اطلس	اطلس
اطمینان	اطمینان
اظهار	اظهار
اعتبار	اعتبار
اعتدال	اعتدال
اعتراض	اعتراض
اعتراضات	اعتراضات
اعتراف	اعتراف
اعترافات	اعترافات
اعتقاد	اعتقاد
اعتقادات	اعتقادات
اعتماد	اعتماد
اعتیاد	اعتیاد
اعتیادآور	اعتیادآور
اعداد	اعداد
اعدام	اعدام
اعراب	اعراب
اعزام	اعزام
اعصاب	اعصاب
اعضا	اعضا
اعضاء	اعضاء
اعظم	اعظم
اعظمی	اعظمی
اعلام	اعلام
اعلامیه	اعلامیه
اعلان	اعلان
اعمال	اعمال
اغلب	اغلب
افتاد	افتاد
افتتاح	افتتاح
افتخار	افتخار
افتخارات	افتخارات
افتخاری	افتخاری
افراد	افراد
افرادی	افرادی
افراسیاب	افراسیاب
افراطی	افراطی
افروز	افروز
افریقا	افریقا
افزار	افزار
افزایش	افزایش
افسانه	افسانه
افسر	افسر
افسران	افسران
افسرده	افسرده
افسردگی	افسردگی
افشار	افشار
افغان	افغان
افغانستان	افغانستان
افغانی	افغانی
افلاطون	افلاطون
افلاطونی	افلاطونی
افکار	افکار
اقامت	اقامت
اقبال	اقبال
اقتباس	اقتباس
اقتدار	اقتدار
اقتصاد	اقتصاد
اقتصاددان	اقتصاددان
اقدام	اقدام
اقدامات	اقدامات
اقلیت	اقلیت
اقلیم	اقلیم
اقوام	اقوام
اقیانوس	اقیانوس
اقیانوسیه	اقیانوسیه
الآن	الآن
الا	الا
الازهر	الازهر
الان	الان
الباقی	الباقی
البته	البته
البرادعی	البرادعی
البرز	البرز
البشیر	البشیر
الثانی	الثانی
الجزایر	الجزایر
الجزیره	الجزیره
الحاق	الحاق
الحق	الحق
السالوادور	السالوادور
العرب	العرب
الف	الف
الفبا	الفبا
الفبایی	الفبایی
القاعده	القاعده
القدس	القدس
الله	الله
الماس	الماس
المالکی	المالکی
المهدی	المهدی
الموت	الموت
المپ	المپ
المپیک	المپیک
النصر	النصر
اله	اله
الهام	الهام
الهی	الهی
الهیات	الهیات
الکترون	الکترون
الکترونیک	الکترونیک
الکتریک	الکتریک
الکتریکی	الکتریکی
الکساندر	الکساندر
الکسی	الکسی
الکسیس	الکسیس
الکل	الکل
الی	الی
الیاس	الیاس
الیاف	الیاف
الیزابت	الیزابت
الیزه	الیزه
الیه	الیه
الیوت	الیوت
اما	اما
امارات	امارات
امارت	امارت
امام	امام
امامزاده	امامزاده
امامعلی	امامعلی
امامی	امامی
امامیه	امامیه
امان	امان
اماکن	اماکن
امتحان	امتحان
امتداد	امتداد
امتیاز	امتیاز
امتیازات	امتیازات
امر	امر
امرسون	امرسون
امروز	امروز
امروزه	امروزه
امروزی	امروزی
امریکا	امریکا
امریکایی	امریکایی
امضا	امضا
املاک	املاک
املش	املش
امن	امن
امنیت	امنیت
امواج	امواج
اموال	اموال
امور	امور
امورِ	امور
امّا	امّا
امپراتور	امپراتور
امپراتوری	امپراتوری
امپراطوری	امپراطوری
امپریالیسم	امپریالیسم
امکان	امکان
امکانات	امکانات
امی	امی
امید	امید
امیدوار	امیدوار
امیر	امیر
امیرمسعود	امیرمسعود
امیرنشین	امیرنشین
امیرکبیر	امیرکبیر
امیری	امیری
امیل	امیل
امیلیانو	امیلیانو
امین	امین
امینی	امینی
انار	انار
انبار	انبار
انبوه	انبوه
انتخاب	انتخاب
انتخابات	انتخابات
انتخاباتی	انتخاباتی
انتساب	انتساب
انتشار	انتشار
انتشارات	انتشارات
انتصاب	انتصاب
انتظار	انتظار
انتقاد	انتقاد
انتقادات	انتقادات
انتقال	انتقال
انتقالی	انتقالی
انتقام	انتقام
انتها	انتها
انجام	انجام
انجمن	انجمن
انجیل	انجیل
انحراف	انحراف
انحصار	انحصار
اندازه	اندازه
اندازی	اندازی
اندام	اندام
اندر	اندر
اندروید	اندروید
اندلس	اندلس
اندونزی	اندونزی
اندونزیایی	اندونزیایی
اندکی	اندکی
اندیشمندانه	اندیشمندانه
اندیشه	اندیشه
انرژی	انرژی
انزلی	انزلی
انسان	انسان
انسانی	انسانی
انشان	انشان
انصار	انصار
انصراف	انصراف
انعقاد	انعقاد
انفال	انفال
انفجار	انفجار
انقلاب	انقلاب
انقلابیون	انقلابیون
انواع	انواع
انور	انور
انوشیروان	انوشیروان
انکار	انکار
انگلس	انگلس
انگلستان	انگلستان
انگلیس	انگلیس
انگلیسی	انگلیسی
انگور	انگور
انگولک	انگولک
انگیز	انگیز
انگیزه	انگیزه
انیشتین	انیشتین
اهالی	اهالی
اهداف	اهداف
اهل	اهل
اهلی	اهلی
اهم	اهم
اهمیت	اهمیت
اهواز	اهواز
او	او
اواخر	اواخر
اواسط	اواسط
اوایل	اوایل
اوباما	اوباما
اوت	اوت
اوج	اوج
اوجالان	اوجالان
اوجی	اوجی
اور	اور
اوراسیا	اوراسیا
اورال	اورال
اورانوس	اورانوس
اورانیوم	اورانیوم
اورتگا	اورتگا
اورست	اورست
اورشلیم	اورشلیم
اوستا	اوستا
اوستایی	اوستایی
اوستیا	اوستیا
اوضاع	اوضاع
اوقات	اوقات
اول	اول
اولا	اولا
اولین	اولین
اولیه	اولیه
اولیهٔ	اولیه
اولیویه	اولیویه
اون	اون
اونوره	اونوره
اونیل	اونیل
اوهایو	اوهایو
اوپک	اوپک
اوکراین	اوکراین
اوکراینی	اوکراینی
اوکیناوا	اوکیناوا
اوگاندا	اوگاندا
اوین	اوین
اَشرِفی	اشرفی
اَی	ای
اِما	اما
اپرا	اپرا
اپل	اپل
اپوزیسیون	اپوزیسیون
اژدها	اژدها
اژه	اژه
اکبر	اکبر
اکتبر	اکتبر
اکثر	اکثر
اکثرا	اکثرا
اکثراً	اکثراً
اکثریت	اکثریت
اکران	اکران
اکراین	اکراین
اکراینِ	اکراین
اکراینی	اکراینی
اکرم	اکرم
اکستر	اکستر
اکسیژن	اکسیژن
اکنون	اکنون
اکو	اکو
اکوادر	اکوادر
اکوادور	اکوادور
اکوسیستم	اکوسیستم
اگر	اگر
اگرچه	اگرچه
اگه	اگه
ای	ای
ایالات	ایالات
ایالت	ایالت
ایالتِ	ایالت
ایالِت	ایالت
ایام	ایام
ایبری	ایبری
ایتالیا	ایتالیا
ایتالیایی	ایتالیایی
ایجاد	ایجاد
ایدئولوژی	ایدئولوژی
ایدئولوژیک	ایدئولوژیک
ایدز	ایدز
ایده	ایده
ایر	ایر
ایران	ایران
ایرانِ	ایران
ایرانی	ایرانی
ایرانیان	ایرانیان
ایرلند	ایرلند
ایرلندِ	ایرلند
ایرلندی	ایرلندی
ایرن	ایرن
ایروان	ایروان
ایرونی	ایرونی
ایزاک	ایزاک
ایزد	ایزد
ایزدی	ایزدی
ایزوتوپ	ایزوتوپ
ایست	ایست
ایستگاه	ایستگاه
ایسلند	ایسلند
ایسم	ایسم
ایشان	ایشان
ایفا	ایفا
ایفل	ایفل
ایل	ایل
ایلام	ایلام
ایلچی	ایلچی
ایلیاد	ایلیاد
ایلینویز	ایلینویز
ایمان	ایمان
این	این
اینان	اینان
اینترنت	اینترنت
اینجا	اینجا
اینجور	اینجور
ایندیانا	ایندیانا
ایندیرا	ایندیرا
اینشتین	اینشتین
اینچنینی	اینچنینی
اینکه	اینکه
ایو	ایو
ایوان	ایوان
ایوانف	ایوانف
ایوبی	ایوبی
ایونیه	ایونیه
ایکس	ایکس
ایگور	ایگور
با	با
باب	باب
بابت	بابت
بابل	بابل
بابلسر	بابلسر
بابلِ	بابل
بابلی	بابلی
بابِل	بابل
بابک	بابک
باتلر	باتلر
باج	باج
باخ	باخ
باختر	باختر
باختری	باختری
باد	باد
بار	بار
باران	باران
بارانی	بارانی
باراک	باراک
باربد	باربد
باردار	باردار
بارداری	بارداری
بارزانی	بارزانی
بارسلون	بارسلون
بارسلونا	بارسلونا
باره	باره
بارها	بارها
باری	باری
باریک	باریک
باز	باز
بازار	بازار
بازتاب	بازتاب
بازداشت	بازداشت
بازدید	بازدید
بازرگان	بازرگان
بازرگانی	بازرگانی
بازسازی	بازسازی
بازنشسته	بازنشسته
بازنشستگی	بازنشستگی
بازو	بازو
بازگشت	بازگشت
بازی	بازی
بازیابی	بازیابی
بازیکن	بازیکن
بازیکنان	بازیکنان
بازیگر	بازیگر
بازیگری	بازیگری
باستان	باستان
باستانی	باستانی
باسواد	باسواد
باسک	باسک
باشد	باشد
باشند	باشند
باشگاه	باشگاه
باشی	باشی
باطل	باطل
باعث	باعث
باغ	باغ
باغداری	باغداری
بافت	بافت
باقر	باقر
باقری	باقری
باقی	باقی
باقیِ	باقی
بال	بال
بالا	بالا
بالاتر	بالاتر
بالاترین	بالاترین
بالاخره	بالاخره
بالایی	بالایی
بالتیک	بالتیک
بالزاک	بالزاک
بالغ	بالغ
بالله	بالله
بالون	بالون
بالکان	بالکان
بامداد	بامداد
بان	بان
باند	باند
بانو	بانو
بانک	بانک
بانکداری	بانکداری
بانکوک	بانکوک
بانکی	بانکی
بانی	بانی
باور	باور
باوند	باوند
باوندی	باوندی
باکو	باکو
باید	باید
بایرن	بایرن
ببر	ببر
بترسی	بترسی
بته	بته
بتواند	بتواند
بتونه	بتونه
بتونّه	بتونه
بجا	بجا
بجز	بجز
بحث	بحث
بحر	بحر
بحران	بحران
بحرین	بحرین
بخار	بخار
بخارا	بخارا
بخارد	بخارد
بخارست	بخارست
بخاستی	بخاستی
بخاطر	بخاطر
بخت	بخت
بختیاری	بختیاری
بخرد	بخرد
بخری	بخری
بخش	بخش
بخشش	بخشش
بخشی	بخشی
بخصوص	بخصوص
بخیر	بخیر
بد	بد
بدان	بدان
بدبین	بدبین
بدجور	بدجور
بدر	بدر
بدزدی	بدزدی
بدست	بدست
بدل	بدل
بدلیل	بدلیل
بدن	بدن
بدنه	بدنه
بدنی	بدنی
بده	بده
بدهد	بدهد
بدهی	بدهی
بدون	بدون
بدی	بدی
بدین	بدین
بر	بر
برآورد	برآورد
برابر	برابر
برابری	برابری
براتیسلاوا	براتیسلاوا
برادر	برادر
برادران	برادران
برادری	برادری
برازیلیا	برازیلیا
برانکو	برانکو
برانگیخته	برانگیخته
براون	براون
برای	برای
بربری	بربری
برتر	برتر
برتراند	برتراند
برتری	برتری
برج	برج
برجسته	برجسته
برجیان	برجیان
برخلاف	برخلاف
برخورد	برخورد
برخوردار	برخوردار
برخی	برخی
برد	برد
برداری	برداری
برداشت	برداشت
برداشته	برداشته
بردسکن	بردسکن
برده	برده
بررسی	بررسی
برزگر	برزگر
برزیل	برزیل
برزیلی	برزیلی
برسی	برسی
برسیم	برسیم
برعهده	برعهده
برعکس	برعکس
برق	برق
برقرار	برقرار
برقراری	برقراری
برلین	برلین
برمه	برمه
برمودا	برمودا
برنار	برنار
برنارد	برنارد
برنامه	برنامه
برنج	برنج
برند	برند
برنده	برنده
برنز	برنز
برهان	برهان
برهم	برهم
بروز	بروز
برون	برون
برونئی	برونئی
برونته	برونته
برونو	برونو
بروکسل	بروکسل
برپایی	برپایی
برژنف	برژنف
برکلی	برکلی
برکنار	برکنار
برکناری	برکناری
برگ	برگ
برگرفته	برگرفته
برگزار	برگزار
برگزیده	برگزیده
بری	بری
بریتانیا	بریتانیا
بریتانیایی	بریتانیایی
بریتیش	بریتیش
بریده	بریده
بریستول	بریستول
بریم	بریم
بریگاد	بریگاد
بز	بز
بزا	بزا
بزایی	بزایی
بزرگ	بزرگ
بزرگداشت	بزرگداشت
بزرگراه	بزرگراه
بزرگی	بزرگی
بزن	بزن
بزنیم	بزنیم
بزه	بزه
بس	بس
بست	بست
بستا	بستا
بستری	بستری
بسته	بسته
بستگی	بستگی
بسفر	بسفر
بسکتبال	بسکتبال
بسیار	بسیار
بسیاری	بسیاری
بسیج	بسیج
بشار	بشار
بشر	بشر
بشری	بشری
بشریت	بشریت
بشناسی	بشناسی
بشکنی	بشکنی
بشکه	بشکه
بشیر	بشیر
بصره	بصره
بصورت	بصورت
بطلمیوس	بطلمیوس
بطور	بطور
بطوری	بطوری
بعث	بعث
بعد	بعد
بعدا	بعدا
بعداز	بعداز
بعداً	بعداً
بعضی	بعضی
بعنوان	بعنوان
بعهده	بعهده
بعید	بعید
بغداد	بغداد
بغدادی	بغدادی
بقاع	بقاع
بقعه	بقعه
بقیه	بقیه
بل	بل
بلا	بلا
بلاروس	بلاروس
بلافاصله	بلافاصله
بلاگر	بلاگر
بلخ	بلخ
بلد	بلد
بلر	بلر
بلز	بلز
بلشویکی	بلشویکی
بلعمی	بلعمی
بلغارستان	بلغارستان
بلند	بلند
بلندِ	بلند
بلندپایه	بلندپایه
بلندی	بلندی
بله	بله
بلوز	بلوز
بلوغ	بلوغ
بلوم	بلوم
بلوچ	بلوچ
بلوچستان	بلوچستان
بلوچی	بلوچی
بلوک	بلوک
بلژیک	بلژیک
بلژیکی	بلژیکی
بلکه	بلکه
بلگراد	بلگراد
بلی	بلی
بمب	بمب
بمبئی	بمبئی
بمرد	بمرد
بمو	بمو
بن	بن
بنا	بنا
بنابر	بنابر
بنابراین	بنابراین
بنابرین	بنابرین
بنادر	بنادر
بنام	بنام
بنان	بنان
بناپارت	بناپارت
بنجامین	بنجامین
بند	بند
بندر	بندر
بندرعباس	بندرعباس
بندری	بندری
بندی	بندی
بندیکت	بندیکت
بنظر	بنظر
بنه	بنه
بنگال	بنگال
بنگالی	بنگالی
بنگلادش	بنگلادش
بنی	بنی
بنیاد	بنیاد
بنیادی	بنیادی
بنیامین	بنیامین
بنیان	بنیان
بنیانگذار	بنیانگذار
بنیتو	بنیتو
بنین	بنین
به	به
بهائی	بهائی
بهار	بهار
بهارستان	بهارستان
بهاری	بهاری
بهانه	بهانه
بهایی	بهایی
بهبود	بهبود
بهتر	بهتر
بهترین	بهترین
بهداد	بهداد
بهداشت	بهداشت
بهداشتی	بهداشتی
بهرام	بهرام
بهره	بهره
بهروز	بهروز
بهشت	بهشت
بهشتی	بهشتی
بهشهر	بهشهر
بهمن	بهمن
بهمنی	بهمنی
بهنام	بهنام
بهی	بهی
بهینه	بهینه
بو	بو
بوئین	بوئین
بوتان	بوتان
بوتسوانا	بوتسوانا
بوته	بوته
بوجود	بوجود
بود	بود
بودا	بودا
بودار	بودار
بوداپست	بوداپست
بودایی	بودایی
بودجه	بودجه
بودن	بودن
بودند	بودند
بوده	بوده
بودیسم	بودیسم
بور	بور
بوران	بوران
بورد	بورد
بوردو	بوردو
بورس	بورس
بورن	بورن
بوره	بوره
بورِن	بورن
بورکینافاسو	بورکینافاسو
بوریس	بوریس
بوستون	بوستون
بوسنی	بوسنی
بوسنیایی	بوسنیایی
بوسیله	بوسیله
بوش	بوش
بوشهر	بوشهر
بوشهری	بوشهری
بوف	بوف
بوفون	بوفون
بول	بول
بولیوار	بولیوار
بولیوی	بولیوی
بوم	بوم
بومی	بومی
بونصر	بونصر
بویم	بویم
بویی	بویی
بَد	بد
بَدِل	بدل
بَدِن	بدن
بَدی	بدی
بَرسی	برسی
بَرِسی	برسی
بَزه	بزه
بَوره	بوره
بَوِرد	بورد
بَوِره	بوره
بَوِرِن	بورن
بَکاشت	بکاشت
بَکشی	بکشی
بَی	بی
بَینه	بینه
بَیّن	بین
بِمو	بمو
بِن	بن
بِنه	بنه
بِنِه	بنه
بچا	بچا
بک	بک
بکار	بکار
بکارت	بکارت
بکت	بکت
بکشی	بکشی
بکن	بکن
بگذشتی	بگذشتی
بگیرد	بگیرد
بی	بی
بیا	بیا
بیاتی	بیاتی
بیان	بیان
بیانیه	بیانیه
بیت	بیت
بیتلز	بیتلز
بیجار	بیجار
بیداری	بیداری
بیدگل	بیدگل
بیرمنگام	بیرمنگام
بیروت	بیروت
بیرون	بیرون
بیرونی	بیرونی
بیزار	بیزار
بیزانس	بیزانس
بیست	بیست
بیستم	بیستم
بیستمین	بیستمین
بیستون	بیستون
بیسمارک	بیسمارک
بیش	بیش
بیشتر	بیشتر
بیشتری	بیشتری
بیشترین	بیشترین
بیشه	بیشه
بیضوی	بیضوی
بیعت	بیعت
بیل	بیل
بیلبائو	بیلبائو
بیله	بیله
بیلیون	بیلیون
بیم	بیم
بیمار	بیمار
بیمارستان	بیمارستان
بیماری	بیماری
بیماریها	بیماریها
بیمه	بیمه
بین	بین
بینه	بینه
بینِه	بینه
بینی	بینی
بیوگرافی	بیوگرافی
بیِّن	بین
بیّن	بین
بیژن	بیژن
بیک	بیک
بیکاری	بیکاری
بیگم	بیگم
تأثیر	تأثیر
تأثیرات	تأثیرات
تأثیرگذار	تأثیرگذار
تأسیس	تأسیس
تأمین	تأمین
تأکید	تأکید
تأیید	تأیید
تئاتر	تئاتر
تئودور	تئودور
تئوری	تئوری
تا	تا
تاب	تاب
تابستان	تابستان
تابش	تابش
تابع	تابع
تابعیت	تابعیت
تاتار	تاتار
تاتاری	تاتاری
تاثیر	تاثیر
تاج	تاج
تاجر	تاجر
تاجیک	تاجیک
تاجیکستان	تاجیکستان
تاجیکی	تاجیکی
تار	تار
تارکوفسکی	تارکوفسکی
تاریخ	تاریخ
تاریخچه	تاریخچه
تاریک	تاریک
تاریکی	تاریکی
تازه	تازه
تازگی	تازگی
تاسیس	تاسیس
تاشکند	تاشکند
تالاب	تالاب
تالار	تالار
تالش	تالش
تالیف	تالیف
تام	تام
تامسون	تامسون
تامل	تامل
تامیل	تامیل
تامین	تامین
تانزانیا	تانزانیا
تانگ	تانگ
تانگو	تانگو
تاپ	تاپ
تاچر	تاچر
تاکنون	تاکنون
تاکید	تاکید
تایباد	تایباد
تایتانیک	تایتانیک
تایلند	تایلند
تایلندی	تایلندی
تایم	تایم
تایمز	تایمز
تایوان	تایوان
تایپه	تایپه
تایید	تایید
تبادل	تبادل
تبار	تبار
تبت	تبت
تبتی	تبتی
تبدیل	تبدیل
تبری	تبری
تبریز	تبریز
تبریزی	تبریزی
تبعید	تبعید
تبعیض	تبعیض
تبعیضات	تبعیضات
تبلیغ	تبلیغ
تبلیغات	تبلیغات
تبلیغاتی	تبلیغاتی
تبیین	تبیین
تثبیت	تثبیت
تجار	تجار
تجارب	تجارب
تجارت	تجارت
تجاری	تجاری
تجاوز	تجاوز
تجدد	تجدد
تجدید	تجدید
تجربه	تجربه
تجربی	تجربی
تجربیات	تجربیات
تجزیه	تجزیه
تجلیل	تجلیل
تجن	تجن
تجهیزات	تجهیزات
تجویز	تجویز
تحت	تحت
تحریف	تحریف
تحریم	تحریم
تحریک	تحریک
تحسین	تحسین
تحصیل	تحصیل
تحصیلات	تحصیلات
تحقیق	تحقیق
تحقیقات	تحقیقات
تحلیل	تحلیل
تحمل	تحمل
تحمیل	تحمیل
تحول	تحول
تحولات	تحولات
تحویل	تحویل
تخت	تخت
تخته	تخته
تخریب	تخریب
تخصص	تخصص
تخلص	تخلص
تخلیه	تخلیه
تخمین	تخمین
تداخل	تداخل
تداعی	تداعی
تداوم	تداوم
تدبیر	تدبیر
تدریج	تدریج
تدریجاً	تدریجاً
تدریس	تدریس
تدوین	تدوین
تر	تر
ترا	ترا
ترابی	ترابی
ترافیک	ترافیک
ترامپ	ترامپ
ترانزیت	ترانزیت
ترانزیستور	ترانزیستور
ترانه	ترانه
تراکتور	تراکتور
تراکتورسازی	تراکتورسازی
تراکم	تراکم
تربت	تربت
تربیت	تربیت
تربیتی	تربیتی
ترتیب	ترتیب
ترجمه	ترجمه
ترجمهٔ	ترجمه
ترجیح	ترجیح
تردید	تردید
ترس	ترس
ترسناک	ترسناک
ترسی	ترسی
ترسیم	ترسیم
ترش	ترش
ترقی	ترقی
تره	تره
تروا	تروا
تروتسکی	تروتسکی
ترور	ترور
تروریست	تروریست
تروریسم	تروریسم
ترومن	ترومن
تروی	تروی
ترویج	ترویج
ترک	ترک
ترکان	ترکان
ترکمن	ترکمن
ترکمنستان	ترکمنستان
ترکی	ترکی
ترکیب	ترکیب
ترکیبات	ترکیبات
ترکیه	ترکیه
تریاک	تریاک
تریلیون	تریلیون
ترینیداد	ترینیداد
تزئینات	تزئینات
تزار	تزار
تزریق	تزریق
تست	تست
تسخیر	تسخیر
تسلط	تسلط
تسلیت	تسلیت
تسلیحات	تسلیحات
تسلیم	تسلیم
تسمیه	تسمیه
تسنن	تسنن
تسکین	تسکین
تشخیص	تشخیص
تشریح	تشریح
تشعشع	تشعشع
تشویق	تشویق
تشکر	تشکر
تشکیل	تشکیل
تشکیلات	تشکیلات
تشیع	تشیع
تشییع	تشییع
تصادف	تصادف
تصاویر	تصاویر
تصحیح	تصحیح
تصرف	تصرف
تصفیه	تصفیه
تصمیم	تصمیم
تصور	تصور
تصوف	تصوف
تصویب	تصویب
تصویر	تصویر
تضعیف	تضعیف
تضمین	تضمین
تظاهرات	تظاهرات
تعادل	تعادل
تعاریف	تعاریف
تعبیر	تعبیر
تعجب	تعجب
تعداد	تعداد
تعریف	تعریف
تعطیل	تعطیل
تعطیلات	تعطیلات
تعطیلی	تعطیلی
تعقیب	تعقیب
تعلق	تعلق
تعلیق	تعلیق
تعلیم	تعلیم
تعمید	تعمید
تعمیر	تعمیر
تعهد	تعهد
تعویض	تعویض
تعیین	تعیین
تغذیه	تغذیه
تغییر	تغییر
تغییرات	تغییرات
تفاوت	تفاوت
تفریح	تفریح
تفسیر	تفسیر
تفلیس	تفلیس
تفنگ	تفنگ
تفکر	تفکر
تفکرات	تفکرات
تقاضا	تقاضا
تقدیر	تقدیر
تقدیم	تقدیم
تقریبا	تقریبا
تقریباً	تقریباً
تقسیم	تقسیم
تقسیمات	تقسیمات
تقلب	تقلب
تقلید	تقلید
تقوی	تقوی
تقویت	تقویت
تقویم	تقویم
تقی	تقی
تل	تل
تلاش	تلاش
تلافی	تلافی
تلسکوپ	تلسکوپ
تلفات	تلفات
تلفظ	تلفظ
تلفن	تلفن
تلفیق	تلفیق
تلقی	تلقی
تلمبار	تلمبار
تله	تله
تلویزیون	تلویزیون
تلگراف	تلگراف
تلگرام	تلگرام
تماس	تماس
تمام	تمام
تمایل	تمایل
تمدن	تمدن
تمرکز	تمرکز
تمرین	تمرین
تمرینات	تمرینات
تن	تن
تناسخ	تناسخ
تناسلی	تناسلی
تنباکو	تنباکو
تنبیه	تنبیه
تند	تند
تنسی	تنسی
تنش	تنش
تنظیم	تنظیم
تنقلات	تنقلات
تنه	تنه
تنها	تنها
تنهایی	تنهایی
تنوع	تنوع
تنِ	تن
تنک	تنک
تنکابن	تنکابن
تنگ	تنگ
تنگه	تنگه
تنیس	تنیس
ته	ته
تهدید	تهدید
تهران	تهران
تهماسب	تهماسب
تهمت	تهمت
تهیه	تهیه
تو	تو
توابع	توابع
توافق	توافق
توان	توان
توانایی	توانایی
توانست	توانست
توانمند	توانمند
توبه	توبه
توتالیتاریسم	توتالیتاریسم
توجه	توجه
توجهی	توجهی
توجیه	توجیه
توحیدی	توحیدی
توده	توده
تور	تور
تورات	تورات
توران	توران
تورانی	تورانی
تورم	تورم
تورنتو	تورنتو
تورنمنت	تورنمنت
توری	توری
توریست	توریست
توریسم	توریسم
تورین	تورین
توزیع	توزیع
توس	توس
توسط	توسط
توسعه	توسعه
توسکا	توسکا
توصیف	توصیف
توصیه	توصیه
توضیح	توضیح
توطئه	توطئه
توفیق	توفیق
توقف	توقف
توقیف	توقیف
تولد	تولد
تولستوی	تولستوی
تولوز	تولوز
تولید	تولید
تولیدات	تولیدات
توماس	توماس
تومان	تومان
تومور	تومور
تون	تون
تونس	تونس
تونل	تونل
تونی	تونی
توهین	توهین
توپ	توپ
توکل	توکل
توکلی	توکلی
توکویل	توکویل
توکیو	توکیو
توگو	توگو
توی	توی
تَنِک	تنک
تُن	تُن
تِبار	تبار
تِفِنگ	تفنگ
تِلاش	تلاش
تِک	تک
تپش	تپش
تپه	تپه
تک	تک
تکامل	تکامل
تکانه	تکانه
تکثیر	تکثیر
تکذیب	تکذیب
تکرار	تکرار
تکریت	تکریت
تکلیف	تکلیف
تکمیل	تکمیل
تکنولوژی	تکنولوژی
تکه	تکه
تکیه	تکیه
تگزاس	تگزاس
تی	تی
تیتراژ	تیتراژ
تیر	تیر
تیران	تیران
تیراندازی	تیراندازی
تیراژ	تیراژ
تیرماه	تیرماه
تیره	تیره
تیلور	تیلور
تیم	تیم
تیمار	تیمار
تیمور	تیمور
تیموری	تیموری
تیموریان	تیموریان
تیمی	تیمی
تیپ	تیپ
تیکه	تیکه
ثابت	ثابت
ثالث	ثالث
ثانی	ثانی
ثانیه	ثانیه
ثبات	ثبات
ثبت	ثبت
ثروت	ثروت
ثروتمند	ثروتمند
جا	جا
جاده	جاده
جادوگر	جادوگر
جادوگری	جادوگری
جاذبه	جاذبه
جاری	جاری
جاز	جاز
جاستین	جاستین
جاسوسی	جاسوسی
جالب	جالب
جام	جام
جامد	جامد
جامع	جامع
جامعه	جامعه
جان	جان
جاناتان	جاناتان
جانب	جانب
جانبی	جانبی
جاندار	جاندار
جانسون	جانسون
جانشین	جانشین
جانشینی	جانشینی
جانور	جانور
جانِّ	جان
جانی	جانی
جاوا	جاوا
جاوه	جاوه
جایزه	جایزه
جایزهٔ	جایزه
جایگاه	جایگاه
جایگزین	جایگزین
جبار	جبار
جبال	جبال
جبر	جبر
جبران	جبران
جبل	جبل
جبهه	جبهه
جد	جد
جدا	جدا
جداگانه	جداگانه
جدایی	جدایی
جده	جده
جدول	جدول
جدی	جدی
جدید	جدید
جدیدِ	جدید
جذب	جذب
جر	جر
جراحی	جراحی
جرالد	جرالد
جرایم	جرایم
جرج	جرج
جرجان	جرجان
جرجانی	جرجانی
جرم	جرم
جریان	جریان
جریب	جریب
جز	جز
جزء	جزء
جزئی	جزئی
جزئیات	جزئیات
جزایر	جزایر
جزو	جزو
جزیره	جزیره
جزیرهٔ	جزیره
جسد	جسد
جسم	جسم
جسمانی	جسمانی
جشن	جشن
جشنواره	جشنواره
جعفر	جعفر
جعفری	جعفری
جعفریه	جعفریه
جغرافیایی	جغرافیایی
جفت	جفت
جفتی	جفتی
جفرسون	جفرسون
جلال	جلال
جلالی	جلالی
جلایر	جلایر
جلب	جلب
جلد	جلد
جلسات	جلسات
جلسه	جلسه
جلفا	جلفا
جلو	جلو
جلوگیری	جلوگیری
جلوی	جلوی
جلگه	جلگه
جلیل	جلیل
جم	جم
جمادی	جمادی
جماعت	جماعت
جمال	جمال
جماهیر	جماهیر
جمشید	جمشید
جمع	جمع
جمعاً	جمعاً
جمعه	جمعه
جمعی	جمعی
جمعیت	جمعیت
جمعیتی	جمعیتی
جملات	جملات
جمله	جمله
جمهور	جمهور
جمهوری	جمهوری
جمهوریخواه	جمهوریخواه
جمهوریِ	جمهوری
جمیل	جمیل
جمیله	جمیله
جناح	جناح
جنازه	جنازه
جنایات	جنایات
جنایت	جنایت
جنایی	جنایی
جنبش	جنبش
جنبه	جنبه
جنس	جنس
جنسیت	جنسیت
جنوا	جنوا
جنوب	جنوب
جنوبگان	جنوبگان
جنوبی	جنوبی
جنگ	جنگ
جنگجو	جنگجو
جنگل	جنگل
جنگنده	جنگنده
جنگِ	جنگ
جنگی	جنگی
جنیفر	جنیفر
جهاد	جهاد
جهان	جهان
جهانگیر	جهانگیر
جهانی	جهانی
جهت	جهت
جهش	جهش
جو	جو
جواب	جواب
جواد	جواد
جوامع	جوامع
جوان	جوان
جوانان	جوانان
جوانی	جوانی
جواهر	جواهر
جواهرات	جواهرات
جوایز	جوایز
جوبار	جوبار
جور	جور
جوراب	جوراب
جورج	جورج
جورجیا	جورجیا
جورواجور	جورواجور
جوزانی	جوزانی
جوزف	جوزف
جوش	جوش
جولای	جولای
جولی	جولی
جولیا	جولیا
جولیوس	جولیوس
جون	جون
جونز	جونز
جونیور	جونیور
جوهر	جوهر
جویبار	جویبار
جویباری	جویباری
جِواب	جواب
جک	جک
جکسون	جکسون
جی	جی
جیبوتی	جیبوتی
جیحون	جیحون
جیر	جیر
جیسون	جیسون
جیم	جیم
جیمز	جیمز
جیمی	جیمی
جین	جین
جیوه	جیوه
حاتم	حاتم
حاج	حاج
حاجی	حاجی
حادثه	حادثه
حاشیه	حاشیه
حاصل	حاصل
حاصلضرب	حاصلضرب
حاضر	حاضر
حافظ	حافظ
حافظه	حافظه
حال	حال
حالت	حالت
حالیکه	حالیکه
حامد	حامد
حامل	حامل
حامی	حامی
حاکم	حاکم
حاکمیت	حاکمیت
حاکی	حاکی
حبس	حبس
حبوبات	حبوبات
حبیب	حبیب
حبیبی	حبیبی
حتا	حتا
حتما	حتما
حتی	حتی
حج	حج
حجاز	حجاز
حجازی	حجازی
حجت	حجت
حجم	حجم
حد	حد
حداقل	حداقل
حداکثر	حداکثر
حدس	حدس
حدود	حدود
حدودا	حدودا
حدوداً	حدوداً
حدیث	حدیث
حذف	حذف
حرارت	حرارت
حرام	حرام
حرف	حرف
حرفه	حرفه
حرم	حرم
حرمسرا	حرمسرا
حروف	حروف
حروفی	حروفی
حرکات	حرکات
حرکت	حرکت
حریری	حریری
حریف	حریف
حریم	حریم
حزب	حزب
حس	حس
حساب	حساب
حساس	حساس
حسام	حسام
حسب	حسب
حسن	حسن
حسنی	حسنی
حسودی	حسودی
حسین	حسین
حسینعلی	حسینعلی
حسینقلی	حسینقلی
حسینی	حسینی
حشرات	حشرات
حشره	حشره
حشمت	حشمت
حشیش	حشیش
حضرت	حضرت
حضور	حضور
حفاری	حفاری
حفاظت	حفاظت
حفظ	حفظ
حق	حق
حقایق	حقایق
حقوق	حقوق
حقوقدان	حقوقدان
حقوقی	حقوقی
حقیقت	حقیقت
حقیقی	حقیقی
حل	حل
حلب	حلب
حلبچه	حلبچه
حلقه	حلقه
حماس	حماس
حماسه	حماسه
حماسی	حماسی
حمام	حمام
حمایت	حمایت
حمد	حمد
حمزه	حمزه
حمص	حمص
حمل	حمل
حملات	حملات
حمله	حمله
حمید	حمید
حمیدرضا	حمیدرضا
حنا	حنا
حنابندان	حنابندان
حنجره	حنجره
حوا	حوا
حوادث	حوادث
حواری	حواری
حواریون	حواریون
حواس	حواس
حوالی	حوالی
حوزه	حوزه
حوزوی	حوزوی
حومه	حومه
حکایت	حکایت
حکم	حکم
حکماً	حکما
حکمت	حکمت
حکومت	حکومت
حکومتِ	حکومت
حکومِت	حکومت
حکیم	حکیم
حیات	حیات
حیاتی	حیاتی
حیاط	حیاط
حیث	حیث
حیثیت	حیثیت
حیدر	حیدر
حیدری	حیدری
حیدریه	حیدریه
حیران	حیران
حین	حین
حیوان	حیوان
حیوانات	حیوانات
خاتمی	خاتمی
خار	خار
خارج	خارج
خارجه	خارجه
خارجی	خارجی
خاره	خاره
خارِ	خار
خارکش	خارکش
خاری	خاری
خازن	خازن
خاسته	خاسته
خاستگاه	خاستگاه
خاش	خاش
خاص	خاص
خاصیت	خاصیت
خاطر	خاطر
خاطرات	خاطرات
خاطره	خاطره
خالص	خالص
خالی	خالی
خام	خام
خامنه	خامنه
خاموش	خاموش
خان	خان
خاندان	خاندان
خانقاه	خانقاه
خانم	خانم
خانه	خانه
خانواده	خانواده
خانوادهٔ	خانواده
خانوادگی	خانوادگی
خانوار	خانوار
خانّه	خانه
خانگی	خانگی
خانی	خانی
خاورمیانه	خاورمیانه
خاوری	خاوری
خاویار	خاویار
خاک	خاک
خبر	خبر
خبرگان	خبرگان
خبرگزاری	خبرگزاری
ختم	ختم
خجیر	خجیر
خدا	خدا
خدابنده	خدابنده
خداوند	خداوند
خدایی	خدایی
خدمات	خدمات
خدماتی	خدماتی
خدمت	خدمت
خر	خر
خراب	خراب
خرابه	خرابه
خراج	خراج
خراسان	خراسان
خراسانی	خراسانی
خرافات	خرافات
خرج	خرج
خرد	خرد
خرداد	خرداد
خرس	خرس
خرم	خرم
خروج	خروج
خروشچف	خروشچف
خرچنگ	خرچنگ
خرید	خرید
خزانه	خزانه
خزر	خزر
خزنده	خزنده
خسته	خسته
خستگی	خستگی
خسرو	خسرو
خسروپرویز	خسروپرویز
خسرویِ	خسروی
خش	خش
خشت	خشت
خشم	خشم
خشمگین	خشمگین
خشن	خشن
خشونت	خشونت
خشک	خشک
خشکی	خشکی
خصوص	خصوص
خصوصاً	خصوصاً
خصوصی	خصوصی
خصوصیات	خصوصیات
خصوصیت	خصوصیت
خط	خط
خطاب	خطاب
خطاطی	خطاطی
خطبه	خطبه
خطر	خطر
خطرناک	خطرناک
خطوط	خطوط
خطی	خطی
خطیب	خطیب
خلأ	خلأ
خلاصه	خلاصه
خلاف	خلاف
خلافت	خلافت
خلال	خلال
خلبان	خلبان
خلخال	خلخال
خلدون	خلدون
خلع	خلع
خلعتبری	خلعتبری
خلفا	خلفا
خلق	خلق
خلوت	خلوت
خلی	خلی
خلیج	خلیج
خلیفه	خلیفه
خلیل	خلیل
خم	خم
خمر	خمر
خمس	خمس
خمسه	خمسه
خمینی	خمینی
خنجر	خنجر
خندق	خندق
خنده	خنده
خو	خو
خوآن	خوآن
خواب	خواب
خوابگاه	خوابگاه
خواجه	خواجه
خوار	خوار
خوارزم	خوارزم
خوارزمی	خوارزمی
خواستار	خواستار
خواص	خواص
خواف	خواف
خوان	خوان
خوانده	خوانده
خوانسار	خوانسار
خواننده	خواننده
خوانندگان	خوانندگان
خواه	خواه
خواهان	خواهان
خواهد	خواهد
خواهم	خواهم
خوب	خوب
خوبی	خوبی
خوتکا	خوتکا
خود	خود
خودداری	خودداری
خودرو	خودرو
خودش	خودش
خودمختار	خودمختار
خودمختاری	خودمختاری
خودکشی	خودکشی
خودگردان	خودگردان
خور	خور
خوراک	خوراک
خوراکی	خوراکی
خورخه	خورخه
خورد	خورد
خوردن	خوردن
خورده	خورده
خورش	خورش
خورشید	خورشید
خورشیدی	خورشیدی
خوری	خوری
خوزستان	خوزستان
خوزه	خوزه
خوش	خوش
خوشاب	خوشاب
خوشرو	خوشرو
خوشه	خوشه
خولیو	خولیو
خون	خون
خونریزی	خونریزی
خَور	خور
خَوری	خوری
خَوِر	خور
خَوِری	خوری
خِجیر	خجیر
خِدا	خدا
خِراب	خراب
خِش	خش
خیابان	خیابان
خیال	خیال
خیام	خیام
خیانت	خیانت
خیر	خیر
خیرالنساء	خیرالنساء
خیریه	خیریه
خیل	خیل
خیلی	خیلی
داخل	داخل
داخلی	داخلی
داد	داد
دادن	دادن
دادند	دادند
داده	داده
دادگاه	دادگاه
دادگستری	دادگستری
دار	دار
دارا	دارا
داراب	داراب
دارالسلام	دارالسلام
دارالفنون	دارالفنون
دارای	دارای
دارایی	دارایی
داربی	داربی
دارد	دارد
داردانل	داردانل
دارفور	دارفور
دارن	دارن
دارند	دارند
دارو	دارو
داروسازی	داروسازی
دارونما	دارونما
داروین	داروین
دارِن	دارن
داری	داری
داریوش	داریوش
داس	داس
داستان	داستان
داستانی	داستانی
داشت	داشت
داشتن	داشتن
داشتند	داشتند
داشته	داشته
داعش	داعش
داعی	داعی
داغ	داغ
داغستان	داغستان
دالاس	دالاس
دالایی	دالایی
دام	دام
داماد	داماد
دامداری	دامداری
دامغان	دامغان
دامنه	دامنه
دان	دان
دانا	دانا
دانایی	دانایی
دانش	دانش
دانشجو	دانشجو
دانشجویی	دانشجویی
دانشمند	دانشمند
دانشمندان	دانشمندان
دانشنامه	دانشنامه
دانشکده	دانشکده
دانشگاه	دانشگاه
دانشی	دانشی
دانلود	دانلود
دانمارک	دانمارک
دانمارکی	دانمارکی
دانند	دانند
دانه	دانه
دانوب	دانوب
دانّه	دانه
دانگ	دانگ
دانیل	دانیل
داود	داود
داوری	داوری
داوطلب	داوطلب
داوود	داوود
داوینچی	داوینچی
داکا	داکا
داکوتا	داکوتا
داگلاس	داگلاس
دایره	دایره
دایمی	دایمی
دایه	دایه
دایی	دایی
دبستان	دبستان
دبلیو	دبلیو
دبی	دبی
دبیر	دبیر
دبیرستان	دبیرستان
دبیرکل	دبیرکل
دجله	دجله
دخالت	دخالت
دختر	دختر
دختران	دختران
در	در
درآمد	درآمد
دراز	دراز
درازی	درازی
درام	درام
دراویدی	دراویدی
درای	درای
دربار	دربار
درباره	درباره
دربارهٔ	دربارهٔ
دربند	دربند
درجات	درجات
درجه	درجه
درجهٔ	درجه
درحال	درحال
درحالی	درحالی
درخت	درخت
درخواست	درخواست
درد	درد
دردسر	دردسر
درزی	درزی
درس	درس
درست	درست
درستی	درستی
درسی	درسی
درصد	درصد
درصدد	درصدد
درفش	درفش
درمان	درمان
درمانی	درمانی
دره	دره
درهم	درهم
درو	درو
دروازه	دروازه
درواقع	درواقع
دروم	دروم
درون	درون
درونه	درونه
درونی	درونی
درویش	درویش
درویشی	درویشی
درک	درک
درگذشت	درگذشت
درگیر	درگیر
درگیری	درگیری
دریا	دریا
دریافت	دریافت
دریانورد	دریانورد
دریانوردی	دریانوردی
دریاچه	دریاچه
دریاکنار	دریاکنار
دریایی	دریایی
دزد	دزد
دزدی	دزدی
دسامبر	دسامبر
دست	دست
دسترس	دسترس
دسترسی	دسترسی
دسته	دسته
دستور	دستور
دستوری	دستوری
دستگاه	دستگاه
دستگرد	دستگرد
دستگیر	دستگیر
دستگیری	دستگیری
دستی	دستی
دستیابی	دستیابی
دستیار	دستیار
دشت	دشت
دشتی	دشتی
دشمن	دشمن
دشمنی	دشمنی
دشوار	دشوار
دعا	دعا
دعوا	دعوا
دعوت	دعوت
دفاتر	دفاتر
دفاع	دفاع
دفاعیات	دفاعیات
دفاعیه	دفاعیه
دفتر	دفتر
دفع	دفع
دفعه	دفعه
دفن	دفن
دقت	دقت
دقیق	دقیق
دقیقا	دقیقا
دقیقاً	دقیقاً
دقیقه	دقیقه
دقیقی	دقیقی
دل	دل
دلا	دلا
دلار	دلار
دلایل	دلایل
دلفین	دلفین
دله	دله
دلیل	دلیل
دلیلی	دلیلی
دم	دم
دما	دما
دماغ	دماغ
دماغه	دماغه
دماوند	دماوند
دمبل	دمبل
دمبک	دمبک
دمشق	دمشق
دموکرات	دموکرات
دموکراتیک	دموکراتیک
دموکراسی	دموکراسی
دمکرات	دمکرات
دمکراتیک	دمکراتیک
دمکراسی	دمکراسی
دمیرچی	دمیرچی
دن	دن
دنبال	دنبال
دنباله	دنباله
دنور	دنور
دنگ	دنگ
دنی	دنی
دنیا	دنیا
دنیایی	دنیایی
دنیرو	دنیرو
ده	ده
دهخدا	دهخدا
دهد	دهد
دهستان	دهستان
دهستانی	دهستانی
دهلی	دهلی
دهم	دهم
دهمین	دهمین
دهند	دهند
دهنده	دهنده
دهه	دهه
دههٔ	دهه
دهک	دهک
دهکده	دهکده
دهی	دهی
دو	دو
دوا	دوا
دوازده	دوازده
دوازدهم	دوازدهم
دوبار	دوبار
دوباره	دوباره
دوبلاژ	دوبلاژ
دوبله	دوبله
دوبلهٔ	دوبله
دوبی	دوبی
دوحه	دوحه
دور	دور
دوران	دوران
دوربین	دوربین
دورتموند	دورتموند
دوره	دوره
دورهٔ	دوره
دوری	دوری
دوست	دوست
دوستان	دوستان
دوستانه	دوستانه
دوستی	دوستی
دوش	دوش
دوشنبه	دوشنبه
دوشیدن	دوشیدن
دول	دول
دولت	دولت
دولتِ	دولت
دولِت	دولت
دوم	دوم
دوما	دوما
دومین	دومین
دومینیک	دومینیک
دومینیکن	دومینیکن
دون	دون
دونالد	دونالد
دونده	دونده
دوو	دوو
دوک	دوک
دوی	دوی
دویست	دویست
دَر	در
دَره	دره
دَرون	درون
دَست	دست
دَم	دم
دَنی	دنی
دَه	ده
دَیّه	دیه
دِرس	درس
دِرو	درو
دِرِس	درس
دِرِست	درست
دِشمن	دشمن
دِل	دل
دِله	دله
دِم	دم
دِنیا	دنیا
دچار	دچار
دژ	دژ
دکارت	دکارت
دکتر	دکتر
دکترا	دکترا
دکتری	دکتری
دکترین	دکترین
دی	دی
دیات	دیات
دیار	دیار
دیاربکر	دیاربکر
دیاله	دیاله
دیالوگ	دیالوگ
دیترویت	دیترویت
دید	دید
دیدار	دیدار
دیدن	دیدن
دیدنی	دیدنی
دیده	دیده
دیدگاه	دیدگاه
دیر	دیر
دیزنی	دیزنی
دیس	دیس
دیلم	دیلم
دیلمان	دیلمان
دیلمی	دیلمی
دیم	دیم
دین	دین
دینار	دینار
دینی	دینی
دیه	دیه
دیو	دیو
دیوار	دیوار
دیوان	دیوان
دیوانه	دیوانه
دیوید	دیوید
دیویس	دیویس
دیّم	دیم
دیّن	دین
دیّه	دیه
دیپلم	دیپلم
دیپلمات	دیپلمات
دیکتاتور	دیکتاتور
دیکتاتوری	دیکتاتوری
دیگر	دیگر
دیگری	دیگری
دیگه	دیگه
دیگو	دیگو
ذخایر	ذخایر
ذخیره	ذخیره
ذرات	ذرات
ذره	ذره
ذغال	ذغال
ذهن	ذهن
ذهنی	ذهنی
ذوالفقار	ذوالفقار
ذوالقرنین	ذوالقرنین
ذوب	ذوب
ذکر	ذکر
ذیل	ذیل
رأس	رأس
رأی	رأی
رئیس	رئیس
رئیسی	رئیسی
را	را
رابرت	رابرت
رابطه	رابطه
رابطهٔ	رابطه
رابین	رابین
راجع	راجع
راحت	راحت
رادرفورد	رادرفورد
رادیو	رادیو
رادیویی	رادیویی
رادیکال	رادیکال
راز	راز
رازی	رازی
راس	راس
راست	راست
راسته	راسته
راستکی	راستکی
راستی	راستی
راسل	راسل
راضی	راضی
رالف	رالف
رام	رام
رامسر	رامسر
رامون	رامون
رامین	رامین
رانی	رانی
راه	راه
راهنمایی	راهنمایی
راهپیمایی	راهپیمایی
راهی	راهی
راوی	راوی
راک	راک
راکفلر	راکفلر
راکون	راکون
راکی	راکی
رای	رای
رایانه	رایانه
رایج	رایج
رایش	رایش
راین	راین
رباط	رباط
ربط	ربط
ربع	ربع
ربیع	ربیع
رتبه	رتبه
رج	رج
رجال	رجال
رجایی	رجایی
رجب	رجب
رجه	رجه
رحیم	رحیم
رخ	رخ
رد	رد
رده	رده
ردیف	ردیف
رز	رز
رساله	رساله
رسانا	رسانا
رساند	رساند
رسانه	رسانه
رستم	رستم
رستمی	رستمی
رستوران	رستوران
رستگاری	رستگاری
رسد	رسد
رسم	رسم
رسما	رسما
رسماً	رسماً
رسمیت	رسمیت
رسن	رسن
رسوم	رسوم
رسی	رسی
رسید	رسید
رسیدند	رسیدند
رشت	رشت
رشته	رشته
رشتهٔ	رشته
رشتی	رشتی
رشد	رشد
رصد	رصد
رضا	رضا
رضاخان	رضاخان
رضازاده	رضازاده
رضاشاه	رضاشاه
رضایت	رضایت
رضایی	رضایی
رضوان	رضوان
رضوانیه	رضوانیه
رضوی	رضوی
رطوبت	رطوبت
رعایت	رعایت
رعد	رعد
رفاه	رفاه
رفاهی	رفاهی
رفت	رفت
رفتار	رفتار
رفته	رفته
رفتیم	رفتیم
رفراندوم	رفراندوم
رفسنجانی	رفسنجانی
رفع	رفع
رفق	رفق
رفیع	رفیع
رفیقی	رفیقی
رقابت	رقابت
رقص	رقص
رقم	رقم
رقیب	رقیب
رم	رم
رمان	رمان
رمانتیک	رمانتیک
رمز	رمز
رمضان	رمضان
رمضانی	رمضانی
رمی	رمی
رن	رن
رنج	رنج
رنجبر	رنجبر
رنسانس	رنسانس
رنه	رنه
رنو	رنو
رنگ	رنگ
رنگین	رنگین
ره	ره
رها	رها
رهایی	رهایی
رهبر	رهبر
رهبران	رهبران
رهبری	رهبری
رهنما	رهنما
رهنمون	رهنمون
رهگذر	رهگذر
رو	رو
روآندا	روآندا
روا	روا
روابط	روابط
رواج	رواج
روان	روان
رواندا	رواندا
روانشناس	روانشناس
روانشناسی	روانشناسی
روانکاوی	روانکاوی
روانی	روانی
روایات	روایات
روایت	روایت
روایتی	روایتی
روبر	روبر
روبرت	روبرت
روبرو	روبرو
روبل	روبل
روبن	روبن
روح	روح
روحانی	روحانی
روحانیون	روحانیون
روحی	روحی
روحیه	روحیه
رود	رود
رودبار	رودبار
رودخانه	رودخانه
رودریگز	رودریگز
رودریگو	رودریگو
رودسر	رودسر
روده	روده
روز	روز
روزانه	روزانه
روزمره	روزمره
روزنامه	روزنامه
روزنامهٔ	روزنامه
روزه	روزه
روزولت	روزولت
روزگار	روزگار
روزی	روزی
روس	روس
روسا	روسا
روستا	روستا
روستایی	روستایی
روسی	روسی
روسیه	روسیه
روش	روش
روشن	روشن
روشنایی	روشنایی
روشنی	روشنی
روشِن	روشن
روغن	روغن
رولان	رولان
روم	روم
رومانی	رومانی
رومانیایی	رومانیایی
رومن	رومن
رومِ	روم
رومی	رومی
رونالد	رونالد
رونالدو	رونالدو
روند	روند
رونق	رونق
روپیه	روپیه
روژه	روژه
روی	روی
رویال	رویال
رویان	رویان
رویانی	رویانی
رویداد	رویداد
رویکرد	رویکرد
رَج	رج
رَد	رد
رَسِد	رسد
رَسِن	رسن
رَفِق	رفق
رُشد	رشد
رُل	رل
رِه	ره
رپ	رپ
رژیم	رژیم
رکن	رکن
رکود	رکود
رکورد	رکورد
ری	ری
ریاست	ریاست
ریاض	ریاض
ریاضی	ریاضی
ریاضیات	ریاضیات
ریال	ریال
ریتم	ریتم
ریز	ریز
ریزشگاه	ریزشگاه
ریزه	ریزه
ریزی	ریزی
ریشار	ریشار
ریشه	ریشه
ریشهٔ	ریشه
ریف	ریف
ریل	ریل
ریه	ریه
ریو	ریو
ریچارد	ریچارد
ریچموند	ریچموند
ریکا	ریکا
ریکاردو	ریکاردو
ریگ	ریگ
ریگان	ریگان
زئیر	زئیر
زاده	زاده
زادهٔ	زاده
زادگاه	زادگاه
زارع	زارع
زاغمرز	زاغمرز
زال	زال
زامبیا	زامبیا
زامنهوف	زامنهوف
زاویه	زاویه
زاپاتا	زاپاتا
زاگرس	زاگرس
زبان	زبان
زبون	زبون
زبیر	زبیر
زحمت	زحمت
زخمی	زخمی
زد	زد
زراعت	زراعت
زرتشت	زرتشت
زرتشتی	زرتشتی
زرتشتیان	زرتشتیان
زرد	زرد
زردشت	زردشت
زرگری	زرگری
زرین	زرین
زلاتان	زلاتان
زلزله	زلزله
زمان	زمان
زمانی	زمانی
زمستان	زمستان
زمین	زمین
زمینه	زمینه
زمینهٔ	زمینه
زمینی	زمینی
زن	زن
زنا	زنا
زنان	زنان
زنانِ	زنان
زنبور	زنبور
زنجان	زنجان
زند	زند
زندان	زندان
زندانی	زندانی
زنده	زنده
زندگی	زندگی
زندیه	زندیه
زنگ	زنگ
زنگبار	زنگبار
زنی	زنی
زهرا	زهرا
زهره	زهره
زواره	زواره
زوال	زوال
زود	زود
زودرس	زودرس
زودی	زودی
زور	زور
زوریخ	زوریخ
زَنده	زنده
زِنا	زنا
زکریا	زکریا
زیاد	زیاد
زیاده	زیاده
زیادی	زیادی
زیار	زیار
زیارت	زیارت
زیبا	زیبا
زیباکلام	زیباکلام
زیبایی	زیبایی
زید	زید
زیدی	زیدی
زیدیه	زیدیه
زیر	زیر
زیرآب	زیرآب
زیرا	زیرا
زیرزمین	زیرزمین
زیرزمینی	زیرزمینی
زیست	زیست
زیستگاه	زیستگاه
زیستی	زیستی
زیمبابوه	زیمبابوه
زین	زین
زینتی	زینتی
زیگموند	زیگموند
سؤال	سؤال
سابق	سابق
سابقاً	سابقاً
سابقه	سابقه
ساحل	ساحل
ساخاروف	ساخاروف
ساخالین	ساخالین
ساخت	ساخت
ساختار	ساختار
ساختمان	ساختمان
ساختن	ساختن
ساخته	ساخته
سادات	سادات
ساده	ساده
سارا	سارا
سارایوو	سارایوو
سارد	سارد
ساروج	ساروج
ساروی	ساروی
سارکوزی	سارکوزی
ساری	ساری
ساریِ	ساری
ساز	ساز
سازمان	سازمان
سازماندهی	سازماندهی
سازنده	سازنده
سازه	سازه
سازگار	سازگار
سازگاری	سازگاری
سازی	سازی
ساسان	ساسان
ساسانی	ساسانی
ساسانیان	ساسانیان
ساعات	ساعات
ساعت	ساعت
ساقه	ساقه
سال	سال
سالار	سالار
سالانه	سالانه
سالم	سالم
ساله	ساله
سالوادور	سالوادور
سالِ	سال
سالگرد	سالگرد
سالگی	سالگی
سالیان	سالیان
سام	سام
سامانه	سامانه
سامانی	سامانی
سامرا	سامرا
سامورایی	سامورایی
سامی	سامی
سان	سان
سانتر	سانتر
سانتوس	سانتوس
سانتیاگو	سانتیاگو
سانتیمتر	سانتیمتر
سانحه	سانحه
سانسور	سانسور
سانسکریت	سانسکریت
سانفرانسیسکو	سانفرانسیسکو
سانچز	سانچز
ساوالان	ساوالان
ساوجبلاغ	ساوجبلاغ
ساکن	ساکن
ساکنان	ساکنان
ساکنین	ساکنین
سایت	سایت
سایر	سایر
ساینس	ساینس
سایه	سایه
سایپا	سایپا
سبا	سبا
سباستین	سباستین
سبب	سبب
سبز	سبز
سبزه	سبزه
سبزوار	سبزوار
سبزی	سبزی
سبزیجات	سبزیجات
سبلان	سبلان
سبک	سبک
ستاد	ستاد
ستار	ستار
ستاره	ستاره
ستد	ستد
ستوده	ستوده
ستون	ستون
سجاد	سجاد
سحاب	سحاب
سحابی	سحابی
سحر	سحر
سخت	سخت
سختی	سختی
سخن	سخن
سخنرانی	سخنرانی
سخنگوی	سخنگوی
سد	سد
سده	سده
سدهٔ	سده
سر	سر
سرا	سرا
سراج	سراج
سراسر	سراسر
سراسری	سراسری
سراغ	سراغ
سرامیک	سرامیک
سران	سران
سرانجام	سرانجام
سرب	سرب
سرباز	سرباز
سربازان	سربازان
سربازی	سربازی
سرتاسر	سرتاسر
سرجمع	سرجمع
سرخ	سرخ
سرخاب	سرخاب
سرخس	سرخس
سرخوش	سرخوش
سرخپوست	سرخپوست
سرد	سرد
سردابه	سردابه
سردار	سردار
سردبیر	سردبیر
سردبیری	سردبیری
سردرد	سردرد
سردی	سردی
سرزمین	سرزمین
سرسبز	سرسبز
سرشار	سرشار
سرشماری	سرشماری
سرشناس	سرشناس
سرطان	سرطان
سرعت	سرعت
سرعین	سرعین
سرما	سرما
سرمایه	سرمایه
سرمربی	سرمربی
سرنوشت	سرنوشت
سرنگون	سرنگون
سرنگونی	سرنگونی
سره	سره
سروآباد	سروآباد
سروانتس	سروانتس
سرود	سرود
سرور	سرور
سروش	سروش
سرویس	سرویس
سرپرست	سرپرست
سرپرستی	سرپرستی
سرچشمه	سرچشمه
سرژ	سرژ
سرکوب	سرکوب
سرکیسیان	سرکیسیان
سرگذشت	سرگذشت
سرگرم	سرگرم
سرگرمی	سرگرمی
سری	سری
سریال	سریال
سریالِ	سریال
سریع	سریع
سریعاً	سریعاً
سریلانکا	سریلانکا
سزار	سزار
سزیم	سزیم
سطح	سطح
سطوح	سطوح
سعادت	سعادت
سعد	سعد
سعدی	سعدی
سعود	سعود
سعودی	سعودی
سعی	سعی
سعید	سعید
سعیدی	سعیدی
سفارت	سفارت
سفارش	سفارش
سفت	سفت
سفر	سفر
سفره	سفره
سفلی	سفلی
سفید	سفید
سفیر	سفیر
سقراط	سقراط
سقراطی	سقراطی
سقز	سقز
سقف	سقف
سقوط	سقوط
سل	سل
سلاح	سلاح
سلاطین	سلاطین
سلاله	سلاله
سلام	سلام
سلامت	سلامت
سلامتی	سلامتی
سلتی	سلتی
سلجوقی	سلجوقی
سلجوقیان	سلجوقیان
سلسله	سلسله
سلطان	سلطان
سلطنت	سلطنت
سلطه	سلطه
سلف	سلف
سلمان	سلمان
سلول	سلول
سلیم	سلیم
سلیمان	سلیمان
سلیمانی	سلیمانی
سلیمانیه	سلیمانیه
سلیمی	سلیمی
سم	سم
سما	سما
سماوی	سماوی
سمبل	سمبل
سمت	سمت
سمرقند	سمرقند
سمنان	سمنان
سمنانی	سمنانی
سمیرم	سمیرم
سن	سن
سنا	سنا
سناتور	سناتور
سنت	سنت
سنجر	سنجر
سند	سند
سنندج	سنندج
سنه	سنه
سنگ	سنگ
سنگال	سنگال
سنگاپور	سنگاپور
سنگر	سنگر
سنگسر	سنگسر
سنگسری	سنگسری
سنگین	سنگین
سنگینی	سنگینی
سنی	سنی
سنین	سنین
سه	سه
سهراب	سهراب
سهم	سهم
سهند	سهند
سهیل	سهیل
سو	سو
سوء	سوء
سوئد	سوئد
سوئدی	سوئدی
سوئیس	سوئیس
سوا	سوا
سوابق	سوابق
سواحل	سواحل
سواد	سواد
سوادکوه	سوادکوه
سوادکوهِ	سوادکوه
سوادکوهی	سوادکوهی
سوار	سوار
سوارز	سوارز
سواری	سواری
سوازیلند	سوازیلند
سوال	سوال
سوت	سوت
سوخت	سوخت
سود	سود
سودان	سودان
سودی	سودی
سور	سور
سوراخ	سوراخ
سوربن	سوربن
سوره	سوره
سوری	سوری
سورینام	سورینام
سوریه	سوریه
سوز	سوز
سوزان	سوزان
سوسن	سوسن
سوسو	سوسو
سوسیال	سوسیال
سوسیالیست	سوسیالیست
سوسیالیستی	سوسیالیستی
سوسیالیسم	سوسیالیسم
سوفیا	سوفیا
سوم	سوم
سوماترا	سوماترا
سومالی	سومالی
سومین	سومین
سونا	سونا
سوهارتو	سوهارتو
سوچی	سوچی
سوکارنو	سوکارنو
سوگند	سوگند
سوی	سوی
سَر	سر
سَره	سره
سَوز	سوز
سُنّی	سنّی
سِر	سر
سِرخ	سرخ
سِره	سره
سِه	سه
سِوا	سوا
سِوار	سوار
سِواسِوا	سواسوا
سّه	سه
سپاه	سپاه
سپتامبر	سپتامبر
سپر	سپر
سپری	سپری
سپس	سپس
سپهدار	سپهدار
سپهر	سپهر
سپهری	سپهری
سپهسالار	سپهسالار
سک	سک
سکایی	سکایی
سکس	سکس
سکه	سکه
سکوت	سکوت
سکولار	سکولار
سکولاریسم	سکولاریسم
سکونت	سکونت
سگ	سگ
سی	سی
سیا	سیا
سیاتل	سیاتل
سیارات	سیارات
سیاره	سیاره
سیارک	سیارک
سیاست	سیاست
سیاستمدار	سیاستمدار
سیاستی	سیاستی
سیاسی	سیاسی
سیاسیون	سیاسیون
سیال	سیال
سیام	سیام
سیاه	سیاه
سیاهکل	سیاهکل
سیاوش	سیاوش
سیب	سیب
سیبری	سیبری
سید	سید
سیدنی	سیدنی
سیده	سیده
سیر	سیر
سیروس	سیروس
سیزده	سیزده
سیزدهم	سیزدهم
سیستان	سیستان
سیستم	سیستم
سیستماتیک	سیستماتیک
سیستمِ	سیستم
سیسنگان	سیِسنگان
سیسیل	سیسیل
سیصد	سیصد
سیف	سیف
سیفی	سیفی
سیلوا	سیلوا
سیلوستر	سیلوستر
سیم	سیم
سیما	سیما
سیمرغ	سیمرغ
سیموس	سیموس
سیمون	سیمون
سیمین	سیمین
سین	سین
سینا	سینا
سیناترا	سیناترا
سینما	سینما
سینمایی	سینمایی
سینه	سینه
سینگ	سینگ
سیّم	سیم
سیگار	سیگار
شاب	شاب
شاخ	شاخ
شاخص	شاخص
شاخه	شاخه
شادمهر	شادمهر
شادی	شادی
شارل	شارل
شارون	شارون
شازده	شازده
شاعر	شاعر
شاعران	شاعران
شاعری	شاعری
شافعی	شافعی
شال	شال
شام	شام
شامل	شامل
شاملو	شاملو
شامپانی	شامپانی
شامپاین	شامپاین
شانزده	شانزده
شانزدهم	شانزدهم
شانس	شانس
شانگهای	شانگهای
شاه	شاه
شاهد	شاهد
شاهرود	شاهرود
شاهزاده	شاهزاده
شاهنامه	شاهنامه
شاهِ	شاه
شاهکار	شاهکار
شاهی	شاهی
شاهین	شاهین
شاپور	شاپور
شاگرد	شاگرد
شایان	شایان
شاید	شاید
شایع	شایع
شایعات	شایعات
شایعه	شایعه
شب	شب
شباهت	شباهت
شبه	شبه
شبکه	شبکه
شبکهٔ	شبکه
شبیه	شبیه
شتاب	شتاب
شتر	شتر
شجاعت	شجاعت
شجاعی	شجاعی
شجریان	شجریان
شخص	شخص
شخصاً	شخصاً
شخصی	شخصی
شخصیت	شخصیت
شد	شد
شدت	شدت
شدن	شدن
شدند	شدند
شده	شده
شدید	شدید
شدیداً	شدیداً
شر	شر
شراب	شراب
شرایط	شرایط
شرایطی	شرایطی
شرح	شرح
شرط	شرط
شرطی	شرطی
شرع	شرع
شرعی	شرعی
شرف	شرف
شرق	شرق
شرقی	شرقی
شرلی	شرلی
شرمن	شرمن
شروان	شروان
شروع	شروع
شروین	شروین
شرکت	شرکت
شرکتِ	شرکت
شرکِت	شرکت
شریعت	شریعت
شریف	شریف
شریک	شریک
شش	شش
ششم	ششم
ششمین	ششمین
شصت	شصت
شطرنج	شطرنج
شعار	شعار
شعبان	شعبان
شعر	شعر
شعرا	شعرا
شعری	شعری
شغل	شغل
شفا	شفا
شفاهی	شفاهی
شفیع	شفیع
شفیلد	شفیلد
شل	شل
شلاق	شلاق
شلیک	شلیک
شما	شما
شمار	شمار
شماره	شماره
شمارهٔ	شماره
شمال	شمال
شمالی	شمالی
شمس	شمس
شمسی	شمسی
شمشیر	شمشیر
شمشیری	شمشیری
شمع	شمع
شمه	شمه
شمیرانات	شمیرانات
شن	شن
شناخت	شناخت
شناخته	شناخته
شناختی	شناختی
شناس	شناس
شناسا	شناسا
شناسایی	شناسایی
شناسه	شناسه
شناسی	شناسی
شنبه	شنبه
شنگ	شنگ
شه	شه
شهاب	شهاب
شهابی	شهابی
شهباز	شهباز
شهر	شهر
شهرآباد	شهرآباد
شهرآشوب	شهرآشوب
شهرام	شهرام
شهربانی	شهربانی
شهرت	شهرت
شهردار	شهردار
شهرداری	شهرداری
شهرسازی	شهرسازی
شهرستان	شهرستان
شهرستانی	شهرستانی
شهرضا	شهرضا
شهروند	شهروند
شهروندی	شهروندی
شهرِ	شهر
شهرک	شهرک
شهری	شهری
شهریار	شهریار
شهریور	شهریور
شهسوار	شهسوار
شهمیرزاد	شهمیرزاد
شهید	شهید
شو	شو
شوال	شوال
شوالیه	شوالیه
شواهد	شواهد
شوخی	شوخی
شود	شود
شور	شور
شورا	شورا
شوراب	شوراب
شورش	شورش
شورشی	شورشی
شوروی	شوروی
شورویِ	شوروی
شوماخر	شوماخر
شِما	شما
شِمه	شمه
شِه	شه
شک	شک
شکار	شکار
شکارچی	شکارچی
شکایت	شکایت
شکر	شکر
شکست	شکست
شکسته	شکسته
شکسپیر	شکسپیر
شکل	شکل
شکلی	شکلی
شکنجه	شکنجه
شکوفایی	شکوفایی
شکوفنده	شکوفنده
شی	شی
شیب	شیب
شیخ	شیخ
شیر	شیر
شیراز	شیراز
شیرازی	شیرازی
شیرودی	شیرودی
شیرویه	شیرویه
شیری	شیری
شیرین	شیرین
شیرینی	شیرینی
شیشه	شیشه
شیشک	شیشک
شیطون	شیطون
شیعه	شیعه
شیعی	شیعی
شیعیان	شیعیان
شیفته	شیفته
شیفتگی	شیفتگی
شیلات	شیلات
شیلی	شیلی
شیلیایی	شیلیایی
شیمی	شیمی
شیمیایی	شیمیایی
شین	شین
شیوه	شیوه
شیوهٔ	شیوه
شیکاگو	شیکاگو
صاحاب	صاحاب
صاحب	صاحب
صادر	صادر
صادرات	صادرات
صادق	صادق
صادقلو	صادقلو
صادقی	صادقی
صاف	صاف
صالح	صالح
صالحی	صالحی
صباح	صباح
صبح	صبح
صحبت	صحبت
صحرا	صحرا
صحنه	صحنه
صحیح	صحیح
صخره	صخره
صد	صد
صدا	صدا
صدام	صدام
صداوسیما	صداوسیما
صدر	صدر
صدراعظم	صدراعظم
صدراعظمی	صدراعظمی
صدساله	صدساله
صدمه	صدمه
صدمین	صدمین
صدها	صدها
صدور	صدور
صرب	صرب
صربستان	صربستان
صرف	صرف
صعود	صعود
صغیر	صغیر
صف	صف
صفاری	صفاری
صفایی	صفایی
صفحات	صفحات
صفحه	صفحه
صفر	صفر
صفوی	صفوی
صفویان	صفویان
صفویه	صفویه
صفی	صفی
صلاح	صلاح
صلح	صلح
صلوات	صلوات
صلیب	صلیب
صمصام	صمصام
صنایع	صنایع
صندلی	صندلی
صندوق	صندوق
صنعا	صنعا
صنعت	صنعت
صنعتی	صنعتی
صور	صور
صورت	صورت
صورتی	صورتی
صوفی	صوفی
صومعه	صومعه
صیادی	صیادی
صید	صید
ضامن	ضامن
ضبط	ضبط
ضحاک	ضحاک
ضد	ضد
ضرب	ضرب
ضربه	ضربه
ضرر	ضرر
ضرورت	ضرورت
ضروری	ضروری
ضعف	ضعف
ضعیف	ضعیف
ضمن	ضمن
ضمناً	ضمناً
ضمیر	ضمیر
ضمیمه	ضمیمه
ضیاء	ضیاء
ضیاءالحق	ضیاءالحق
طارق	طارق
طالب	طالب
طالبان	طالبان
طالبی	طالبی
طالقانی	طالقانی
طاهر	طاهر
طاهری	طاهری
طایفه	طایفه
طب	طب
طبابت	طبابت
طباطبایی	طباطبایی
طبرستان	طبرستان
طبرسی	طبرسی
طبری	طبری
طبع	طبع
طبق	طبق
طبقه	طبقه
طبقهٔ	طبقه
طبیب	طبیب
طبیعت	طبیعت
طبیعی	طبیعی
طرابلس	طرابلس
طراح	طراح
طراحی	طراحی
طرح	طرح
طرز	طرز
طرف	طرف
طرفدار	طرفدار
طرفداران	طرفداران
طرفداری	طرفداری
طرفین	طرفین
طریق	طریق
طعم	طعم
طعمه	طعمه
طغرل	طغرل
طلا	طلا
طلاق	طلاق
طلایی	طلایی
طلب	طلب
طلعت	طلعت
طنز	طنز
طنزپرداز	طنزپرداز
طوایف	طوایف
طور	طور
طوری	طوری
طوس	طوس
طوسی	طوسی
طوفان	طوفان
طول	طول
طولانی	طولانی
طی	طی
طیب	طیب
طیبی	طیبی
ظاهر	ظاهر
ظاهرا	ظاهرا
ظاهراً	ظاهراً
ظاهری	ظاهری
ظرف	ظرف
ظرفیت	ظرفیت
ظریف	ظریف
ظلم	ظلم
ظهر	ظهر
ظهور	ظهور
ظهیرالدین	ظهیرالدین
عاج	عاج
عادت	عادت
عادل	عادل
عادلی	عادلی
عادی	عادی
عارف	عارف
عازم	عازم
عاشق	عاشق
عاشقانه	عاشقانه
عاشقی	عاشقی
عاطفی	عاطفی
عاقبت	عاقبت
عالم	عالم
عالی	عالی
عالیه	عالیه
عام	عام
عامل	عامل
عامه	عامه
عبادت	عبادت
عبارت	عبارت
عباس	عباس
عباسی	عباسی
عباسیان	عباسیان
عبد	عبد
عبدالباقی	عبدالباقی
عبدالجبار	عبدالجبار
عبدالحسین	عبدالحسین
عبدالحمید	عبدالحمید
عبدالرحمان	عبدالرحمان
عبدالرحمن	عبدالرحمن
عبدالرحیم	عبدالرحیم
عبدالعزیز	عبدالعزیز
عبدالعظیم	عبدالعظیم
عبدالعلی	عبدالعلی
عبدالفتاح	عبدالفتاح
عبدالله	عبدالله
عبدالمالک	عبدالمالک
عبدالمجید	عبدالمجید
عبدالملک	عبدالملک
عبدالملکی	عبدالملکی
عبدالناصر	عبدالناصر
عبدالکریم	عبدالکریم
عبدی	عبدی
عبری	عبری
عبور	عبور
عتیق	عتیق
عثمان	عثمان
عثمانی	عثمانی
عثمانیان	عثمانیان
عجیب	عجیب
عدالت	عدالت
عدد	عدد
عدسی	عدسی
عدل	عدل
عدلیه	عدلیه
عدم	عدم
عدن	عدن
عده	عده
عراق	عراق
عراقی	عراقی
عرب	عرب
عربستان	عربستان
عربی	عربی
عرصه	عرصه
عرض	عرض
عرضه	عرضه
عرفان	عرفان
عرفانی	عرفانی
عرق	عرق
عروس	عروس
عروسی	عروسی
عزا	عزا
عزاداری	عزاداری
عزالدین	عزالدین
عزت	عزت
عزل	عزل
عزیز	عزیز
عسل	عسل
عسلی	عسلی
عسکری	عسکری
عسگری	عسگری
عشایر	عشایر
عشق	عشق
عشقی	عشقی
عصب	عصب
عصبی	عصبی
عصر	عصر
عضدالدوله	عضدالدوله
عضو	عضو
عضویت	عضویت
عظمت	عظمت
عظیم	عظیم
عفونت	عفونت
عقاب	عقاب
عقاید	عقاید
عقب	عقب
عقبه	عقبه
عقدهٔ	عقده
عقرب	عقرب
عقل	عقل
عقلی	عقلی
عقیده	عقیده
عقیقی	عقیقی
عقیلی	عقیلی
علاقه	علاقه
علامت	علامت
علامه	علامه
علاوه	علاوه
علایق	علایق
علایم	علایم
علت	علت
علف	علف
علم	علم
علما	علما
علمی	علمی
علناً	علناً
علوم	علوم
علوی	علوی
علی	علی
علیا	علیا
علیرضا	علیرضا
علیزاده	علیزاده
علیقلی	علیقلی
علیه	علیه
عمادالدوله	عمادالدوله
عمادالدین	عمادالدین
عمادی	عمادی
عمارت	عمارت
عمان	عمان
عمدتا	عمدتا
عمدتاً	عمدتاً
عمده	عمده
عمدهٔ	عمده
عمر	عمر
عمران	عمران
عمرو	عمرو
عمق	عمق
عمل	عمل
عملا	عملا
عملاً	عملاً
عملکرد	عملکرد
عملی	عملی
عملیات	عملیات
عملیاتی	عملیاتی
عمو	عمو
عمودی	عمودی
عموم	عموم
عموماً	عموماً
عمومی	عمومی
عمیق	عمیق
عناصر	عناصر
عناوین	عناوین
عنایت	عنایت
عنصر	عنصر
عنصری	عنصری
عنوان	عنوان
عنکبوت	عنکبوت
عهد	عهد
عهدنامه	عهدنامه
عهده	عهده
عوارض	عوارض
عوام	عوام
عوامل	عوامل
عود	عود
عوض	عوض
عَوِض	عوض
عُمر	عمر
عکاس	عکاس
عکاسی	عکاسی
عکس	عکس
عید	عید
عیدی	عیدی
عیسی	عیسی
عیلام	عیلام
عین	عین
عینی	عینی
غار	غار
غارت	غارت
غازی	غازی
غافل	غافل
غالب	غالب
غالباً	غالباً
غبار	غبار
غذا	غذا
غذایی	غذایی
غرامت	غرامت
غرب	غرب
غربی	غربی
غرق	غرق
غرور	غرور
غریب	غریب
غزل	غزل
غزلیات	غزلیات
غزنوی	غزنوی
غزه	غزه
غسان	غسان
غسل	غسل
غلات	غلات
غلامحسین	غلامحسین
غلامرضا	غلامرضا
غلامعلی	غلامعلی
غلبه	غلبه
غلط	غلط
غنا	غنا
غنی	غنی
غول	غول
غیبت	غیبت
غیر	غیر
غیررسمی	غیررسمی
غیرطبیعی	غیرطبیعی
غیرقابل	غیرقابل
غیرقانونی	غیرقانونی
غیرمجاز	غیرمجاز
غیرمستقیم	غیرمستقیم
غیرنظامی	غیرنظامی
غیره	غیره
فاتح	فاتح
فاتحه	فاتحه
فارس	فارس
فارسی	فارسی
فارغ	فارغ
فارک	فارک
فاز	فاز
فاشیست	فاشیست
فاشیستی	فاشیستی
فاشیسم	فاشیسم
فاصله	فاصله
فاضلی	فاضلی
فاطمه	فاطمه
فاعل	فاعل
فالکلند	فالکلند
فامیل	فامیل
فامیلی	فامیلی
فان	فان
فتح	فتح
فتحعلی	فتحعلی
فتوا	فتوا
فتوحات	فتوحات
فجر	فجر
فخر	فخر
فخرالدوله	فخرالدوله
فخرالدین	فخرالدین
فدایی	فدایی
فدراسیون	فدراسیون
فدرال	فدرال
فدرالی	فدرالی
فدرالیسم	فدرالیسم
فر	فر
فرآیند	فرآیند
فرات	فرات
فرار	فرار
فراری	فراری
فراز	فراز
فراشبند	فراشبند
فرافکنی	فرافکنی
فراماسونری	فراماسونری
فرامرز	فرامرز
فراموش	فراموش
فرانتس	فرانتس
فرانس	فرانس
فرانسه	فرانسه
فرانسهِ	فرانسه
فرانسوا	فرانسوا
فرانسوی	فرانسوی
فرانسیس	فرانسیس
فرانسیسکو	فرانسیسکو
فرانچسکو	فرانچسکو
فرانک	فرانک
فرانکفورت	فرانکفورت
فرانکلین	فرانکلین
فرانکو	فرانکو
فراهانی	فراهانی
فراهم	فراهم
فراوان	فراوان
فراوانی	فراوانی
فراگیر	فراگیر
فراگیری	فراگیری
فرح	فرح
فرخ	فرخ
فرخی	فرخی
فرد	فرد
فردریک	فردریک
فردوس	فردوس
فردوسی	فردوسی
فردی	فردی
فردیناند	فردیناند
فرزاد	فرزاد
فرزانه	فرزانه
فرزند	فرزند
فرزندان	فرزندان
فرستاده	فرستاده
فرسودگی	فرسودگی
فرصت	فرصت
فرض	فرض
فرضیه	فرضیه
فرعون	فرعون
فرعی	فرعی
فرق	فرق
فرقه	فرقه
فرم	فرم
فرمان	فرمان
فرماندار	فرماندار
فرمانده	فرمانده
فرماندهی	فرماندهی
فرمانروا	فرمانروا
فرمانروایی	فرمانروایی
فرمول	فرمول
فرناندز	فرناندز
فرناندو	فرناندو
فرنگ	فرنگ
فرهاد	فرهاد
فرهادی	فرهادی
فرهنگ	فرهنگ
فرهنگی	فرهنگی
فرهود	فرهود
فرو	فرو
فرود	فرود
فرودگاه	فرودگاه
فروردین	فروردین
فروزش	فروزش
فروش	فروش
فروشنده	فروشنده
فروغ	فروغ
فروپاشی	فروپاشی
فروید	فروید
فریبرز	فریبرز
فریدریک	فریدریک
فریدون	فریدون
فریرا	فریرا
فریم	فریم
فساد	فساد
فستیوال	فستیوال
فسفر	فسفر
فشار	فشار
فشرده	فشرده
فصل	فصل
فضا	فضا
فضایی	فضایی
فضل	فضل
فطر	فطر
فعال	فعال
فعالیت	فعالیت
فعل	فعل
فعلاً	فعلاً
فعلی	فعلی
فقر	فقر
فقط	فقط
فقه	فقه
فقیر	فقیر
فقیری	فقیری
فقیه	فقیه
فلات	فلات
فلاح	فلاح
فلاسفه	فلاسفه
فلانی	فلانی
فلاورجان	فلاورجان
فلاکت	فلاکت
فلج	فلج
فلز	فلز
فلزات	فلزات
فلسطین	فلسطین
فلسفه	فلسفه
فلسفی	فلسفی
فلورانس	فلورانس
فلوریدا	فلوریدا
فلک	فلک
فلکی	فلکی
فلیکس	فلیکس
فمینیست	فمینیست
فمینیستی	فمینیستی
فمینیسم	فمینیسم
فن	فن
فناوری	فناوری
فنلاند	فنلاند
فنلاندی	فنلاندی
فنیقی	فنیقی
فهرست	فهرست
فهم	فهم
فهیمه	فهیمه
فو	فو
فواصل	فواصل
فواید	فواید
فوت	فوت
فوتبال	فوتبال
فوتسال	فوتسال
فوج	فوج
فورد	فورد
فوری	فوری
فوریه	فوریه
فوق	فوق
فولاد	فولاد
فولکلور	فولکلور
فومن	فومن
فِرار	فرار
فک	فک
فکر	فکر
فکری	فکری
فی	فی
فیبر	فیبر
فیجی	فیجی
فیدل	فیدل
فیروز	فیروز
فیروزآباد	فیروزآباد
فیروزه	فیروزه
فیروزکوه	فیروزکوه
فیروزی	فیروزی
فیزیولوژی	فیزیولوژی
فیزیولوژیک	فیزیولوژیک
فیزیک	فیزیک
فیزیکی	فیزیکی
فیس	فیس
فیصل	فیصل
فیضیه	فیضیه
فیفا	فیفا
فیل	فیل
فیلادلفیا	فیلادلفیا
فیلسوف	فیلسوف
فیلم	فیلم
فیلمِ	فیلم
فیلیپ	فیلیپ
فیلیپین	فیلیپین
فیلیپینی	فیلیپینی
فینال	فینال
فینیکس	فینیکس
قائل	قائل
قائم	قائم
قابل	قابل
قابلیت	قابلیت
قابوس	قابوس
قاتل	قاتل
قاجار	قاجار
قاجاریه	قاجاریه
قادر	قادر
قادسیه	قادسیه
قاره	قاره
قاسم	قاسم
قاسمی	قاسمی
قاصد	قاصد
قاضی	قاضی
قاطی	قاطی
قاعده	قاعده
قافیه	قافیه
قالب	قالب
قانون	قانون
قانونی	قانونی
قاهره	قاهره
قاچاق	قاچاق
قایق	قایق
قباد	قباد
قبایل	قبایل
قبر	قبر
قبرس	قبرس
قبضه	قبضه
قبل	قبل
قبلا	قبلا
قبلاً	قبلاً
قبلی	قبلی
قبول	قبول
قبولی	قبولی
قبیل	قبیل
قبیله	قبیله
قتل	قتل
قحطی	قحطی
قد	قد
قدر	قدر
قدرت	قدرت
قدرتمند	قدرتمند
قدرتی	قدرتی
قدری	قدری
قدس	قدس
قدمت	قدمت
قدیس	قدیس
قدیم	قدیم
قدیمی	قدیمی
قذافی	قذافی
قرآن	قرآن
قرار	قرار
قرارداد	قرارداد
قراردادی	قراردادی
قرارگاه	قرارگاه
قراری	قراری
قران	قران
قربانی	قربانی
قرص	قرص
قرق	قرق
قرمز	قرمز
قرن	قرن
قره	قره
قرون	قرون
قروه	قروه
قریب	قریب
قریش	قریش
قزاق	قزاق
قزاقی	قزاقی
قزلباش	قزلباش
قزوین	قزوین
قزوینی	قزوینی
قسطنطنیه	قسطنطنیه
قسم	قسم
قسمت	قسمت
قشقایی	قشقایی
قشلاق	قشلاق
قشنگ	قشنگ
قشنگی	قشنگی
قشون	قشون
قصاب	قصاب
قصد	قصد
قصر	قصر
قصه	قصه
قصیده	قصیده
قضایی	قضایی
قضیه	قضیه
قطار	قطار
قطب	قطب
قطر	قطر
قطع	قطع
قطعات	قطعات
قطعنامه	قطعنامه
قطعه	قطعه
قطعیت	قطعیت
قفقاز	قفقاز
قفقازی	قفقازی
قلب	قلب
قلعه	قلعه
قلم	قلم
قلمرو	قلمرو
قله	قله
قلی	قلی
قلیایی	قلیایی
قم	قم
قمر	قمر
قمری	قمری
قناری	قناری
قنبری	قنبری
قند	قند
قندهار	قندهار
قهرمان	قهرمان
قهرمانان	قهرمانان
قهرمانی	قهرمانی
قهوه	قهوه
قو	قو
قوا	قوا
قواعد	قواعد
قوام	قوام
قوانین	قوانین
قوس	قوس
قول	قول
قولی	قولی
قوم	قوم
قومس	قومس
قومیت	قومیت
قوه	قوه
قوچان	قوچان
قوی	قوی
قِرار	قرار
قِسمت	قسمت
قِسمِت	قسمت
قیافه	قیافه
قیام	قیام
قیامت	قیامت
قید	قید
قیر	قیر
قیصر	قیصر
قیمت	قیمت
قیومیت	قیومیت
لا	لا
لاتزیو	لاتزیو
لاتین	لاتین
لاتینی	لاتینی
لادن	لادن
لاذقیه	لاذقیه
لار	لار
لارن	لارن
لارنس	لارنس
لاریجان	لاریجان
لازاروس	لازاروس
لازم	لازم
لاش	لاش
لاشه	لاشه
لال	لال
لاله	لاله
لالیگا	لالیگا
لاما	لاما
لامرد	لامرد
لامپ	لامپ
لاهه	لاهه
لاهور	لاهور
لاهیجان	لاهیجان
لاک	لاک
لاگوس	لاگوس
لایه	لایه
لباس	لباس
لبنان	لبنان
لبنانی	لبنانی
لتونی	لتونی
لحاظ	لحاظ
لحظه	لحظه
لخت	لخت
لذا	لذا
لذت	لذت
لر	لر
لرد	لرد
لسانی	لسانی
لستر	لستر
لشکر	لشکر
لشکرکشی	لشکرکشی
لشکری	لشکری
لشگر	لشگر
لطف	لطف
لطفی	لطفی
لغو	لغو
لفظ	لفظ
لقب	لقب
لله	لله
لم	لم
لنجان	لنجان
لندن	لندن
لنون	لنون
لنکران	لنکران
لنگ	لنگ
لنگر	لنگر
لنگرود	لنگرود
لنگه	لنگه
لنین	لنین
لنینگراد	لنینگراد
له	له
لهجه	لهجه
لهستان	لهستان
لهستانی	لهستانی
لوئیز	لوئیز
لوئیس	لوئیس
لوازم	لوازم
لوبیا	لوبیا
لوتر	لوتر
لوتوس	لوتوس
لوح	لوح
لودویک	لودویک
لودویگ	لودویگ
لور	لور
لورن	لورن
لوری	لوری
لوس	لوس
لوسی	لوسی
لوقا	لوقا
لولا	لولا
لوله	لوله
لومومبا	لومومبا
لوپز	لوپز
لوچ	لوچ
لوک	لوک
لوکزامبورگ	لوکزامبورگ
لوگوس	لوگوس
لوی	لوی
لویس	لویس
لویی	لویی
لک	لک
لی	لی
لیبرال	لیبرال
لیبرالیسم	لیبرالیسم
لیبریا	لیبریا
لیبی	لیبی
لیتوانی	لیتوانی
لیث	لیث
لیدی	لیدی
لیره	لیره
لیز	لیز
لیسانس	لیسانس
لیسبون	لیسبون
لیست	لیست
لیل	لیل
لیلا	لیلا
لیله	لیله
لیلی	لیلی
لیندون	لیندون
لینک	لینک
لینکلن	لینکلن
لینگ	لنگ
لیورپول	لیورپول
لیون	لیون
لیک	لیک
لیگ	لیگ
مأمور	مأمور
مأموریت	مأموریت
مؤسسه	مؤسسه
ما	ما
ماتیاس	ماتیاس
ماتیو	ماتیو
ماجرا	ماجرا
ماد	ماد
مادام	مادام
ماداگاسکار	ماداگاسکار
مادر	مادر
مادرید	مادرید
مادلین	مادلین
ماده	ماده
مادی	مادی
مار	مار
مارادونا	مارادونا
مارتین	مارتین
مارس	مارس
مارسل	مارسل
مارسی	مارسی
مارشال	مارشال
مارپیچی	مارپیچی
مارچ	مارچ
مارک	مارک
مارکس	مارکس
مارکسیست	مارکسیست
مارکسیستی	مارکسیستی
مارکسیسم	مارکسیسم
مارکو	مارکو
مارکوس	مارکوس
مارگارت	مارگارت
مارگریت	مارگریت
ماری	ماری
ماریا	ماریا
مارینا	مارینا
ماریو	ماریو
مازندران	مازندران
مازندرانی	مازندرانی
مازیار	مازیار
ماسال	ماسال
ماساچوست	ماساچوست
ماست	ماست
ماسون	ماسون
ماسک	ماسک
ماشین	ماشین
ماقبل	ماقبل
مال	مال
مالاوی	مالاوی
مالایا	مالایا
مالایی	مالایی
مالت	مالت
مالدیو	مالدیو
مالزی	مالزی
مالک	مالک
مالکی	مالکی
مالکیت	مالکیت
مالی	مالی
مالیات	مالیات
مالیه	مالیه
مامور	مامور
ماموریت	ماموریت
مامون	مامون
ماند	ماند
ماندلا	ماندلا
مانده	مانده
مانع	مانع
مانند	مانند
مانکن	مانکن
مانی	مانی
مانیفست	مانیفست
ماه	ماه
ماهه	ماهه
ماهور	ماهور
ماهی	ماهی
ماهیت	ماهیت
ماهیچه	ماهیچه
ماهیگیری	ماهیگیری
ماوراء	ماوراء
ماکان	ماکان
ماکسیم	ماکسیم
مایع	مایع
مایل	مایل
مایلی	مایلی
مایه	مایه
مایک	مایک
مایکروسافت	مایکروسافت
مایکل	مایکل
مبارزات	مبارزات
مبارزه	مبارزه
مبارک	مبارک
مبارکه	مبارکه
مبتلا	مبتلا
مبتنی	مبتنی
مبدأ	مبدأ
متأثر	متأثر
متال	متال
متحد	متحد
متحده	متحده
متحدِ	متحد
متحول	متحول
متخصص	متخصص
متخلص	متخلص
متداول	متداول
متر	متر
متراکم	متراکم
مترجم	مترجم
مترمربع	مترمربع
متروپولیتن	متروپولیتن
متشکل	متشکل
متصل	متصل
متعدد	متعدد
متعلق	متعلق
متعهد	متعهد
متغیر	متغیر
متفاوت	متفاوت
متفقین	متفقین
متفکر	متفکر
متل	متل
متمایز	متمایز
متمدن	متمدن
متمرکز	متمرکز
متن	متن
متنوع	متنوع
متهم	متهم
متوالی	متوالی
متوجه	متوجه
متوسط	متوسط
متوقف	متوقف
متولد	متولد
متولی	متولی
متون	متون
متی	متی
متین	متین
مثال	مثال
مثبت	مثبت
مثل	مثل
مثلا	مثلا
مثلاً	مثلاً
مثلث	مثلث
مثنوی	مثنوی
مجارستان	مجارستان
مجارستانی	مجارستانی
مجاری	مجاری
مجاز	مجاز
مجازات	مجازات
مجالس	مجالس
مجاور	مجاور
مجبور	مجبور
مجتبی	مجتبی
مجتمع	مجتمع
مجتهد	مجتهد
مجدد	مجدد
مجددا	مجددا
مجدداً	مجدداً
مجروح	مجروح
مجری	مجری
مجریه	مجریه
مجلات	مجلات
مجلس	مجلس
مجلسی	مجلسی
مجله	مجله
مجلهٔ	مجله
مجمع	مجمع
مجموع	مجموع
مجموعاً	مجموعاً
مجموعه	مجموعه
مجموعهٔ	مجموعه
مجنون	مجنون
مجوز	مجوز
مجید	مجید
مجیدآباد	مجیدآباد
مجیدی	مجیدی
محاصره	محاصره
محافظ	محافظ
محافظت	محافظت
محافظه	محافظه
محاکمه	محاکمه
محبت	محبت
محبوب	محبوب
محبوبیت	محبوبیت
محترم	محترم
محدود	محدود
محدوده	محدوده
محدودیت	محدودیت
محرم	محرم
محروم	محروم
محسن	محسن
محسوب	محسوب
محصول	محصول
محصولات	محصولات
محض	محض
محقق	محقق
محققین	محققین
محل	محل
محلات	محلات
محله	محله
محلی	محلی
محمد	محمد
محمدخان	محمدخان
محمدرضا	محمدرضا
محمدصالح	محمدصالح
محمدی	محمدی
محمدیه	محمدیه
محمود	محمود
محمودآباد	محمودآباد
محور	محور
محوطه	محوطه
محکمه	محکمه
محکوم	محکوم
محیط	محیط
محیطی	محیطی
مخابرات	مخابرات
مخابراتی	مخابراتی
مخارج	مخارج
مخاطب	مخاطب
مخالف	مخالف
مخالفان	مخالفان
مخالفت	مخالفت
مخالفین	مخالفین
مختار	مختار
مخترع	مخترع
مختصات	مختصات
مختصر	مختصر
مختصراً	مختصرا
مختلف	مختلف
مختلفِ	مختلف
مخدر	مخدر
مخصوص	مخصوص
مخصوصا	مخصوصا
مخصوصاً	مخصوصاً
مخفف	مخفف
مخفی	مخفی
مخلوط	مخلوط
مخملی	مخملی
مد	مد
مدار	مدار
مدارس	مدارس
مدارک	مدارک
مدافع	مدافع
مدال	مدال
مدام	مدام
مداوم	مداوم
مدت	مدت
مدرس	مدرس
مدرسه	مدرسه
مدرسهٔ	مدرسه
مدرن	مدرن
مدرک	مدرک
مدعی	مدعی
مدل	مدل
مدنی	مدنی
مدیترانه	مدیترانه
مدیتیشن	مدیتیشن
مدیر	مدیر
مدیرعامل	مدیرعامل
مدیره	مدیره
مدیرکل	مدیرکل
مدیریت	مدیریت
مدیسون	مدیسون
مدینه	مدینه
مدیون	مدیون
مذاهب	مذاهب
مذاکرات	مذاکرات
مذاکره	مذاکره
مذهب	مذهب
مذهبی	مذهبی
مذکور	مذکور
مرا	مرا
مراتب	مراتب
مراحل	مراحل
مراد	مراد
مرادی	مرادی
مراسم	مراسم
مراقبت	مراقبت
مراکز	مراکز
مراکش	مراکش
مربع	مربع
مربوط	مربوط
مربی	مربی
مربیگری	مربیگری
مرتب	مرتب
مرتبط	مرتبط
مرتبه	مرتبه
مرتد	مرتد
مرتضوی	مرتضوی
مرتضی	مرتضی
مرجانه	مرجانه
مرجع	مرجع
مرحله	مرحله
مرحوم	مرحوم
مرد	مرد
مرداب	مرداب
مرداد	مرداد
مردان	مردان
مرداویج	مرداویج
مردسالارِ	مردسالار
مردم	مردم
مردمِ	مردم
مردمی	مردمی
مردن	مردن
مرده	مرده
مردود	مردود
مردِم	مردم
مردی	مردی
مرز	مرز
مرزبان	مرزبان
مرسدس	مرسدس
مرسوم	مرسوم
مرضیه	مرضیه
مرطوب	مرطوب
مرعشی	مرعشی
مرغانه	مرغانه
مرمت	مرمت
مرمر	مرمر
مرمره	مرمره
مره	مره
مرو	مرو
مروارید	مروارید
مرودشت	مرودشت
مرور	مرور
مرکب	مرکب
مرکبات	مرکبات
مرکز	مرکز
مرکزی	مرکزی
مرکزیت	مرکزیت
مرکل	مرکل
مرگ	مرگ
مری	مری
مریخ	مریخ
مریض	مریض
مریضی	مریضی
مریلند	مریلند
مریم	مریم
مریوان	مریوان
مزارع	مزارع
مزدکی	مزدکی
مزرعه	مزرعه
مزمن	مزمن
مزه	مزه
مزین	مزین
مس	مس
مسئله	مسئله
مسئلهٔ	مسئله
مسئول	مسئول
مسئولیت	مسئولیت
مسئولین	مسئولین
مسائل	مسائل
مسابقات	مسابقات
مسابقه	مسابقه
مسابقهٔ	مسابقه
مساحت	مساحت
مسافر	مسافر
مسافرت	مسافرت
مساوی	مساوی
مست	مست
مستبد	مستبد
مستر	مستر
مستعار	مستعار
مستعمرات	مستعمرات
مستعمره	مستعمره
مستقر	مستقر
مستقل	مستقل
مستقیم	مستقیم
مستقیماً	مستقیماً
مستمر	مستمر
مستند	مستند
مستوفی	مستوفی
مسجد	مسجد
مسخره	مسخره
مسعود	مسعود
مسعودی	مسعودی
مسقط	مسقط
مسلح	مسلح
مسلحانه	مسلحانه
مسلط	مسلط
مسلم	مسلم
مسلمان	مسلمان
مسلمانان	مسلمانان
مسلمون	مسلمون
مسلمین	مسلمین
مسموم	مسموم
مسکن	مسکن
مسکو	مسکو
مسکونی	مسکونی
مسیح	مسیح
مسیحا	مسیحا
مسیحی	مسیحی
مسیحیان	مسیحیان
مسیحیت	مسیحیت
مسیر	مسیر
مشابه	مشابه
مشارکت	مشارکت
مشاغل	مشاغل
مشاهدات	مشاهدات
مشاهده	مشاهده
مشاهیر	مشاهیر
مشاور	مشاور
مشاوره	مشاوره
مشایی	مشایی
مشت	مشت
مشترک	مشترک
مشترکاً	مشترکاً
مشتری	مشتری
مشخص	مشخص
مشخصات	مشخصات
مشخصه	مشخصه
مشرق	مشرق
مشروطه	مشروطه
مشروطیت	مشروطیت
مشروعه	مشروعه
مشروعیت	مشروعیت
مشغول	مشغول
مشهد	مشهد
مشهدی	مشهدی
مشهور	مشهور
مشورت	مشورت
مشکان	مشکان
مشکل	مشکل
مشکلات	مشکلات
مشکوک	مشکوک
مشکین	مشکین
مصاحبه	مصاحبه
مصادره	مصادره
مصالح	مصالح
مصدق	مصدق
مصدوم	مصدوم
مصر	مصر
مصرف	مصرف
مصری	مصری
مصطفی	مصطفی
مصلوب	مصلوب
مصنوعی	مصنوعی
مضامین	مضامین
مضمون	مضمون
مطابق	مطابق
مطالب	مطالب
مطالعات	مطالعات
مطالعه	مطالعه
مطبوعات	مطبوعات
مطرح	مطرح
مطلب	مطلب
مطلق	مطلق
مطلقه	مطلقه
مطمئن	مطمئن
مطهری	مطهری
مظاهر	مظاهر
مظفر	مظفر
مظهر	مظهر
معابر	معابر
معاد	معاد
معادل	معادل
معادن	معادن
معارف	معارف
معاصر	معاصر
معانی	معانی
معاهده	معاهده
معاهدهٔ	معاهده
معاون	معاون
معاونت	معاونت
معاویه	معاویه
معبد	معبد
معتاد	معتاد
معتبر	معتبر
معتدل	معتدل
معترض	معترض
معتقد	معتقد
معجزه	معجزه
معدن	معدن
معدنی	معدنی
معده	معده
معدود	معدود
معرض	معرض
معرفت	معرفت
معرفی	معرفی
معروف	معروف
معروفِ	معروف
معروفی	معروفی
معروفیت	معروفیت
معشوقه	معشوقه
معصوم	معصوم
معلم	معلم
معلمی	معلمی
معلوم	معلوم
معمار	معمار
معماری	معماری
معمر	معمر
معمول	معمول
معمولا	معمولا
معمولاً	معمولاً
معمولی	معمولی
معنا	معنا
معنایی	معنایی
معنوی	معنوی
معنی	معنی
معکوس	معکوس
معیار	معیار
معین	معین
معینی	معینی
مغرب	مغرب
مغز	مغز
مغزی	مغزی
مغول	مغول
مفتی	مفتی
مفهوم	مفهوم
مفید	مفید
مقابل	مقابل
مقابله	مقابله
مقالات	مقالات
مقاله	مقاله
مقام	مقام
مقامات	مقامات
مقامی	مقامی
مقاومت	مقاومت
مقایسه	مقایسه
مقداد	مقداد
مقدار	مقدار
مقداری	مقداری
مقدس	مقدس
مقدسی	مقدسی
مقدم	مقدم
مقدمات	مقدمات
مقدمه	مقدمه
مقدونی	مقدونی
مقدونیه	مقدونیه
مقر	مقر
مقصد	مقصد
مقطع	مقطع
مقعد	مقعد
مقننه	مقننه
مقیاس	مقیاس
ملا	ملا
ملاصدرا	ملاصدرا
ملاقات	ملاقات
ملایم	ملایم
ملبورن	ملبورن
ملت	ملت
ملحق	ملحق
ملقب	ملقب
ملل	ملل
مللِ	ملل
ملویل	ملویل
ملّا	ملا
ملّی	ملّی
ملک	ملک
ملکه	ملکه
ملی	ملی
ملیت	ملیت
ممالک	ممالک
ممانعت	ممانعت
ممتاز	ممتاز
ممتنع	ممتنع
ممفیس	ممفیس
مملکت	مملکت
مملکتِ	مملکت
ممنوع	ممنوع
ممنوعه	ممنوعه
ممنوعیت	ممنوعیت
ممکن	ممکن
من	من
منابع	منابع
منار	منار
مناسب	مناسب
مناسبت	مناسبت
مناطق	مناطق
مناظر	مناظر
مناظره	مناظره
منافع	منافع
مناقشه	مناقشه
منبع	منبع
منت	منت
منتخب	منتخب
منتشر	منتشر
منتظر	منتظر
منتظری	منتظری
منتقد	منتقد
منتقدان	منتقدان
منتقدین	منتقدین
منتقل	منتقل
منتهی	منتهی
منجر	منجر
منجمله	منجمله
منحصر	منحصر
منحل	منحل
منزل	منزل
منزوی	منزوی
منسوب	منسوب
منشأ	منشأ
منشور	منشور
منشی	منشی
منصف	منصف
منصوب	منصوب
منصور	منصور
منطق	منطق
منطقه	منطقه
منطقهٔ	منطقه
منطقی	منطقی
منظره	منظره
منظم	منظم
منظور	منظور
منظومه	منظومه
منع	منع
منعقد	منعقد
منفجر	منفجر
منفی	منفی
منقرض	منقرض
منوچهر	منوچهر
منچستر	منچستر
منگنز	منگنز
منی	منی
مه	مه
مهاباد	مهاباد
مهاجر	مهاجر
مهاجرت	مهاجرت
مهاجرین	مهاجرین
مهاجم	مهاجم
مهارت	مهارت
مهجوری	مهجوری
مهدی	مهدی
مهر	مهر
مهراد	مهراد
مهران	مهران
مهرداد	مهرداد
مهرماه	مهرماه
مهره	مهره
مهرپرستی	مهرپرستی
مهشید	مهشید
مهم	مهم
مهمانخانه	مهمانخانه
مهماندوست	مهماندوست
مهندس	مهندس
مهندسی	مهندسی
مهٔ	مه
مهین	مهین
مو	مو
مواجه	مواجه
مواد	مواد
موارد	موارد
مواضع	مواضع
موافق	موافق
موافقت	موافقت
موبایل	موبایل
موبد	موبد
موتزارت	موتزارت
موتور	موتور
موثر	موثر
موج	موج
موجب	موجب
موجود	موجود
موجودات	موجودات
موجوداتِ	موجودات
مودت	مودت
مودتی	مودتی
مودّتی	مودتی
مور	مور
مورالس	مورالس
مورخ	مورخ
مورخین	مورخین
مورد	مورد
موروثی	موروثی
موریتانی	موریتانی
موریس	موریس
موزامبیک	موزامبیک
موزه	موزه
موزیسین	موزیسین
موزیک	موزیک
موس	موس
موسس	موسس
موسسات	موسسات
موسسه	موسسه
موسو	موسو
موسولینی	موسولینی
موسوم	موسوم
موسوی	موسوی
موسی	موسی
موسیقی	موسیقی
موسیقیایی	موسیقیایی
موسیقیِ	موسیقی
موشک	موشک
موصل	موصل
موضع	موضع
موضوع	موضوع
موضوعات	موضوعات
موعود	موعود
موفق	موفق
موفقیت	موفقیت
موقت	موقت
موقتی	موقتی
موقع	موقع
موقعیت	موقعیت
مول	مول
مولا	مولا
مولانا	مولانا
مولداوی	مولداوی
مولن	مولن
مولود	مولود
مونا	مونا
موناکو	موناکو
مونتانا	مونتانا
مونه	مونه
مونیخ	مونیخ
موید	موید
مَتّی	متی
مَردی	مردی
مَقِر	مقر
مَیِّن	مین
مَیّن	مین
مُد	مد
مُدرن	مدرن
مُدل	مدل
مِلّا	ملا
مِن	من
مک	مک
مکاتب	مکاتب
مکاتبات	مکاتبات
مکان	مکان
مکانی	مکانی
مکانیسم	مکانیسم
مکانیک	مکانیک
مکانیکی	مکانیکی
مکتب	مکتب
مکرر	مکرر
مکرمه	مکرمه
مکزیک	مکزیک
مکزیکو	مکزیکو
مکزیکوسیتی	مکزیکوسیتی
مکزیکی	مکزیکی
مکنزی	مکنزی
مکه	مکه
مکی	مکی
مگر	مگر
می	می
میادین	میادین
میامی	میامی
میان	میان
میاندورود	میاندورود
میانرود	میانرود
میانمار	میانمار
میانه	میانه
میترا	میترا
میترائیسم	میترائیسم
میتران	میتران
میثم	میثم
میدان	میدان
میدل	میدل
میراث	میراث
میرزا	میرزا
میرزاخانی	میرزاخانی
میز	میز
میزان	میزان
میزبان	میزبان
میزبانی	میزبانی
میس	میس
میشل	میشل
میشکا	میشکا
میشیگان	میشیگان
میل	میل
میلاد	میلاد
میلادی	میلادی
میلان	میلان
میله	میله
میلیارد	میلیارد
میلیمتر	میلیمتر
میلیون	میلیون
میم	میم
میمند	میمند
میمون	میمون
مین	مین
مینا	مینا
مینسک	مینسک
مینوی	مینوی
میهنی	میهنی
میوه	میوه
میّن	مین
میکا	میکا
میکل	میکل
میگل	میگل
نا	نا
نابرابری	نابرابری
نابغه	نابغه
نابود	نابود
نابودی	نابودی
ناتل	ناتل
ناتنی	ناتنی
ناتو	ناتو
ناتورالیسم	ناتورالیسم
ناتینگهام	ناتینگهام
ناحیه	ناحیه
ناحیهٔ	ناحیه
ناخالص	ناخالص
ناخودآگاه	ناخودآگاه
نادر	نادر
نادرست	نادرست
نادرشاه	نادرشاه
نادری	نادری
نادعلی	نادعلی
ناراحت	ناراحت
ناراحتی	ناراحتی
ناراضی	ناراضی
نارضایتی	نارضایتی
نارنج	نارنج
نارنگی	نارنگی
ناز	ناز
نازل	نازل
نازک	نازک
نازی	نازی
نازیسم	نازیسم
ناسا	ناسا
ناسیونال	ناسیونال
ناسیونالیست	ناسیونالیست
ناسیونالیسم	ناسیونالیسم
ناشر	ناشر
ناشناخته	ناشناخته
ناشناس	ناشناس
ناشی	ناشی
ناصر	ناصر
ناصرالدین	ناصرالدین
ناصری	ناصری
ناظر	ناظر
ناظم	ناظم
ناقص	ناقص
نام	نام
نامدار	نامدار
نامزد	نامزد
نامشخص	نامشخص
نامعلوم	نامعلوم
نامنظم	نامنظم
نامه	نامه
نامگذاری	نامگذاری
نامی	نامی
نامیبیا	نامیبیا
نامیده	نامیده
نان	نان
نانسی	نانسی
ناو	ناو
ناوگان	ناوگان
ناپدید	ناپدید
ناپذیر	ناپذیر
ناپل	ناپل
ناپولی	ناپولی
ناچار	ناچار
ناکازاکی	ناکازاکی
ناگزیر	ناگزیر
ناگهانی	ناگهانی
نایب	نایب
نایروبی	نایروبی
نبرد	نبرد
نبود	نبود
نت	نت
نتانیاهو	نتانیاهو
نتایج	نتایج
نتیجتاً	نتیجتاً
نتیجه	نتیجه
نتیجهٔ	نتیجه
نثر	نثر
نجات	نجات
نجران	نجران
نجف	نجف
نجفی	نجفی
نجوم	نجوم
نجیب	نجیب
نحو	نحو
نحوه	نحوه
نحوهٔ	نحوه
نحوی	نحوی
نخ	نخ
نخاسته	نخاسته
نخجوان	نخجوان
نخست	نخست
نخستین	نخستین
نخواهد	نخواهد
ندا	ندا
ندارد	ندارد
نداشت	نداشت
نداشتن	نداشتن
نداشته	نداشته
نده	نده
ندیم	ندیم
نر	نر
نرخ	نرخ
نرسی	نرسی
نرم	نرم
نرماندی	نرماندی
نروژ	نروژ
نروژی	نروژی
نرگس	نرگس
نزد	نزد
نزدیک	نزدیک
نزدیکی	نزدیکی
نسا	نسا
نساجی	نساجی
نسبت	نسبت
نسبتا	نسبتا
نسبتاً	نسبتاً
نسبی	نسبی
نسبیت	نسبیت
نستعلیق	نستعلیق
نستور	نستور
نسخ	نسخ
نسخه	نسخه
نسخهٔ	نسخه
نسرین	نسرین
نسل	نسل
نسیم	نسیم
نشا	نشا
نشان	نشان
نشده	نشده
نشر	نشر
نشریات	نشریات
نشریه	نشریه
نشست	نشست
نشناسی	نشناسی
نشین	نشین
نشینی	نشینی
نصاب	نصاب
نصب	نصب
نصر	نصر
نصرالله	نصرالله
نصف	نصف
نصیحت	نصیحت
نصیرآباد	نصیرآباد
نظارت	نظارت
نظام	نظام
نظامی	نظامی
نظر	نظر
نظرآباد	نظرآباد
نظرات	نظرات
نظرسنجی	نظرسنجی
نظری	نظری
نظریات	نظریات
نظریه	نظریه
نظریهٔ	نظریه
نظم	نظم
نظیر	نظیر
نعل	نعل
نعیمی	نعیمی
نفت	نفت
نفر	نفر
نفره	نفره
نفس	نفس
نفع	نفع
نفوذ	نفوذ
نفوس	نفوس
نفیسی	نفیسی
نقاره	نقاره
نقاش	نقاش
نقاشی	نقاشی
نقاط	نقاط
نقد	نقد
نقدی	نقدی
نقره	نقره
نقش	نقش
نقشه	نقشه
نقشی	نقشی
نقض	نقض
نقطه	نقطه
نقطهٔ	نقطه
نقل	نقل
نقی	نقی
نقیب	نقیب
نلسون	نلسون
نما	نما
نماد	نماد
نماز	نماز
نمایش	نمایش
نمایشگاه	نمایشگاه
نماینده	نماینده
نمایندگان	نمایندگان
نمایندگی	نمایندگی
نمره	نمره
نمو	نمو
نمود	نمود
نمونه	نمونه
نمک	نمک
نمی	نمی
ننه	ننه
نه	نه
نهاد	نهاد
نهاوند	نهاوند
نهایت	نهایت
نهایتا	نهایتا
نهایتاً	نهایتاً
نهر	نهر
نهضت	نهضت
نهم	نهم
نهمین	نهمین
نو	نو
نوآباد	نوآباد
نوا	نوا
نواحی	نواحی
نواختن	نواختن
نوادا	نوادا
نوادگان	نوادگان
نوار	نوار
نوازنده	نوازنده
نوازندگی	نوازندگی
نوامبر	نوامبر
نوبت	نوبت
نوبل	نوبل
نوح	نوح
نود	نود
نوده	نوده
نور	نور
نورالدین	نورالدین
نورانی	نورانی
نورس	نورس
نوروز	نوروز
نوروزی	نوروزی
نوری	نوری
نوزده	نوزده
نوزدهم	نوزدهم
نوشته	نوشته
نوشتهٔ	نوشته
نوشهر	نوشهر
نوشهری	نوشهری
نوشیدن	نوشیدن
نوع	نوع
نون	نون
نوه	نوه
نوک	نوک
نوکنده	نوکنده
نویس	نویس
نویسد	نویسد
نویسنده	نویسنده
نویسندهٔ	نویسنده
نویسندگی	نویسندگی
نویسی	نویسی
نوین	نوین
نَیره	نیره
نِداشته	نداشته
نپال	نپال
نژاد	نژاد
نژادی	نژادی
نکا	نکا
نکارد	نکارد
نکته	نکته
نکرده	نکرده
نکشی	نکشی
نگار	نگار
نگارش	نگارش
نگارنده	نگارنده
نگاه	نگاه
نگذشته	نگذشته
نگران	نگران
نگرانی	نگرانی
نگرش	نگرش
نگرو	نگرو
نگرویِ	نگروی
نگه	نگه
نگهبان	نگهبان
نگهداری	نگهداری
نی	نی
نیاز	نیاز
نیازمند	نیازمند
نیازی	نیازی
نیایش	نیایش
نیت	نیت
نیجر	نیجر
نیجریه	نیجریه
نیر	نیر
نیرو	نیرو
نیروگاه	نیروگاه
نیز	نیز
نیزه	نیزه
نیس	نیس
نیست	نیست
نیش	نیش
نیشابور	نیشابور
نیل	نیل
نیلی	نیلی
نیم	نیم
نیما	نیما
نیمایی	نیمایی
نیمه	نیمه
نیمهٔ	نیمه
نیمکره	نیمکره
نیمی	نیمی
نینوا	نینوا
نیو	نیو
نیوتن	نیوتن
نیوجرسی	نیوجرسی
نیوز	نیوز
نیوزلند	نیوزلند
نیوزیلند	نیوزیلند
نیوکاسل	نیوکاسل
نیویورک	نیویورک
نیچه	نیچه
نیک	نیک
نیکاراگوئه	نیکاراگوئه
نیکسون	نیکسون
نیکلا	نیکلا
نیکلاس	نیکلاس
نیکلای	نیکلای
نیکوزیا	نیکوزیا
نیکول	نیکول
نیکولا	نیکولا
نیکولاس	نیکولاس
نیکی	نیکی
نیکیتا	نیکیتا
هائیتی	هائیتی
هابل	هابل
هادی	هادی
هارد	هارد
هاروارد	هاروارد
هارولد	هارولد
هارون	هارون
هاشم	هاشم
هاشمی	هاشمی
هافبک	هافبک
هال	هال
هالووین	هالووین
هالیوود	هالیوود
هامبورگ	هامبورگ
هانا	هانا
هانتینگتون	هانتینگتون
هانری	هانری
هانوی	هانوی
هاوارد	هاوارد
هاوانا	هاوانا
هاوایی	هاوایی
هاوکینگ	هاوکینگ
هاپکینز	هاپکینز
هایزنبرگ	هایزنبرگ
هاینریش	هاینریش
هتل	هتل
هجایی	هجایی
هجدهم	هجدهم
هجرت	هجرت
هجری	هجری
هجوم	هجوم
هدا	هدا
هدایت	هدایت
هدایتی	هدایتی
هدف	هدف
هدن	هدن
هدی	هدی
هدیه	هدیه
هر	هر
هرات	هرات
هراز	هراز
هراس	هراس
هراکلیتوس	هراکلیتوس
هربرت	هربرت
هرتی	هرتی
هرجور	هرجور
هرزگوین	هرزگوین
هرساله	هرساله
هرمز	هرمز
هرناندز	هرناندز
هرودوت	هرودوت
هرچند	هرچند
هرچه	هرچه
هرکس	هرکس
هرکول	هرکول
هرگز	هرگز
هرگونه	هرگونه
هریس	هریس
هریسون	هریسون
هزار	هزار
هزاران	هزاران
هزارجریبی	هزارجریبی
هزاره	هزاره
هزینه	هزینه
هست	هست
هستم	هستم
هستند	هستند
هسته	هسته
هستی	هستی
هسه	هسه
هسِّه	هسه
هسّه	هسه
هشت	هشت
هشتاد	هشتاد
هشتم	هشتم
هشتمین	هشتمین
هشتگرد	هشتگرد
هشدار	هشدار
هفت	هفت
هفتاد	هفتاد
هفتم	هفتم
هفتمین	هفتمین
هفته	هفته
هفتگی	هفتگی
هفدهم	هفدهم
هلموت	هلموت
هلن	هلن
هلند	هلند
هلندِ	هلند
هلندی	هلندی
هلی	هلی
هلیوم	هلیوم
هم	هم
همان	همان
همانند	همانند
هماهنگ	هماهنگ
هماهنگی	هماهنگی
همایش	همایش
همایون	همایون
همت	همت
همجنس	همجنس
همجوار	همجوار
همدان	همدان
همدانی	همدانی
همدیگر	همدیگر
همراه	همراه
همراهی	همراهی
همزمان	همزمان
همسایه	همسایه
همسایگی	همسایگی
همسر	همسر
همه	همه
همهٔ	همهٔ
هموار	هموار
همواره	همواره
همون	همون
همچنان	همچنان
همچنین	همچنین
همچون	همچون
همکاری	همکاری
همگی	همگی
همیشه	همیشه
همیشگی	همیشگی
همیلتون	همیلتون
همین	همین
همینگوی	همینگوی
هند	هند
هندسه	هندسه
هندو	هندو
هندوانه	هندوانه
هندوراس	هندوراس
هندوستان	هندوستان
هندوچین	هندوچین
هندوییسم	هندوییسم
هندِ	هند
هنر	هنر
هنرمند	هنرمند
هنرمندان	هنرمندان
هنرپیشه	هنرپیشه
هنری	هنری
هنوز	هنوز
هنگ	هنگ
هنگام	هنگام
هنگامی	هنگامی
هوا	هوا
هوادار	هوادار
هواپیما	هواپیما
هوایی	هوایی
هود	هود
هوس	هوس
هوش	هوش
هوشمند	هوشمند
هوشنگ	هوشنگ
هوشیار	هوشیار
هولوکاست	هولوکاست
هومر	هومر
هوندا	هوندا
هونگ	هونگ
هوو	هوو
هوکایدو	هوکایدو
هوگو	هوگو
هویت	هویت
هویدا	هویدا
هَسته	هسته
هَسّه	هسه
هِدا	هدا
هِدی	هدی
هِم	هم
هِمراه	همراه
هِمراهی	همراهی
هژبر	هژبر
هژمونی	هژمونی
هک	هک
هکتار	هکتار
هیأت	هیأت
هیئت	هیئت
هیات	هیات
هیتلر	هیتلر
هیجان	هیجان
هیجدهم	هیجدهم
هیدروژن	هیدروژن
هیروشیما	هیروشیما
هیستری	هیستری
هیل	هیل
هیلاری	هیلاری
هیمالیا	هیمالیا
هیوستون	هیوستون
هیچ	هیچ
هیچکس	هیچکس
و	و
وا	وا
وابسته	وابسته
وابستگی	وابستگی
وات	وات
واتسون	واتسون
واتیکان	واتیکان
واجب	واجب
واحد	واحد
واحدِ	واحد
وادار	وادار
وارد	وارد
واسطه	واسطه
واسلاو	واسلاو
واشنگتن	واشنگتن
واشینگتن	واشینگتن
واقع	واقع
واقعا	واقعا
واقعه	واقعه
واقعی	واقعی
واقعیت	واقعیت
وال	وال
والاس	والاس
والتر	والتر
والد	والد
والری	والری
والنسیا	والنسیا
واله	واله
والی	والی
والیبال	والیبال
وام	وام
وان	وان
وانت	وانت
واژه	واژه
واژهٔ	واژه
واکر	واکر
واکنش	واکنش
واگذار	واگذار
وایمار	وایمار
وایکینگ	وایکینگ
وب	وب
وبر	وبر
وبلاگ	وبلاگ
وتو	وتو
وجه	وجه
وجود	وجود
وجین	وجین
وحدت	وحدت
وحش	وحش
وحشت	وحشت
وحی	وحی
وحید	وحید
ورامین	ورامین
ورد	ورد
وردنه	وردنه
وردی	وردی
ورزا	ورزا
ورزش	ورزش
ورزشکار	ورزشکار
ورزشگاه	ورزشگاه
ورسای	ورسای
ورسک	ورسک
ورشو	ورشو
ورشکستگی	ورشکستگی
ورم	ورم
ورنه	ورنه
ورود	ورود
ورودی	ورودی
وزارت	وزارت
وزن	وزن
وزنه	وزنه
وزیر	وزیر
وزیران	وزیران
وزیری	وزیری
وساطت	وساطت
وسایل	وسایل
وست	وست
وسط	وسط
وسطی	وسطی
وسعت	وسعت
وسواس	وسواس
وسیع	وسیع
وسیله	وسیله
وشمگیر	وشمگیر
وصل	وصل
وصیت	وصیت
وضع	وضع
وضعیت	وضعیت
وطن	وطن
وظایف	وظایف
وظیفه	وظیفه
وظیفهٔ	وظیفه
وفادار	وفادار
وفاداری	وفاداری
وقایع	وقایع
وقت	وقت
وقتی	وقتی
وقف	وقف
وقوع	وقوع
ول	ول
ولادیمیر	ولادیمیر
ولایات	ولایات
ولایت	ولایت
ولتاژ	ولتاژ
ولز	ولز
ولزی	ولزی
ولگا	ولگا
ولی	ولی
ولید	ولید
ولیعهد	ولیعهد
ون	وِن
ونزوئلا	ونزوئلا
ونسان	ونسان
ونوس	ونوس
ونک	ونک
ونگ	ونگ
ونیز	ونیز
وهابیت	وهابیت
ووهان	ووهان
وَردنه	وردنه
وَرنه	ورنه
وِ	و
وِل	ول
وِن	وِن
وکیل	وکیل
وی	وی
ویت	ویت
ویتامین	ویتامین
ویتنام	ویتنام
ویتنامی	ویتنامی
ویدئو	ویدئو
ویر	ویر
ویراستار	ویراستار
ویرایش	ویرایش
ویرجینیا	ویرجینیا
ویروس	ویروس
ویرژیل	ویرژیل
ویس	ویس
ویل	ویل
ویلا	ویلا
ویلسون	ویلسون
ویلن	ویلن
ویلهلم	ویلهلم
ویلیام	ویلیام
ویلیامز	ویلیامز
وین	وین
ویندوز	ویندوز
وینستون	وینستون
ویولن	ویولن
ویژه	ویژه
ویژگی	ویژگی
ویکتور	ویکتور
ویکتوریا	ویکتوریا
ویکی	ویکی
ِآثار	آثار
ِآخرین	آخرین
ِآدِم	آدم
ِآزادی	آزادی
ِآسیا	آسیا
ِآلبوم	آلبوم
ِآمار	آمار
ِآهنگ	آهنگ
ِاتحاد	اتحاد
ِاتحادیه	اتحادیه
ِاختیارات	اختیارات
ِاداره	اداره
ِادبی	ادبی
ِادبیات	ادبیات
ِارتباط	ارتباط
ِارتش	ارتش
ِاستاد	استاد
ِاستان	استان
ِاستعمار	استعمار
ِاستقلال	استقلال
ِاسقف	اسقف
ِاسلامی	اسلامی
ِاسم	اسم
ِاسپهبد	اسپهبد
ِاشغال	اشغال
ِاصل	اصل
ِاصلی	اصلی
ِاطراف	اطراف
ِاعضا	اعضا
ِاقتصاد	اقتصاد
ِاقوام	اقوام
ِامپراتوری	امپراتوری
ِامیر	امیر
ِانتخابات	انتخابات
ِانجمن	انجمن
ِانقلاب	انقلاب
ِاواخر	اواخر
ِاوضاع	اوضاع
ِاولین	اولین
ِاولیه	اولیه
ِاوکیناوا	اوکیناوا
ِاکثریت	اکثریت
ِایالت	ایالت
ِایران	ایران
ِایرانی	ایرانی
ِبابل	بابل
ِبابلسر	بابلسر
ِبازار	بازار
ِباقی	باقی
ِبحران	بحران
ِبخاستی	بخاستی
ِبخش	بخش
ِبریم	بریم
ِبعضی	بعضی
ِبندر	بندر
ِبنه	بنه
ِبورس	بورس
ِبومی	بومی
ِبِن	بن
ِبِنه	بنه
ِبی	بی
ِبیست	بیست
ِتابع	تابع
ِتاریخ	تاریخ
ِتبار	تبار
ِتجارت	تجارت
ِتجاری	تجاری
ِتفسیر	تفسیر
ِتنها	تنها
ِتوکیو	توکیو
ِتِبار	تبار
ِتِک	تک
ِتیر	تیر
ِتیم	تیم
ِجا	جا
ِجانشین	جانشین
ِجایزه	جایزه
ِجبهه	جبهه
ِجدید	جدید
ِجریان	جریان
ِجزیره	جزیره
ِجمعیت	جمعیت
ِجمهوری	جمهوری
ِجنبش	جنبش
ِجنوب	جنوب
ِجنوبی	جنوبی
ِجنگ	جنگ
ِجواب	جواب
ِحاکم	حاکم
ِحزب	حزب
ِحق	حق
ِحقوق	حقوق
ِحمایت	حمایت
ِحملات	حملات
ِحمله	حمله
ِحکم	حکم
ِحکومت	حکومت
ِحکومِت	حکومت
ِخاندان	خاندان
ِخانواده	خانواده
ِخاک	خاک
ِخط	خط
ِخلق	خلق
ِخوری	خوری
ِداستان	داستان
ِدبیرکل	دبیرکل
ِدربار	دربار
ِدرون	درون
ِدریا	دریا
ِدستور	دستور
ِدله	دله
ِدلیل	دلیل
ِدموکراتیک	دموکراتیک
ِدموکراسی	دموکراسی
ِدو	دو
ِدور	دور
ِدوران	دوران
ِدوره	دوره
ِدولت	دولت
ِدولِت	دولت
ِدومین	دومین
ِدیم	دیم
ِدین	دین
ِدینی	دینی
ِدیوان	دیوان
ِدیگه	دیگه
ِرئیس	رئیس
ِراه	راه
ِرتبه	رتبه
ِرسانه	رسانه
ِرسمیت	رسمیت
ِرشته	رشته
ِرهبر	رهبر
ِرهبری	رهبری
ِروابط	روابط
ِروز	روز
ِروش	روش
ِریاست	ریاست
ِریشه	ریشه
ِریکا	ریکا
ِزنا	زنا
ِزندگی	زندگی
ِساحل	ساحل
ِسازمان	سازمان
ِسال	سال
ِسبک	سبک
ِسر	سر
ِسران	سران
ِسردار	سردار
ِسرزمین	سرزمین
ِسرشماری	سرشماری
ِسفر	سفر
ِسلسله	سلسله
ِسلطنت	سلطنت
ِسه	سه
ِسو	سو
ِسوال	سوال
ِسوره	سوره
ِسوسیالیستی	سوسیالیستی
ِسومین	سومین
ِسَر	سر
ِسَره	سره
ِسِره	سره
ِسِوا	سوا
ِسپاه	سپاه
ِسپهسالار	سپهسالار
ِسی	سی
ِسیاسی	سیاسی
ِشاه	شاه
ِشرق	شرق
ِشرقی	شرقی
ِشعر	شعر
ِشمال	شمال
ِشمالی	شمالی
ِشهر	شهر
ِشورا	شورا
ِشورش	شورش
ِشکایت	شکایت
ِشکست	شکست
ِشکل	شکل
ِصدا	صدا
ِصدراعظم	صدراعظم
ِعربی	عربی
ِعضو	عضو
ِعضویت	عضویت
ِعقاید	عقاید
ِعمان	عمان
ِغرب	غرب
ِغربی	غربی
ِفدراسیون	فدراسیون
ِفرماندار	فرماندار
ِفرمانده	فرمانده
ِفرهنگ	فرهنگ
ِفلات	فلات
ِفلسفه	فلسفه
ِفیلم	فیلم
ِقاجار	قاجار
ِقاره	قاره
ِقانون	قانون
ِقدرت	قدرت
ِقدیمی	قدیمی
ِقرن	قرن
ِقلعه	قلعه
ِقوانین	قوانین
ِلاله	لاله
ِلشکر	لشکر
ِلهجه	لهجه
ِلوری	لوری
ِلیگ	لیگ
ِمار	مار
ِمتحده	متحده
ِمجلس	مجلس
ِمجله	مجله
ِمجموعه	مجموعه
ِمخالف	مخالف
ِمختلف	مختلف
ِمذهب	مذهب
ِمربی	مربی
ِمردم	مردم
ِمردِم	مردم
ِمرکز	مرکز
ِمرکزی	مرکزی
ِمسئله	مسئله
ِمسئول	مسئول
ِمسائل	مسائل
ِمسابقات	مسابقات
ِمستعمره	مستعمره
ِمعاصر	معاصر
ِمعاون	معاون
ِمعروف	معروف
ِمعلم	معلم
ِمعنی	معنی
ِملل	ملل
ِملّی	ملّی
ِملکه	ملکه
ِملی	ملّی
ِمنابع	منابع
ِمناطق	مناطق
ِمنشور	منشور
ِمنطقه	منطقه
ِمهم	مهم
ِموقعیت	موقعیت
ِمَقِر	مقر
ِمکتب	مکتب
ِمیلاد	میلاد
ِناحیه	ناحیه
ِنخست	نخست
ِنزدیکی	نزدیکی
ِنسبی	نسبی
ِنظامی	نظامی
ِنظر	نظر
ِنقش	نقش
ِنماینده	نماینده
ِنمایندگی	نمایندگی
ِنه	نه
ِنوه	نوه
ِنژاد	نژاد
ِنژادی	نژادی
ِنیرو	نیرو
ِهدف	هدف
ِهمراه	همراه
ِهمراهی	همراهی
ِهوایی	هوایی
ِهوکایدو	هوکایدو
ِهیروشیما	هیروشیما
ِوالی	والی
ِواژه	واژه
ِوزارت	وزارت
ِوزیر	وزیر
ِوسط	وسط
ِوضعیت	وضعیت
ِولیعهد	ولیعهد
ِپرجمعیت	پرجمعیت
ِپرچم	پرچم
ِپول	پول
ِپِشتی	پشتی
ِپی	پی
ِپیل	پیل
ِچلّه	چله
ِکاخ	کاخ
ِکار	کار
ِکارون	کارون
ِکاندیدا	کاندیدا
ِکتاب	کتاب
ِکشور	کشور
ِکل	کل
ِکلمه	کلمه
ِکمونیست	کمونیست
ِکمیته	کمیته
ِکنترل	کنترل
ِکنگره	کنگره
ِکوره	کوره
ِکوچی	کوچی
ِکیوتو	کیوتو
ِگت	گت
ِگتِ	گت
ِگروه	گروه
ِگپ	گپ
پا	پا
پابلو	پابلو
پابند	پابند
پاتر	پاتر
پاتریس	پاتریس
پاتریک	پاتریک
پادشاه	پادشاه
پادشاهان	پادشاهان
پادشاهی	پادشاهی
پادگان	پادگان
پارادوکس	پارادوکس
پاراگوئه	پاراگوئه
پارتی	پارتی
پارس	پارس
پارسی	پارسی
پارسیان	پارسیان
پارلمان	پارلمان
پاره	پاره
پارچه	پارچه
پارک	پارک
پاریس	پاریس
پاس	پاس
پاسخ	پاسخ
پاسداری	پاسداری
پاسکال	پاسکال
پاسیفیک	پاسیفیک
پاشا	پاشا
پاشایی	پاشایی
پال	پال
پالایش	پالایش
پاناما	پاناما
پانزده	پانزده
پانزدهم	پانزدهم
پاپ	پاپ
پاچینو	پاچینو
پاک	پاک
پاکدشت	پاکدشت
پاکسازی	پاکسازی
پاکستان	پاکستان
پای	پای
پایان	پایان
پایتخت	پایتخت
پایدار	پایدار
پایه	پایه
پایهٔ	پایه
پایگاه	پایگاه
پاییز	پاییز
پایین	پایین
پایینی	پایینی
پتاسیم	پتاسیم
پتانسیل	پتانسیل
پتر	پتر
پترزبورگ	پترزبورگ
پتک	پتک
پتی	پتی
پخش	پخش
پدر	پدر
پدید	پدید
پدیده	پدیده
پذیرش	پذیرش
پذیرفت	پذیرفت
پذیرفته	پذیرفته
پر	پر
پراکنده	پراکنده
پراگ	پراگ
پرت	پرت
پرتاب	پرتاب
پرتره	پرتره
پرتغال	پرتغال
پرتغالِ	پرتغال
پرتغالی	پرتغالی
پرتو	پرتو
پرجمعیت	پرجمعیت
پرداخت	پرداخت
پرداخته	پرداخته
پرداز	پرداز
پرده	پرده
پردیس	پردیس
پرز	پرز
پرس	پرس
پرستش	پرستش
پرستی	پرستی
پرسش	پرسش
پرسپولیس	پرسپولیس
پرفروش	پرفروش
پرنده	پرنده
پرندگان	پرندگان
پرنس	پرنس
پرنسس	پرنسس
پره	پره
پرو	پرو
پرواز	پرواز
پروانه	پروانه
پروتئین	پروتئین
پروتستان	پروتستان
پروتکل	پروتکل
پرور	پرور
پروردگار	پروردگار
پرورش	پرورش
پرورشگاه	پرورشگاه
پروفسور	پروفسور
پرونده	پرونده
پروژه	پروژه
پرویز	پرویز
پروین	پروین
پرچم	پرچم
پرچمی	پرچمی
پرچین	پرچین
پرک	پرک
پرکار	پرکار
پرکوه	پرکوه
پری	پری
پزشک	پزشک
پزشکی	پزشکی
پزو	پزو
پس	پس
پست	پست
پستاندار	پستاندار
پسر	پسر
پسند	پسند
پسوند	پسوند
پشت	پشت
پشتکوه	پشتکوه
پشتی	پشتی
پشتیبانی	پشتیبانی
پطرس	پطرس
پل	پل
پلانک	پلانک
پلنگ	پلنگ
پلوتو	پلوتو
پلور	پلور
پلک	پلک
پلیس	پلیس
پن	پن
پنالتی	پنالتی
پناه	پناه
پناهندگی	پناهندگی
پناهگاه	پناهگاه
پنبه	پنبه
پنج	پنج
پنجاب	پنجاب
پنجابی	پنجابی
پنجاه	پنجاه
پنجره	پنجره
پنجشیر	پنجشیر
پنجم	پنجم
پنجمین	پنجمین
پنجه	پنجه
پنسیلوانیا	پنسیلوانیا
پنهان	پنهان
پنهانی	پنهانی
پنگ	پنگ
پهلوان	پهلوان
پهلوی	پهلوی
پهن	پهن
پهنا	پهنا
پهنه	پهنه
پوتین	پوتین
پور	پور
پورتو	پورتو
پورتوریکو	پورتوریکو
پوررضا	پوررضا
پوریا	پوریا
پوست	پوست
پوشاک	پوشاک
پوشش	پوشش
پوشکین	پوشکین
پوشیده	پوشیده
پول	پول
پولدار	پولدار
پولیس	پولیس
پوند	پوند
پوپولیسم	پوپولیسم
پویا	پویا
پویول	پویول
پُست	پست
پِر	پر
پِشت	پشت
پِشتی	پشتی
پِل	پل
پژواک	پژواک
پژوهش	پژوهش
پژوهشگر	پژوهشگر
پژوهشگران	پژوهشگران
پکن	پکن
پی	پی
پیاده	پیاده
پیام	پیام
پیامبر	پیامبر
پیانو	پیانو
پیانیست	پیانیست
پیاپی	پیاپی
پیت	پیت
پیتر	پیتر
پیتزا	پیتزا
پیدا	پیدا
پیدایش	پیدایش
پیر	پیر
پیرامون	پیرامون
پیران	پیران
پیرلو	پیرلو
پیرو	پیرو
پیروز	پیروز
پیروزی	پیروزی
پیروی	پیروی
پیری	پیری
پیزارو	پیزارو
پیس	پیس
پیش	پیش
پیشبرد	پیشبرد
پیشتاز	پیشتاز
پیشتر	پیشتر
پیشرفت	پیشرفت
پیشرفته	پیشرفته
پیشرو	پیشرو
پیشروی	پیشروی
پیشنهاد	پیشنهاد
پیشوند	پیشوند
پیشگام	پیشگام
پیشگیری	پیشگیری
پیشی	پیشی
پیشین	پیشین
پیشینه	پیشینه
پیل	پیل
پیمان	پیمان
پینوشه	پینوشه
پیوست	پیوست
پیوسته	پیوسته
پیوند	پیوند
پیوندی	پیوندی
پیچیده	پیچیده
پیک	پیک
پیکاسو	پیکاسو
پیکر	پیکر
پیگیری	پیگیری
چابکسر	چابکسر
چاد	چاد
چادر	چادر
چارلز	چارلز
چارلی	چارلی
چاره	چاره
چارچوب	چارچوب
چاشت	چاشت
چال	چال
چالوس	چالوس
چاه	چاه
چاوز	چاوز
چاپ	چاپ
چاپار	چاپار
چاپلین	چاپلین
چای	چای
چایی	چایی
چخوف	چخوف
چرا	چرا
چراغ	چراغ
چراغعلی	چراغعلی
چربی	چربی
چرخ	چرخ
چرخش	چرخش
چرخه	چرخه
چرنوبیل	چرنوبیل
چرچیل	چرچیل
چریک	چریک
چشم	چشم
چشمه	چشمه
چفت	چفت
چلسی	چلسی
چله	چله
چلّه	چله
چلیک	چلیک
چم	چم
چمران	چمران
چنار	چنار
چناران	چناران
چنان	چنان
چند	چند
چندان	چندان
چندتا	چندتا
چندی	چندی
چندین	چندین
چنگ	چنگ
چنگال	چنگال
چنین	چنین
چه	چه
چهار	چهار
چهاردانگه	چهاردانگه
چهاردهم	چهاردهم
چهارشنبه	چهارشنبه
چهارصد	چهارصد
چهارم	چهارم
چهارمین	چهارمین
چهره	چهره
چهل	چهل
چو	چو
چوب	چوب
چوبی	چوبی
چوله	چوله
چون	چون
چونکه	چونکه
چپ	چپ
چپکی	چپکی
چپی	چپی
چچن	چچن
چک	چک
چکسلواکی	چکسلواکی
چکی	چکی
چگالی	چگالی
چگونه	چگونه
چگونگی	چگونگی
چی	چی
چیز	چیز
چین	چین
چینی	چینی
ژاله	ژاله
ژان	ژان
ژاندارمری	ژاندارمری
ژانر	ژانر
ژانویه	ژانویه
ژانویهٔ	ژانویه
ژاپن	ژاپن
ژاک	ژاک
ژاکلین	ژاکلین
ژرمن	ژرمن
ژروم	ژروم
ژرژ	ژرژ
ژن	ژن
ژنرال	ژنرال
ژنو	ژنو
ژوئن	ژوئن
ژوئیه	ژوئیه
ژوئیهٔ	ژوئیه
ژوزف	ژوزف
ژول	ژول
ژولی	ژولی
ژولیت	ژولیت
ژولیتِ	ژولیت
ژولیوس	ژولیوس
ژوهانسبورگ	ژوهانسبورگ
ژیل	ژیل
ژیلبر	ژیلبر
کابل	کابل
کابینه	کابینه
کاتالانی	کاتالانی
کاتالونی	کاتالونی
کاترین	کاترین
کاترینا	کاترینا
کاتولیک	کاتولیک
کاخ	کاخ
کار	کار
کارآفرین	کارآفرین
کارا	کارا
کارائیب	کارائیب
کاراکاس	کاراکاس
کاراکتر	کاراکتر
کارایی	کارایی
کاربر	کاربر
کاربرد	کاربرد
کاربری	کاربری
کارتاژ	کارتاژ
کارتون	کارتون
کارخانه	کارخانه
کارد	کارد
کارشناس	کارشناس
کارشناسی	کارشناسی
کارل	کارل
کارلوس	کارلوس
کارمند	کارمند
کارمندان	کارمندان
کارن	کارن
کارنامه	کارنامه
کارنامهٔ	کارنامه
کارور	کارور
کارول	کارول
کارولین	کارولین
کارولینا	کارولینا
کارون	کارون
کارونی	کارونی
کارِ	کار
کارکرد	کارکرد
کارگر	کارگر
کارگران	کارگران
کارگردان	کارگردان
کارگردانی	کارگردانی
کارگری	کارگری
کاری	کاری
کازرون	کازرون
کازه	کازه
کاست	کاست
کاستا	کاستا
کاستاریکا	کاستاریکا
کاسترو	کاسترو
کاسپاروف	کاسپاروف
کاسپین	کاسپین
کاشان	کاشان
کاشانی	کاشانی
کاشمر	کاشمر
کاشی	کاشی
کاظم	کاظم
کاظمی	کاظمی
کاغذ	کاغذ
کافر	کافر
کافکا	کافکا
کافی	کافی
کال	کال
کالا	کالا
کالبد	کالبد
کالج	کالج
کالی	کالی
کالیفرنیا	کالیفرنیا
کالینینگراد	کالینینگراد
کامبوج	کامبوج
کامران	کامران
کامرون	کامرون
کامل	کامل
کاملا	کاملا
کاملاً	کاملاً
کامو	کامو
کامپیوتر	کامپیوتر
کامپیوتری	کامپیوتری
کان	کان
کانادا	کانادا
کانادایی	کانادایی
کانال	کانال
کانتون	کانتون
کاندوم	کاندوم
کاندید	کاندید
کاندیدا	کاندیدا
کانزاس	کانزاس
کانه	کانه
کانون	کانون
کانّه	کانه
کانی	کانی
کاهش	کاهش
کاهن	کاهن
کاوه	کاوه
کاووس	کاووس
کاوی	کاوی
کاویان	کاویان
کاویانی	کاویانی
کاپ	کاپ
کاپریو	کاپریو
کاپیتالیسم	کاپیتالیسم
کاپیتان	کاپیتان
کاکویه	کاکویه
کاکی	کاکی
کای	کای
کبودجامه	کبودجامه
کبک	کبک
کبیر	کبیر
کبیسه	کبیسه
کتاب	کتاب
کتابت	کتابت
کتابخانه	کتابخانه
کتابچه	کتابچه
کتابی	کتابی
کتب	کتب
کته	کته
کتول	کتول
کتولی	کتولی
کتی	کتی
کتیبه	کتیبه
کجور	کجور
کجوری	کجوری
کد	کد
کدو	کدو
کر	کر
کرانه	کرانه
کراچی	کراچی
کربلا	کربلا
کربن	کربن
کرج	کرج
کرد	کرد
کردستان	کردستان
کردن	کردن
کردند	کردند
کرده	کرده
کردکوی	کردکوی
کردی	کردی
کردیم	کردیم
کرس	کرس
کرسی	کرسی
کرم	کرم
کرمان	کرمان
کرمانجی	کرمانجی
کرمانشاه	کرمانشاه
کره	کره
کروات	کروات
کرواسی	کرواسی
کروبی	کروبی
کروز	کروز
کرون	کرون
کرونا	کرونا
کروی	کروی
کرک	کرک
کرکس	کرکس
کرکوک	کرکوک
کری	کری
کریس	کریس
کریستال	کریستال
کریستف	کریستف
کریستفر	کریستفر
کریستو	کریستو
کریستوف	کریستوف
کریستوفر	کریستوفر
کریستیانو	کریستیانو
کریستین	کریستین
کریسمس	کریسمس
کریم	کریم
کریمه	کریمه
کریمی	کریمی
کریکت	کریکت
کز	کز
کس	کس
کسانی	کسانی
کسایی	کسایی
کسب	کسب
کسروی	کسروی
کسوف	کسوف
کسی	کسی
کش	کش
کشاورز	کشاورز
کشاورزی	کشاورزی
کشت	کشت
کشتار	کشتار
کشته	کشته
کشتی	کشتی
کشف	کشف
کشمیر	کشمیر
کشور	کشور
کشورِ	کشور
کشوری	کشوری
کشک	کشک
کشی	کشی
کشیده	کشیده
کشیش	کشیش
کف	کف
کل	کل
کلا	کلا
کلات	کلات
کلاردشت	کلاردشت
کلارک	کلارک
کلاس	کلاس
کلاسیک	کلاسیک
کلاشنیکف	کلاشنیکف
کلاشینکف	کلاشینکف
کلاله	کلاله
کلان	کلان
کلاه	کلاه
کلاوس	کلاوس
کلاً	کلاً
کلخوران	کلخوران
کلرادو	کلرادو
کلسیم	کلسیم
کلمات	کلمات
کلمب	کلمب
کلمبیا	کلمبیا
کلمبیایی	کلمبیایی
کلمه	کلمه
کلمهٔ	کلمه
کله	کله
کلود	کلود
کلودل	کلودل
کلوین	کلوین
کلّی	کلی
کلک	کلک
کلکته	کلکته
کلی	کلی
کلید	کلید
کلیدی	کلیدی
کلیسا	کلیسا
کلیسایی	کلیسایی
کلینتون	کلینتون
کلیه	کلیه
کم	کم
کمال	کمال
کماکان	کماکان
کمبریج	کمبریج
کمبود	کمبود
کمتر	کمتر
کمترین	کمترین
کمدی	کمدی
کمدین	کمدین
کمر	کمر
کمربند	کمربند
کمرنگ	کمرنگ
کمون	کمون
کمونیست	کمونیست
کمونیستی	کمونیستی
کمونیسم	کمونیسم
کمپ	کمپ
کمپانی	کمپانی
کمپین	کمپین
کمک	کمک
کمی	کمی
کمیت	کمیت
کمیته	کمیته
کمیتهٔ	کمیته
کمیسیون	کمیسیون
کمیل	کمیل
کمین	کمین
کمیک	کمیک
کن	کن
کنار	کنار
کناره	کناره
کنتاکی	کنتاکی
کنترل	کنترل
کند	کند
کنده	کنده
کندوان	کندوان
کندی	کندی
کنراد	کُنراد
کنس	کنس
کنستانتین	کنستانتین
کنسرت	کنسرت
کنفدراسیون	کنفدراسیون
کنفرانس	کنفرانس
کنند	کنند
کننده	کننده
کنندگان	کنندگان
کنندگی	کنندگی
کنه	کنه
کنوانسیون	کنوانسیون
کنونی	کنونی
کنِّه	کنه
کنّه	کنه
کنکورد	کنکورد
کنگ	کنگ
کنگره	کنگره
کنگرهٔ	کنگره
کنگو	کنگو
کنی	کنی
کنیا	کنیا
کنیز	کنیز
کنیم	کنیم
که	که
کهن	کهن
کهنه	کهنه
کو	کو
کوانتوم	کوانتوم
کوبا	کوبا
کوبانی	کوبانی
کوبیسم	کوبیسم
کوت	کوت
کوتاه	کوتاه
کوتاهی	کوتاهی
کوتوله	کوتوله
کوثر	کوثر
کودتا	کودتا
کودکان	کودکان
کودکی	کودکی
کور	کور
کوره	کوره
کوروش	کوروش
کوری	کوری
کوزوو	کوزوو
کوشی	کوشی
کوفی	کوفی
کول	کول
کومس	کومس
کون	کون
کوه	کوه
کوهدشت	کوهدشت
کوهستان	کوهستان
کوهستانی	کوهستانی
کوهن	کوهن
کوهپایه	کوهپایه
کوهی	کوهی
کوپرنیک	کوپرنیک
کوچ	کوچ
کوچه	کوچه
کوچک	کوچک
کوچکتر	کوچکتر
کوچی	کوچی
کوک	کوک
کوکائین	کوکائین
کوی	کوی
کویت	کویت
کویر	کویر
کوین	کوین
کَته	کته
کَر	کر
کُره	کره
کُل	کل
کِنار	کنار
کِنده	کنده
کپلر	کپلر
کپنهاگ	کپنهاگ
کپّل	کپل
کچه	کچه
کی	کی
کیا	کیا
کیارستمی	کیارستمی
کیان	کیان
کیانگ	کیانگ
کیخسرو	کیخسرو
کیس	کیس
کیسینجر	کیسینجر
کیش	کیش
کیف	کیف
کیفیت	کیفیت
کیلو	کیلو
کیلومتر	کیلومتر
کیلوگرم	کیلوگرم
کیم	کیم
کین	کین
کینه	کینه
کینگ	کینگ
کیهان	کیهان
کیوان	کیوان
کیوتو	کیوتو
کیومرث	کیومرث
کیپ	کیپ
کیکاووس	کیکاووس
گابریل	گابریل
گابن	گابن
گابون	گابون
گارد	گارد
گارسیا	گارسیا
گارفیلد	گارفیلد
گاز	گاز
گازی	گازی
گال	گال
گالش	گالش
گالیسیا	گالیسیا
گالیسیایی	گالیسیایی
گالیله	گالیله
گام	گام
گاما	گاما
گامبی	گامبی
گامبیا	گامبیا
گاندی	گاندی
گانه	گانه
گانّه	گانه
گاه	گاه
گاهشمار	گاهشمار
گاهی	گاهی
گاو	گاو
گت	گت
گته	گته
گتِ	گت
گجرات	گجرات
گذار	گذار
گذاری	گذاری
گذاشت	گذاشت
گذاشته	گذاشته
گذشت	گذشت
گذشته	گذشته
گر	گر
گرا	گرا
گرافیک	گرافیک
گرامر	گرامر
گرانت	گرانت
گراند	گراند
گرانش	گرانش
گراهام	گراهام
گرایان	گرایان
گرایانه	گرایانه
گرایش	گرایش
گرایلی	گرایلی
گرایی	گرایی
گرجستان	گرجستان
گرجی	گرجی
گرد	گرد
گردآوری	گردآوری
گردان	گردان
گردش	گردش
گردشگری	گردشگری
گردن	گردن
گردنه	گردنه
گردنّه	گردنه
گرده	گرده
گردون	گردون
گردید	گردید
گرفت	گرفت
گرفتار	گرفتار
گرفتن	گرفتن
گرفتند	گرفتند
گرفته	گرفته
گرم	گرم
گرما	گرما
گرمایی	گرمایی
گرمدره	گرمدره
گرمسار	گرمسار
گرمی	گرمی
گرنه	گرنه
گره	گره
گرو	گرو
گروه	گروه
گروهِ	گروه
گروهی	گروهی
گروگان	گروگان
گرچه	گرچه
گرگان	گرگان
گرگانی	گرگانی
گرگوری	گرگوری
گری	گری
گرینلند	گرینلند
گریگوری	گریگوری
گریگوریان	گریگوریان
گز	گز
گزارش	گزارش
گزارشگری	گزارشگری
گزلیک	گزلیک
گزنفون	گزنفون
گزنه	گزنه
گسترده	گسترده
گسترش	گسترش
گسیختگی	گسیختگی
گشت	گشت
گفت	گفت
گفتار	گفتار
گفته	گفته
گل	گل
گلادیاتور	گلادیاتور
گلاسکو	گلاسکو
گلدن	گلدن
گلزار	گلزار
گلستان	گلستان
گلشیفته	گلشیفته
گله	گله
گلوله	گلوله
گلوگاه	گلوگاه
گلپایگان	گلپایگان
گلکی	گلکی
گلی	گلی
گمیشان	گمیشان
گناباد	گناباد
گناه	گناه
گنبد	گنبد
گنج	گنج
گنجه	گنجه
گنجوی	گنجوی
گنجینه	گنجینه
گندم	گندم
گندِم	گندم
گنه	گنه
گنّه	گنه
گه	گه
گوآم	گوآم
گواتمالا	گواتمالا
گوارا	گوارا
گوانتانامو	گوانتانامو
گواهی	گواهی
گوته	گوته
گور	گور
گورباچف	گورباچف
گوردون	گوردون
گورکانی	گورکانی
گورکی	گورکی
گوستاو	گوستاو
گوسفند	گوسفند
گوش	گوش
گوشت	گوشت
گوشه	گوشه
گول	گول
گومز	گومز
گون	گون
گوناگون	گوناگون
گوناگونی	گوناگونی
گونه	گونه
گونّه	گونه
گونی	گونی
گوهر	گوهر
گوگل	گوگل
گوی	گوی
گویا	گویا
گویان	گویان
گویش	گویش
گویند	گویند
گویی	گویی
گَت	گت
گَل	گل
گَنّه	گنه
گُل	گل
گِلِکی	گلکی
گِنّه	گنه
گپ	گپ
گچ	گچ
گیاه	گیاه
گیاهان	گیاهان
گیتار	گیتار
گیر	گیر
گیری	گیری
گیسو	گیسو
گیل	گیل
گیلاس	گیلاس
گیلان	گیلان
گیلانشاه	گیلانشاه
گیلانی	گیلانی
گیلکی	گیلکی
گیم	گیم
گینه	گینه
گینهٔ	گینه
گینّه	گینه
گیورگی	گیورگی
گیوم	گیوم
یا	یا
یاد	یاد
یادبود	یادبود
یادگار	یادگار
یادگیری	یادگیری
یار	یار
یاران	یاران
یارشاطر	یارشاطر
یاری	یاری
یازده	یازده
یازدهم	یازدهم
یازدهمین	یازدهمین
یاسر	یاسر
یاغی	یاغی
یافت	یافت
یافتن	یافتن
یافته	یافته
یانگ	یانگ
یاکوتی	یاکوتی
یبوست	یبوست
یثرب	یثرب
یحیی	یحیی
یخ	یخ
یخچال	یخچال
یزد	یزد
یزدانی	یزدانی
یزدگرد	یزدگرد
یزدی	یزدی
یزید	یزید
یشت	یشت
یعقوب	یعقوب
یعنی	یعنی
یغما	یغما
یلتسین	یلتسین
یلدا	یلدا
یله	یله
یمن	یمن
یمنی	یمنی
یمین	یمین
یهود	یهود
یهودی	یهودی
یهودیت	یهودیت
یوآن	یوآن
یواشکی	یواشکی
یوتا	یوتا
یوجین	یوجین
یوحنا	یوحنا
یورش	یورش
یورو	یورو
یورک	یورک
یوری	یوری
یوسف	یوسف
یوشیج	یوشیج
یوفا	یوفا
یوم	یوم
یون	یون
یونان	یونان
یونانِ	یونان
یونانی	یونانی
یونانیان	یونانیان
یونایتد	یونایتد
یونس	یونس
یونسکو	یونسکو
یونگ	یونگ
یوهان	یوهان
یوهانس	یوهانس
یوونتوس	یوونتوس
یوگسلاوی	یوگسلاوی
یک	یک
یکدیگر	یکدیگر
یکشنبه	یکشنبه
یکم	یکم
یکمین	یکمین
یکپارچه	یکپارچه
یکی	یکی
یگان	یگان
یگانه	یگانه
ییل	ییلاو	او