ءِ	ءِ
آ	آ
آئرس	آئرس
آئرش	آئرش
آئرن	آئرن
آئس	آئس
آئل	آئل
آئن	آئن
آئی	آئی
آئے	آئے
آب	آب
آباد	آباد
آبادی	آبادی
آبدار	آبدار
آبرو	آبرو
آبِ	آبِ
آتش	آتش
آتما	آتما
آثار	آثار
آثارِ	آثارِ
آثم	آثم
آج	آج
آحاد	آحاد
آخر	آخر
آخرت	آخرت
آخری	آخری
آخوند	آخوند
آداب	آداب
آدرش	آدرش
آدم	آدم
آذر	آذر
آر	آر
آرا	آرا
آرائش	آرائش
آراستہ	آراستہ
آرام	آرام
آرزو	آرزو
آزاد	آزاد
آزار	آزار
آزمائش	آزمائش
آس	آس
آسا	آسا
آسائش	آسائش
آسان	آسان
آستان	آستان
آسمان	آسمان
آسن	آسن
آشا	آشا
آشرم	آشرم
آشنا	آشنا
آشوب	آشوب
آصف	آصف
آغا	آغا
آغاز	آغاز
آغوش	آغوش
آف	آف
آفاق	آفاق
آفت	آفت
آفتاب	آفتاب
آفس	آفس
آقا	آقا
آل	آل
آلا	آلا
آلات	آلات
آلان	آلان
آلن	آلن
آلو	آلو
آلِ	آلِ
آلہ	آلہ
آم	آم
آمد	آمد
آمر	آمر
آمن	آمن
آمنا	آمنا
آمنہ	آمنہ
آموز	آموز
آن	آن
آنا	آنا
آنر	آنر
آنسو	آنسو
آنلائن	آنلائن
آنند	آنند
آنچل	آنچل
آنگن	آنگن
آواز	آواز
آور	آور
آپ	آپ
آپا	آپا
آچار	آچار
آگ	آگ
آگم	آگم
آیا	آیا
ا	ا
اب	اب
ابا	ابا
ابتدا	ابتدا
ابتداء	ابتداءً
ابتر	ابتر
ابجد	ابجد
ابدال	ابدال
ابر	ابر
ابرار	ابرار
ابرو	ابرو
ابرِ	ابرِ
ابل	ابل
ابلاغ	ابلاغ
ابن	ابن
ابنِ	ابنِ
ابو	ابو
ابوالقاسم	ابوالقاسم
ابوتراب	ابوتراب
ابھی	ابھی
ات	ات
اتا	اتا
اتان	اتان
اتباع	اتباع
اتحاد	اتحاد
اتحاف	اتحاف
اتر	اتر
اترانگ	اترانگ
اتفاق	اتفاق
اتفاقاً	اتفاقاً
اتم	اتم
اثبات	اثبات
اثر	اثر
اثرات	اثرات
اثرانداز	اثرانداز
اثنا	اثنا
اجازت	اجازت
اجاگر	اجاگر
اجتماع	اجتماع
اجر	اجر
اجرت	اجرت
اجل	اجل
اجلاس	اجلاس
اجماع	اجماع
اجمل	اجمل
اجوائن	اجوائن
اجگر	اجگر
احباب	احباب
احبار	احبار
احتجاج	احتجاج
احترام	احترام
احتشام	احتشام
احد	احد
احرار	احرار
احرام	احرام
احساس	احساس
احساسات	احساسات
احسان	احسان
احسن	احسن
احمد	احمد
احمر	احمر
احمق	احمق
احوال	احوال
اخبار	اخبار
اختتام	اختتام
اختر	اختر
اختصار	اختصار
اختلاف	اختلاف
اختناق	اختناق
اختیار	اختیار
اخذ	اخذ
اخر	اخر
اخراج	اخراج
اخلاص	اخلاص
اخلاق	اخلاق
اخوان	اخوان
اخوت	اخوت
ادا	ادا
ادارت	ادارت
اداس	اداس
اداکارہ	اداکارہ
ادب	ادب
ادغام	ادغام
ادل	ادل
اذان	اذان
اذن	اذن
ارب	ارب
ارباب	ارباب
اربع	اربع
اربعین	اربعین
ارتفاق	ارتفاق
ارتقا	ارتقا
ارتقاء	ارتقاء
ارجمند	ارجمند
ارد	ارد
اردو	اردو
ارسطو	ارسطو
ارشاد	ارشاد
ارشد	ارشد
ارض	ارض
ارل	ارل
ارم	ارم
ارمان	ارمان
ارمغان	ارمغانِ
ارواح	ارواح
از	از
ازخود	ازخود
ازل	ازل
ازم	ازم
اس	اس
اساس	اساس
اسباب	اسباب
است	است
استاد	استاد
استثنا	استثنا
استحصال	استحصال
استخراج	استخراج
استدعا	استدعا
استدلال	استدلال
استر	استر
استعداد	استعداد
استعفا	استعفا
استعفیٰ	استعفیٰ
استعمال	استعمال
استغراق	استغراق
استغفار	استغفار
استقامت	استقامت
استقبال	استقبال
استقلال	استقلال
استلام	استلام
استوا	استوا
استوار	استوار
اسد	اسد
اسداللہ	اسداللہ
اسرا	اسرا
اسرار	اسرار
اسراف	اسراف
اسعد	اسعد
اسفند	اسفند
اسلام	اسلام
اسلامزم	اسلامزم
اسلامی	اسلامی
اسلم	اسلم
اسلوب	اسلوب
اسم	اسم
اسماء	اسماء
اسود	اسود
اسپتال	اسپتال
اسپرنگ	اسپرنگ
اسی	اسی
اسے	اسے
اشاعت	اشاعت
اشباع	اشباع
اشتر	اشتر
اشتقاق	اشتقاق
اشد	اشد
اشراف	اشراف
اشرف	اشرف
اشعار	اشعار
اشفاق	اشفاق
اشنان	اشنان
اصحاب	اصحاب
اصرار	اصرار
اصطلاح	اصطلاح
اصغر	اصغر
اصل	اصل
اصلاح	اصلاح
اصلاحات	اصلاحات
اصول	اصول
اضافت	اضافت
اطاعت	اطاعت
اطلاع	اطلاع
اطلاعات	اطلاعات
اطلاق	اطلاق
اعتبار	اعتبار
اعتدال	اعتدال
اعتراض	اعتراض
اعتراف	اعتراف
اعتزاز	اعتزاز
اعتقاد	اعتقاد
اعتماد	اعتماد
اعجاز	اعجاز
اعداد	اعداد
اعراب	اعراب
اعراف	اعراف
اعز	اعز
اعزاز	اعزاز
اعصاب	اعصاب
اعظم	اعظم
اعلان	اعلان
اعلیٰ	اعلیٰ
اعمال	اعمال
اعوان	اعوان
اغوا	اغوا
اف	اف
افتتاح	افتتاح
افتخار	افتخار
افراد	افراد
افراط	افراط
افروز	افروز
افزا	افزا
افزائش	افزائش
افسانہ	افسانہ
افسر	افسر
افسوس	افسوس
افشار	افشار
افضل	افضل
افعال	افعال
افغان	افغان
افق	افق
افلاس	افلاس
افلاطون	افلاطون
اقارب	اقارب
اقامت	اقامت
اقبال	اقبال
اقتباس	اقتباس
اقتدار	اقتدار
اقدار	اقدار
اقدام	اقدام
اقدس	اقدس
اقرار	اقرار
اقرب	اقرب
اقوال	اقوال
اقوام	اقوام
ال	ال
الآخر	الآخر
الا	الا
الاحرار	الاحرار
الاخبار	الاخبار
الاخلاص	الاخلاص
الاخلاق	الاخلاق
الارحام	الارحام
الارض	الارض
الارم	الارم
الاسرار	الاسرار
الاسلام	الاسلام
الاسود	الاسود
الاعظم	الاعظم
الامام	الامام
الامر	الامر
الانسان	الانسان
الانوار	الانوار
الاول	الاول
الب	الب
البتہ	البتّہ
البحر	البحر
البدل	البدل
البلدان	البلدان
البم	البم
التجا	التجا
التمش	التمش
التوبہ	التوبہ
الجامع	الجامع
الجبرا	الجبرا
الجبل	الجبل
الجمال	الجمال
الحاج	الحاج
الحاد	الحاد
الحافظ	الحافظ
الحاق	الحاق
الحال	الحال
الحج	الحج
الحجر	الحجر
الحرام	الحرام
الحروف	الحروف
الحسن	الحسن
الحق	الحق
الحمد	الحمد
الحمرا	الحمرا
الخط	الخط
الخطاب	الخطاب
الدولہ	الدولہ
الدین	الدین
الرحمان	الرحمان
الرحمن	الرحمن
الرحمٰن	الرحمٰن
الرزاق	الرزاق
الزام	الزام
الزمان	الزمان
الست	الست
السلام	السلام
السلطنت	السلطنت
السند	السند
السّلام	السّلام
الشان	الشان
الشعرا	الشعرا
الشفا	الشفا
الصلوات	الصلوات
الصّلوات	الصّلوات
الطارق	الطارق
الطاف	الطاف
الطبع	الطبع
العالم	العالم
العام	العام
العجائب	العجائب
العرب	العرب
العصر	العصر
العلم	العلم
العلوم	العلوم
العمل	العمل
العنان	العنان
العوام	العوام
الف	الف
الفا	الفا
الفاظ	الفاظ
الفت	الفت
الفرائض	الفرائض
الفروض	الفروض
الفضل	الفضل
الفطرت	الفطرت
الفلاح	الفلاح
القاب	القاب
القادر	القادر
القاسم	القاسم
القتل	القتل
القدر	القدر
القدس	القدس
القرآن	القرآن
القلوب	القلوب
القوم	القوم
اللسان	اللسان
اللغات	اللغات
اللفظ	اللفظ
اللّٰہ	اللّٰہ
اللہ	اللہ
الم	الم
الماس	الماس
المال	المال
المثل	المثل
المخلوقات	المخلوقات
المسجد	المسجد
المشائخ	المشائخ
المظفر	المظفر
المقامات	المقامات
المقدس	المقدس
المناظر	المناظر
الموت	الموت
الناس	الناس
النسا	النسا
النساء	النساء
النفس	النفس
النور	النور
الو	الو
الوجود	الوجود
الوداع	الوداع
الور	الور
الوقت	الوقت
الولد	الولد
الک	الک
الگ	الگ
الہ	الہ
ام	ام
امارات	امارات
امارت	امارت
امام	امام
امامت	امامت
امان	امان
امانت	امانت
امبر	امبر
امت	امت
امتحان	امتحان
امتزاج	امتزاج
امجد	امجد
امداد	امداد
امر	امر
امرت	امرت
امروز	امروز
امریکی	امریکی
امل	امل
املتاس	املتاس
امن	امن
امنگ	امنگ
امور	امور
امّ	امّ
امپائر	امپائر
امیر	امیر
ان	ان
انا	انا
اناج	اناج
انار	انار
انبار	انبار
انت	انت
انتخاب	انتخاب
انتخابات	انتخابات
انتساب	انتساب
انتشار	انتشار
انتظار	انتظار
انتظام	انتظام
انتقال	انتقال
انتقام	انتقام
انجا	انجا
انجام	انجام
انجم	انجم
انجمن	انجمن
انجن	انجن
انحراف	انحراف
انحصار	انحصار
انحطاط	انحطاط
اند	اند
انداز	انداز
اندازا	اندازا
اندازاً	اندازاً
اندازِ	اندازِ
اندر	اندر
اندرا	اندرا
اندرون	اندرون
اندلس	اندلس
اندوز	اندوز
انس	انس
انساب	انساب
انسان	انسان
انسداد	انسداد
انشا	انشا
انشاء	انشاء
انشورنس	انشورنس
انصار	انصار
انصاف	انصاف
انضمام	انضمام
انعام	انعام
انعقاد	انعقاد
انفلوئنزا	انفلوئنزا
انقلاب	انقلاب
انناس	انناس
انو	انو
انوار	انوار
انواع	انواع
انور	انور
انوپ	انوپ
انچ	انچ
انچارج	انچارج
انگ	انگ
انگریزی	انگریزی
انگل	انگل
انگلش	انگلش
انگور	انگور
انہوں	اُنہوں
انہیں	اُنہیں
او	او
اوائل	اوائل
اوت	اوت
اوتار	اوتار
اوج	اوج
اور	اور
اورنگ	اورنگ
اوز	اوز
اوزار	اوزار
اوس	اوس
اوست	اوست
اوستا	اوستا
اوسر	اوسر
اوسط	اوسط
اوشا	اوشا
اوقات	اوقات
اوقاف	اوقاف
اول	اول
اولا	اولا
اولاد	اولاد
اولو	اولو
اوم	اوم
اون	اون
اوندھ	اوندھ
اوور	اوور
اوپر	اوپر
اوپرا	اوپرا
اوک	اوک
اَمر	اَمر
اَن	اَن
اَپ	اَپ
اُتان	اُتان
اُتر	اُتر
اُداس	اُداس
اُردو	اُردو
اُس	اُس
اُستاد	اُستاد
اُفق	اُفق
اُم	اُم
اُمت	اُمت
اُمنگ	اُمنگ
اُن	اُن
اِزم	اِزم
اِس	اِس
اِلا	اِلا
اِن	اِن
اِنسان	اِنسان
اِک	اِک
اپ	اپ
اپت	اپت
اپر	اپر
اپریل	اپریل
اپسرا	اپسرا
اپنا	اپنا
اپنی	اپنی
اپنے	اپنے
اچار	اچار
اچرج	اچرج
اچل	اچل
اک	اک
اکا	اکا
اکتوبر	اکتوبر
اکل	اکل
اگر	اگر
اگروال	اگروال
اگست	اگست
اگھم	اگھم
اہم	اہم
ای	ای
ایس	ایس
ایسے	ایسے
ایف	ایف
ایم	ایم
این	این
ایٹمی	ایٹمی
ایک	ایک
اے	اے
ب	ب
با	با
بائبل	بائبل
بائرن	بائرن
باب	باب
بابا	بابا
بابت	بابت
بابر	بابر
بابل	بابل
بابن	بابن
بابو	بابو
بات	بات
باجا	باجا
باختر	باختر
باد	باد
بادام	بادام
بادشاہ	بادشاہ
بادل	بادل
بار	بار
باران	باران
بارش	بارش
بارن	بارن
بارو	بارو
بارود	بارود
باز	باز
بازار	بازار
بازارن	بازارن
بازو	بازو
باس	باس
باشد	باشد
باشندو	باشندو
باضابطہ	باضابطہ
باطل	باطل
باطن	باطن
باعث	باعث
باغ	باغ
باغبان	باغبان
باقاعدہ	باقاعدہ
باقر	باقر
بال	بال
بالآخر	بالآخر
بالا	بالا
بالاتر	بالاتر
بالاتفاق	بالاتفاق
بالادست	بالادست
بالخصوص	بالخصوص
بالر	بالر
بالغ	بالغ
بالن	بالن
بالو	بالو
بالواسطہ	بالواسطہ
بام	بام
بان	بان
باندا	باندا
باندر	باندر
بانس	بانس
بانو	بانو
بانگ	بانگ
باوجود	باوجود
باپ	باپ
باچا	باچا
باک	باک
باکسنگ	باکسنگ
ببر	ببر
بت	بت
بتول	بتول
بجا	بجا
بجار	بجار
بحال	بحال
بحالی	بحالی
بحث	بحث
بحر	بحر
بحران	بحران
بحری	بحری
بحق	بحق
بخار	بخار
بخارا	بخارا
بخت	بخت
بختر	بختر
بخش	بخش
بخشش	بخشش
بخل	بخل
بخلاف	بخلاف
بخود	بخود
بد	بد
بداخلاق	بَداَخْلاق
بدبخت	بدبخت
بدبودار	بَدبُودار
بدتر	بَدتَر
بدر	بدر
بدستور	بدستور
بدصورت	بدصورت
بدعت	بدعت
بدل	بدل
بدمعاش	بدمعاش
بدن	بدن
بدنام	بدنام
بدو	بدو
بدوش	بدوش
بدولت	بدولت
بدھ	بدھ
بذات	بذات
بر	بر
برآمد	برآمد
برا	برا
برابر	برابر
برات	برات
براج	براج
برادر	برادر
برار	برار
براس	براس
براق	براق
برانچ	برانچ
برباد	برباد
بربر	بربر
بربط	بربط
برتر	برتر
برتن	برتن
برج	برج
برجن	برجن
برحق	برحق
برخوردار	برخوردار
برد	برد
بردار	بردار
برداشت	برداشت
بردبار	بردبار
برزخ	برزخ
برسات	برسات
برسر	برسر
برش	برش
برطانوی	برطانوی
برطانیہ	برطانیہ
برطرف	برطرف
برف	برف
برق	برق
برقرار	برقرار
برلا	برلا
برلاس	برلاس
برلن	برلن
برما	برما
برملا	برملا
برمن	برمن
برن	برن
برو	برو
بروز	بروز
برپا	برپا
برک	برک
برکا	برکا
برگ	برگ
برہ	برہ
بزرگ	بزرگ
بزم	بزم
بزمِ	بزمِ
بزنس	بزنس
بس	بس
بسا	بسا
بسال	بسال
بسبب	بسبب
بست	بست
بستر	بستر
بسترا	بسترا
بسر	بسر
بسم	بسم
بسمل	بسمل
بسنت	بسنت
بشارت	بشارت
بشر	بشر
بشپ	بشپ
بصر	بصر
بطن	بطن
بطور	بطور
بعث	بعث
بعثت	بعثت
بعد	بعد
بعدالموت	بعدالموت
بعض	بعض
بعل	بعل
بغاوت	بغاوت
بغداد	بغداد
بغض	بغض
بغل	بغل
بقا	بقا
بقول	بقول
بل	بل
بلا	بلا
بلاد	بلاد
بلاغت	بلاغت
بلال	بلال
بلاول	بلاول
بلب	بلب
بلبل	بلبل
بلحاظ	بلحاظ
بلغم	بلغم
بلند	بلند
بلور	بلور
بلوط	بلوط
بلوغت	بلوغت
بلوچ	بلوچ
بم	بم
بمبار	بمبار
بمطابق	بمطابق
بن	بن
بنا	بنا
بنارس	بنارس
بنام	بنام
بنت	بنت
بنجر	بنجر
بند	بند
بندا	بندا
بندر	بندر
بندرگاہ	بندرگاہ
بندش	بندش
بندن	بندن
بندو	بندو
بندوبست	بندوبست
بندوق	بندوق
بندہ	بندہ
بنسبت	بنسبت
بنو	بنو
بنگ	بنگ
بنگال	بنگال
بنگلا	بنگلا
بنگلہ	بنگلہ
بنیاد	بنیاد
بو	بو
بوتل	بوتل
بود	بود
بور	بور
بورا	بورا
بوس	بوس
بوستان	بوستان
بوقت	بوقتِ
بول	بول
بولا	بولا
بولر	بولر
بوم	بوم
بونا	بونا
بوند	بوند
بُت	بُت
بُخار	بُخار
بُلبُل	بُلبُل
بُک	بُک
بِل	بِل
بِنا	بِنا
بِہ	بِہ
بِیچ	بِیچ
بچا	بچا
بچت	بچت
بچل	بچل
بچن	بچن
بچو	بچو
بچپن	بچپن
بڑا	بڑا
بڑی	بڑی
بڑے	بڑے
بک	بک
بکر	بکر
بگ	بگ
بھار	بھار
بھارت	بھارت
بھرپور	بھرپور
بھلے	بھلے
بھی	بھی
بہ	بہ
بہت	بہت
بی	بی
بیان	بیان
بیداری	بیداری
بین	بین
بے	بے
ت	ت
تا	تا
تائب	تائب
تاب	تاب
تابع	تابع
تابوت	تابوت
تاتار	تاتار
تاثر	تاثر
تاج	تاج
تاجر	تاجر
تاحال	تاحال
تار	تار
تارا	تارا
تاراج	تاراج
تارن	تارن
تارو	تارو
تاریخ	تاریخ
تاس	تاس
تاش	تاش
تاشقند	تاشقند
تال	تال
تالا	تالا
تالو	تالو
تام	تام
تامل	تامل
تان	تان
تانگ	تانگ
تبت	تبت
تبدیل	تبدیل
تبسم	تبسم
تبو	تبو
تت	تت
تتبع	تتبع
تتر	تتر
تتو	تتو
تجارت	تجارت
تجسس	تجسس
تجمل	تجمل
تحت	تحت
تحصیل	تحصیل
تحفظ	تحفظ
تحفہ	تحفہ
تحمل	تحمل
تخت	تخت
تخلص	تخلص
تخم	تخم
تدبر	تدبر
تدمر	تدمر
تر	تر
ترا	ترا
تراب	تراب
تراش	تراش
تربت	تربت
ترت	ترت
ترجمان	ترجمان
ترخان	ترخان
ترس	ترس
ترش	ترش
ترم	ترم
ترمذی	ترمذی
ترن	ترن
ترنج	ترنج
ترنم	ترنم
ترنگ	ترنگ
ترو	ترو
ترین	ترین
تسلسل	تسلسل
تسلط	تسلط
تشخص	تشخص
تشدد	تشدد
تصادم	تصادم
تصرف	تصرف
تصنع	تصنع
تصور	تصور
تصورات	تصورات
تصوف	تصوف
تصویر	تصویر
تضاد	تضاد
تعارف	تعارف
تعاقب	تعاقب
تعالیٰ	تعالیٰ
تعاون	تعاون
تعجب	تعجب
تعداد	تعداد
تعریف	تعریف
تعصب	تعصب
تعلق	تعلق
تعلقات	تعلقات
تعلقہ	تعلقہ
تعلیم	تعلیم
تعمیر	تعمیر
تغزل	تغزل
تغییر	تغییر
تفاوت	تفاوت
تقاضا	تقاضا
تقدس	تقدس
تقریباً	تقریباً
تقسیم	تقسیم
تل	تل
تلاش	تلاش
تلاوت	تلاوت
تلخ	تلخ
تلف	تلف
تلفظ	تلفظ
تلمود	تلمود
تلنگ	تلنگ
تلوار	تلوار
تلور	تلور
تلہ	تلہ
تم	تم
تماشا	تماشا
تمام	تمام
تمتع	تمتع
تمدن	تمدن
تمر	تمر
تمغا	تمغا
تمن	تمن
تمنا	تمنا
تن	تن
تناسب	تناسب
تناسخ	تناسخ
تناظر	تناظر
تنبو	تنبو
تنت	تنت
تند	تند
تندرست	تندرست
تندور	تندور
تنزل	تنزل
تنور	تنور
تنگ	تنگ
تو	تو
توازن	توازن
توان	توان
توب	توب
توت	توت
توجہ	توجہ
تورات	تورات
توسط	توسط
توقع	توقع
تولد	تولد
تولن	تولن
تون	تون
توپ	توپ
تَر	تَر
تَہ	تَہ
تُم	تُم
تِرے	تِرے
تپ	تپ
تپا	تپا
تپش	تپش
تک	تک
تکا	تکا
تھا	تھا
تھن	تھن
تھے	تھے
تہ	تہ
تیرا	تیرا
تیل	تیل
تین	تین
ثابت	ثابت
ثاقب	ثاقب
ثالث	ثالث
ثبوت	ثبوت
ثقافت	ثقافت
ثقل	ثقل
ثلث	ثلث
ثم	ثم
ثمر	ثمر
ثنا	ثنا
ثواب	ثواب
ثور	ثور
ج	ج
جا	جا
جائداد	جائداد
جائز	جائز
جائے	جائے
جاب	جاب
جابر	جابر
جات	جات
جاتا	جاتا
جاترا	جاترا
جاتی	جاتی
جادو	جادو
جادوگر	جادوگر
جاذب	جاذب
جار	جار
جاری	جاری
جاسوس	جاسوس
جال	جال
جالب	جالب
جام	جام
جامد	جامد
جامع	جامع
جامعہ	جامعہ
جان	جان
جانب	جانب
جانباز	جانبازِ
جانبدار	جانبدار
جاندار	جاندار
جانسن	جانسن
جانور	جانور
جانِ	جانِ
جانچ	جانچ
جاوا	جاوا
جاپان	جاپان
جب	جب
جبار	جبار
جبر	جبر
جبل	جبل
جبلت	جبلت
جت	جت
جتن	جتن
جج	جج
جد	جد
جدا	جدا
جداجدا	جداجدا
جداگانہ	جداگانہ
جدت	جدت
جدول	جدول
جدید	جدید
جذام	جذام
جذب	جذب
جذبا	جذبا
جذبات	جذبات
جر	جر
جرات	جرات
جراح	جراح
جراحت	جراحت
جرار	جرار
جرح	جرح
جرم	جرم
جرمن	جرمن
جز	جز
جزا	جزا
جزائر	جزائر
جزو	جزو
جس	جس
جسامت	جسامت
جست	جست
جستجو	جستجو
جسد	جسد
جسم	جسم
جسونت	جسونت
جسے	جسے
جشن	جشن
جعفر	جعفر
جغرافیہ	جغرافیہ
جل	جل
جلا	جلا
جلاب	جلاب
جلاد	جلاد
جلال	جلال
جلد	جلد
جلن	جلن
جلوس	جلوس
جم	جم
جماد	جماد
جمار	جمار
جماع	جماع
جماعت	جماعت
جمال	جمال
جمع	جمع
جمعدار	جمعدار
جمعیت	جمعیت
جمل	جمل
جمن	جمن
جمود	جمود
جن	جن
جناب	جناب
جنابت	جنابت
جنات	جنات
جناح	جناح
جنب	جنب
جنبش	جنبش
جنت	جنت
جنتا	جنتا
جنتر	جنتر
جند	جند
جنرل	جنرل
جنس	جنس
جنم	جنم
جنوب	جنوب
جنوبی	جنوبی
جنوری	جنوری
جنون	جنون
جنگ	جنگ
جنگل	جنگل
جو	جو
جواب	جواب
جواد	جواد
جوار	جوار
جواز	جواز
جوالا	جوالا
جوان	جوان
جوت	جوت
جوتا	جوتا
جوس	جوس
جوش	جوش
جول	جول
جون	جون
جونا	جونا
جَر	جَر
جَن	جَن
جَون	جَون
جُدا	جُدا
جُنون	جُنون
جُو	جُو
جُون	جُون
جِس	جِس
جِن	جِن
جپ	جپ
جپسم	جپسم
جگ	جگ
جگر	جگر
جگن	جگن
جھل	جھل
جھلم	جھلم
جھمر	جھمر
جھول	جھول
جھولا	جھولا
جھونا	جھونا
جہ	جہ
جہاں	جہاں
جی	جی
ح	ح
حائل	حائل
حاتم	حاتم
حاجب	حاجب
حاجت	حاجت
حاذق	حاذق
حارث	حارث
حاسد	حاسد
حاصل	حاصل
حاضر	حاضر
حافظ	حافظ
حال	حال
حالات	حالات
حالت	حالت
حامد	حامد
حامل	حامل
حب	حب
حبش	حبش
حج	حج
حجاب	حجاب
حجاج	حُجّاج
حجاز	حجاز
حجام	حجام
حجت	حجت
حجر	حجر
حجم	حجم
حد	حد
حداد	حداد
حدث	حدث
حدود	حدود
حدیث	حدیث
حذف	حذف
حر	حر
حرا	حرا
حرارت	حرارت
حراست	حراست
حرام	حرام
حرب	حرب
حربا	حربا
حرج	حرج
حرص	حرص
حرف	حرف
حرفت	حرفت
حرم	حرم
حرمت	حرمت
حروف	حروف
حزب	حزب
حس	حس
حساب	حساب
حسابِ	حسابِ
حساس	حساس
حسام	حسام
حسان	حسان
حسب	حسب
حسد	حسد
حسرت	حسرت
حسن	حسن
حسنِ	حسنِ
حسین	حسین
حشر	حشر
حشرات	حشرات
حشمت	حشمت
حشو	حشو
حصا	حصا
حصار	حصار
حصن	حصن
حصول	حصول
حضر	حضر
حضرات	حضرات
حضرت	حضرت
حضور	حضور
حفاظت	حفاظت
حفص	حفص
حفظ	حفظ
حق	حق
حقائق	حقائق
حقارت	حقارت
حقن	حقن
حقوق	حقوق
حل	حل
حلاج	حلاج
حلال	حلال
حلب	حلب
حلف	حلف
حلم	حلم
حمام	حمام
حمد	حمد
حمزہ	حمزہ
حمل	حمل
حملہ	حملہ
حمود	حمود
حنا	حنا
حوا	حوا
حواس	حواس
حوالا	حوالا
حوت	حوت
حور	حور
حوض	حوض
حَق	حَق
حُب	حُب
حُر	حُر
حُسن	حُسن
حِس	حِس
حکومت	حکومت
حیثیت	حیثیت
حیدر	حیدر
خ	خ
خائف	خائف
خاتون	خاتون
خادم	خادم
خار	خار
خارج	خارج
خارجہ	خارجہ
خاردار	خاردار
خارش	خارش
خاص	خاص
خاصیت	خاصیت
خاطر	خاطر
خاقان	خاقان
خال	خال
خالد	خالد
خالص	خالص
خالصتان	خالصتان
خالق	خالق
خام	خام
خاموش	خاموش
خان	خان
خاندان	خاندان
خانقاہ	خانقاہ
خانم	خانم
خانہ	خانہ
خاوند	خاوند
خبر	خبر
خبردار	خبردار
ختم	ختم
خدا	خدا
خداداد	خداداد
خداوند	خداوند
خدمت	خدمت
خراب	خراب
خراج	خراج
خرار	خرار
خراسان	خراسان
خراش	خراش
خرد	خرد
خرم	خرم
خروج	خروج
خروس	خروس
خروش	خروش
خرچ	خرچ
خرگوش	خرگوش
خرید	خرید
خزانہ	خزانہ
خس	خس
خسرو	خسرو
خصلت	خصلت
خصوصاً	خصوصاً
خصوصیت	خصوصیت
خضر	خضر
خط	خط
خطا	خطا
خطاب	خطاب
خطابت	خطابت
خطاط	خطاط
خطبات	خطبات
خطِ	خطِ
خفاف	خفاف
خفت	خفت
خلا	خلا
خلاف	خلاف
خلافت	خلافت
خلط	خلط
خلعت	خلعت
خلف	خلف
خلق	خلق
خلقت	خلقت
خلل	خلل
خلوت	خلوت
خلوص	خلوص
خم	خم
خمار	خمار
خمس	خمس
خناق	خناق
خنجر	خنجر
خندق	خندق
خواب	خواب
خواجہ	خواجہ
خوار	خوار
خوارزم	خوارزم
خواص	خواص
خوان	خوان
خوب	خوب
خود	خود
خودبخود	خودبخود
خودمختار	خودمختار
خور	خور
خورد	خورد
خوش	خوش
خوشاب	خوشاب
خوشامد	خوشامد
خوشبو	خوشبو
خوشبودار	خوشبودار
خوف	خوف
خول	خول
خون	خون
خونخوار	خونخوار
خُدا	خُدا
خچر	خچر
خیال	خیال
خیبر	خیبر
د	د
داؤد	داؤد
دائم	دائم
داتا	داتا
داخل	داخل
داد	داد
دادا	دادا
دادن	دادن
دادو	دادو
دار	دار
دارالاشاعت	دارالاشاعت
دارالامان	دارالامان
دارالبقا	دارالبقا
دارالعلوم	دارالعلوم
دارو	دارو
داس	داس
داستان	داستان
داستانِ	داستانِ
داشت	داشت
داغ	داغ
دافع	دافع
دال	دال
دالان	دالان
دام	دام
دامن	دامن
دان	دان
دانا	دانا
دانش	دانش
داور	داور
دت	دت
دتا	دتا
دختر	دختر
دخل	دخل
در	در
درآمد	درآمد
درا	درا
دراز	دراز
دربار	دربار
دربان	دربان
درج	درج
درجن	درجن
درجہ	درجہ
درخت	درخت
درخواست	درخواست
درد	درد
درس	درس
درست	درست
درسن	درسن
درشن	درشن
درو	درو
درون	درون
درگا	درگا
درگذر	درگذر
درگزر	درگزر
دریا	دریا
دریافت	دریافت
دز	دز
دس	دس
دست	دست
دستا	دستا
دستار	دستار
دستاویزات	دستاویزات
دستبردار	دستبردار
دستخط	دستخط
دسترخوان	دسترخوان
دسترس	دسترس
دستور	دستور
دستِ	دستِ
دسمبر	دسمبر
دشت	دشت
دشمن	دشمن
دعا	دعا
دعوت	دعوت
دعویٰ	دعویٰ
دغا	دغا
دفاع	دفاع
دفتر	دفتر
دفع	دفع
دفن	دفن
دق	دق
دقت	دقت
دل	دل
دلا	دلا
دلائل	دلائل
دلال	دلال
دلالت	دلالت
دلان	دلانِ
دلاور	دلاور
دلبر	دلبر
دلت	دلت
دلدار	دلدار
دلدل	دلدل
دلربا	دلربا
دلو	دلو
دم	دم
دماغ	دماغ
دن	دن
دنگ	دنگ
دنگل	دنگل
دنیا	دنیا
دو	دو
دوا	دوا
دوار	دوار
دوام	دوام
دوبارا	دوبارا
دور	دور
دوران	دوران
دورِ	دورِ
دوز	دوز
دوزخ	دوزخ
دوست	دوست
دوش	دوش
دولت	دولت
دوم	دوم
دونوں	دونوں
دَل	دَل
دَور	دَور
دُر	دُر
دُشمن	دُشمن
دُعا	دُعا
دُور	دُور
دِل	دِل
دِن	دِن
دک	دک
دکا	دکا
دکن	دکن
دھل	دھل
دھن	دھن
دھنک	دھنک
دی	دی
دیا	دیا
دین	دین
دیکھ	دیکھ
دیکھنے	دیکھنے
دیگر	دیگر
دے	دے
ذات	ذات
ذاتِ	ذاتِ
ذبح	ذبح
ذرا	ذرا
ذرائع	ذرائع
ذریعے	ذریعے
ذلت	ذلت
ذو	ذو
ذوالحج	ذوالحج
ذوالفقار	ذوالفقار
ذوالنون	ذوالنون
ذوق	ذوق
ذکر	ذکر
ذھن	ذھن
ر	ر
را	را
راؤ	راؤ
رائج	رائج
رائس	رائس
رائل	رائل
رائن	رائن
رابع	رابع
رابن	رابن
رات	رات
راج	راج
راجا	راجا
راجن	راجن
راجپوت	راجپوت
راحت	راحت
راز	راز
راس	راس
راست	راست
راسخ	راسخ
راشد	راشد
راشن	راشن
راغب	راغب
رافع	رافع
راقم	راقم
رام	رام
رامن	رامن
رامپور	رامپور
ران	ران
رانا	رانا
رانجھا	رانجھا
راول	راول
راون	راون
راک	راک
راہ	راہ
رب	رب
ربا	ربا
رباب	رباب
رباط	رباط
ربط	ربط
ربن	ربن
رت	رت
رتا	رتا
رتن	رتن
رجا	رجا
رجب	رجب
رجحان	رجحان
رجحانات	رجحانات
رجز	رجز
رجعت	رجعت
رجوع	رجوع
رح	رح
رحلت	رحلت
رحم	رحم
رحمان	رحمان
رحمت	رحمت
رخ	رخ
رخا	رخا
رخصت	رخصت
رخو	رخو
رد	رد
ردعمل	ردعمل
ردم	ردم
ردِ	ردِ
رزاق	رزاق
رزرو	رزرو
رزق	رزق
رس	رس
رسا	رسا
رسائل	رسائل
رسالا	رسالا
رسالت	رسالت
رسالدار	رسالدار
رستا	رستا
رستم	رستم
رسد	رسد
رسل	رسل
رسم	رسم
رسن	رسن
رسوخ	رسوخ
رسول	رسول
رش	رش
رشحات	رشحات
رشد	رشد
رشوت	رشوت
رضا	رضا
رضوان	رضوان
رطوبت	رطوبت
رع	رع
رعب	رعب
رغبت	رغبت
رفاقت	رفاقت
رفت	رفت
رفتار	رفتار
رفع	رفع
رقابت	رقابت
رقاص	رقاص
رقاصہ	رقاصہ
رقص	رقص
رقم	رقم
رقمطراز	رقمطراز
رم	رم
رمز	رمز
رمضان	رمضان
رمل	رمل
رموز	رموز
رن	رن
رنج	رنج
رند	رند
رنگ	رنگ
رنگا	رنگا
رنگت	رنگت
رنگو	رنگو
رو	رو
روئداد	روئداد
روا	روا
رواج	رواج
رواق	رواق
روان	روان
روانا	روانا
روایت	روایت
روبرو	رُوبرو
روبل	روبل
روح	روح
رود	رود
روز	روز
روزانہ	روزانہ
روزن	روزن
روزگار	روزگار
روزہ	روزہ
روس	روس
روش	روش
روشن	روشن
روشناس	روشناس
روشندان	روشندان
روشنی	روشنی
روغن	روغن
رول	رول
رولا	رولا
رولنگ	رولنگ
روم	روم
رومال	رومال
رومان	رومان
رومانس	رومانس
رومن	رومن
رونا	رونا
روند	روند
رونق	رونق
رونما	رونما
روپ	روپ
روپا	روپا
روپوش	روپوش
روگ	روگ
رَت	رَت
رَس	رَس
رُت	رُت
رُخ	رُخ
رُوح	رُوح
رُوپ	رُوپ
رچنا	رچنا
رک	رک
رکا	رُکا
رکان	رکان
رکب	رکب
رکما	رکما
رکن	رکن
رکھ	رکھ
رکھا	رکھا
رگ	رگ
رہ	رہ
رہا	رہا
رہنمائی	رہنمائی
رہی	رہی
رہے	رہے
ریاست	ریاست
ریاض	ریاض
ریسرچ	ریسرچ
ریچھ	ریچھ
ز	ز
زائد	زائد
زائر	زائر
زابل	زابل
زاد	زاد
زار	زار
زال	زال
زان	زان
زبان	زبان
زبر	زبر
زبردست	زبردست
زبور	زبور
زبون	زبون
زحل	زحل
زخم	زخم
زد	زد
زر	زر
زراعت	زراعت
زرد	زرد
زردشت	زردشت
زرقا	زرقا
زرگر	زرگر
زعفران	زعفران
زلال	زلال
زلف	زلف
زمان	زمان
زمانہ	زمانہ
زمرد	زمرد
زمزم	زمزم
زمین	زمین
زن	زن
زنا	زنا
زنبق	زنبق
زند	زند
زندان	زندان
زندگی	زندگی
زندہ	زندہ
زنگ	زنگ
زوار	زوار
زوال	زوال
زور	زور
زوردار	زوردار
زون	زون
زپ	زپ
زیاد	زیاد
زیادہ	زیادہ
زیر	زیر
س	س
سا	سا
سائبان	سائبان
سائر	سائر
سائز	سائز
سائل	سائل
سائن	سائن
سائنس	سائنس
سابق	سابق
سات	سات
ساتھ	ساتھ
ساجد	ساجد
ساجن	ساجن
ساحر	ساحر
ساحل	ساحل
ساخت	ساخت
سادا	سادا
سادہ	سادہ
سار	سار
سارا	سارا
سارس	سارس
سارنگ	سارنگ
ساز	ساز
سازش	سازش
ساعت	ساعت
ساغر	ساغر
ساقط	ساقط
سال	سال
سالا	سالا
سالار	سالار
سالانہ	سالانہ
سالم	سالم
سالن	سالن
سالو	سالو
سام	سام
سامان	سامان
سامراج	سامراج
سان	سان
سانگ	سانگ
ساون	ساون
ساک	ساک
ساگر	ساگر
سب	سب
سبب	سبب
سبحان	سبحان
سبز	سبز
سبق	سبق
ست	ست
ستار	ستار
ستارا	ستارا
ستان	ستان
ستر	ستر
ستم	ستم
ستمگر	ستمگر
ستون	ستون
سج	سج
سجاد	سجاد
سجع	سجع
سجن	سجن
سحر	سحر
سخاوت	سخاوت
سخت	سخت
سخن	سخن
سد	سد
سدا	سدا
سر	سر
سرا	سرا
سراج	سراج
سراسر	سراسر
سراغ	سراغ
سرانجام	سرانجام
سراپا	سراپا
سربراہ	سربراہ
سرجن	سرجن
سرحد	سرحد
سرخ	سرخ
سرد	سرد
سردار	سردار
سرس	سرس
سرسام	سرسام
سرسبز	سرسبز
سرشار	سرشار
سرطان	سرطان
سرفراز	سرفراز
سرفروش	سرفروش
سرمد	سرمد
سرمست	سرمست
سرنج	سرنج
سرنگ	سرنگ
سرو	سرو
سرود	سرود
سرور	سرور
سرورق	سرورق
سروس	سروس
سروپ	سروپ
سرِ	سرِ
سرچ	سرچ
سرگذشت	سرگذشت
سرگرم	سرگرم
سرگزشت	سرگزشت
سرگم	سرگم
سری	سری
سزا	سزا
سزاوار	سزاوار
سست	سست
سستا	سستا
سطح	سطح
سعادت	سعادت
سعد	سعد
سعود	سعود
سفارت	سفارت
سفارش	سفارش
سفر	سفر
سفوف	سفوف
سقراط	سقراط
سقوط	سقوط
سل	سل
سلا	سلا
سلاد	سلاد
سلاست	سلاست
سلام	سلام
سلامت	سلامت
سلامتی	سلامتی
سلسلہ	سلسلہ
سلطان	سلطان
سلطنت	سلطنت
سلف	سلف
سلفر	سلفر
سلم	سلم
سلمان	سلمان
سلمیٰ	سلمیٰ
سلو	سلو
سلور	سلور
سم	سم
سما	سما
سماج	سماج
سماع	سماع
سماعت	سماعت
سماچار	سماچار
سمجھ	سمجھ
سمرقند	سمرقند
سمن	سمن
سمند	سمند
سمندر	سمندر
سمگل	سمگل
سمگلنگ	سمگلنگ
سمیت	سمیت
سن	سن
سنا	سنا
سنان	سنان
سنبل	سنبل
سنت	سنت
سنتوش	سنتوش
سنج	سنج
سنجر	سنجر
سند	سند
سندا	سندا
سندر	سندر
سندس	سندس
سندھ	سندھ
سنس	سنس
سنسار	سنسار
سنسان	سنسان
سنوار	سنوار
سنون	سنون
سنگ	سنگ
سنگت	سنگت
سنگلاخ	سنگلاخ
سنگم	سنگم
سنگِ	سنگِ
سنگھ	سنگھ
سنگھار	سنگھار
سنہ	سنہ
سو	سو
سوء	سوء
سوئمبر	سوئمبر
سوئمنگ	سوئمنگ
سوا	سوا
سواد	سواد
سوار	سوار
سوال	سوال
سوانح	سوانح
سود	سود
سودا	سودا
سوداگر	سوداگر
سودہ	سودہ
سور	سور
سوراج	سوراج
سوراخ	سوراخ
سورت	سورت
سورج	سورج
سورس	سورس
سورما	سورما
سورنجان	سورنجان
سورہ	سورہ
سوز	سوز
سوزش	سوزش
سوس	سوس
سوسن	سوسن
سوشل	سوشل
سوشلزم	سوشلزم
سوغات	سوغات
سول	سول
سولجر	سولجر
سوم	سوم
سوما	سوما
سون	سون
سونا	سونا
سوپ	سوپ
سوچ	سوچ
سَت	سَت
سَر	سَر
سَن	سَن
سَنَد	سَنَد
سَو	سَو
سُخن	سُخن
سُر	سُر
سُرخ	سُرخ
سُور	سُور
سُک	سُک
سِر	سِر
سِک	سِک
سپاس	سپاس
سپر	سپر
سپرد	سپرد
سپنا	سپنا
سپوت	سپوت
سپون	سپون
سپہ	سپہ
سچ	سچ
سچا	سچا
سچل	سچل
سک	سک
سکتا	سکتا
سکر	سکر
سکھ	سکھ
سگا	سگا
سگار	سگار
سگنل	سگنل
سی	سی
سیاست	سیاست
سیاہ	سیاہ
سید	سید
سین	سین
سے	سے
شائع	شائع
شائق	شائق
شاخ	شاخ
شاد	شاد
شاداب	شاداب
شادمان	شادمان
شادی	شادی
شارح	شارح
شارع	شارع
شاستر	شاستر
شاعر	شاعر
شال	شال
شالا	شالا
شام	شام
شامت	شامت
شامل	شامل
شان	شان
شانت	شانت
شاپ	شاپ
شاگرد	شاگرد
شاہ	شاہ
شب	شب
شباب	شباب
شبد	شبد
شبنم	شبنم
شتر	شتر
شجاع	شجاع
شجاعت	شجاعت
شخص	شخص
شخصیت	شخصیت
شد	شد
شداد	شداد
شدت	شدت
شدھ	شدھ
شدہ	شدہ
شر	شر
شراب	شراب
شرارت	شرارت
شرافت	شرافت
شربت	شربت
شرح	شرح
شرر	شرر
شرط	شرط
شرع	شرع
شرف	شرف
شرم	شرم
شرمسار	شرمسار
شروع	شروع
شروعات	شروعات
شریف	شریف
شش	شش
ششم	ششم
شطرنج	شطرنج
شعار	شعار
شعاع	شعاع
شعب	شعب
شعبان	شعبان
شعبہ	شعبہ
شعر	شعر
شعری	شعری
شعور	شعور
شغف	شغف
شغل	شغل
شفا	شفا
شفاعت	شفاعت
شفاف	شفاف
شفق	شفق
شفقت	شفقت
شق	شق
شل	شل
شلنگ	شلنگ
شلوار	شلوار
شمار	شمار
شمال	شمال
شمر	شمر
شمس	شمس
شمشاد	شمشاد
شمع	شمع
شنا	شنا
شناخت	شناخت
شناس	شناس
شو	شو
شوال	شوال
شوخ	شوخ
شودر	شودر
شور	شور
شورش	شورش
شورو	شورو
شوق	شوق
شُمار	شُمار
شِو	شِو
شپ	شپ
شکست	شکست
شگاف	شگاف
شگن	شگن
شہر	شہر
شیعہ	شیعہ
صائب	صائب
صابر	صابر
صاحب	صاحب
صاحبان	صاحبان
صاحبِ	صاحبِ
صادر	صادر
صادق	صادق
صارف	صارف
صاف	صاف
صالح	صالح
صبا	صبا
صباح	صباحِ
صبح	صبح
صبر	صبر
صحاح	صحاح
صحافت	صحافت
صحبت	صحبت
صحت	صحت
صحرا	صحرا
صحن	صحن
صد	صد
صدا	صدا
صدارت	صدارت
صدارتی	صدارتی
صداقت	صداقت
صدر	صدر
صدف	صدف
صدی	صدی
صراحت	صراحت
صراط	صراط
صراف	صراف
صرف	صرف
صف	صف
صفا	صفا
صفات	صفات
صفت	صفت
صفحہ	صفحہ
صفدر	صفدر
صفر	صفر
صفرا	صفرا
صلاح	صلاح
صلح	صلح
صلی	صلی
صنائع	صنائع
صندل	صندل
صندوق	صندوق
صنعت	صنعت
صنف	صنف
صنم	صنم
صنوبر	صنوبر
صوت	صوت
صور	صور
صورت	صورت
صوم	صوم
صُبح	صُبح
ضائع	ضائع
ضامن	ضامن
ضبط	ضبط
ضخامت	ضخامت
ضد	ضد
ضراب	ضراب
ضرار	ضرار
ضرب	ضرب
ضرر	ضرر
ضرور	ضرور
ضرورت	ضرورت
ضروری	ضروری
ضعف	ضعف
ضلع	ضلع
ضم	ضم
ضماد	ضماد
ضمانت	ضمانت
ضمن	ضمن
ط	ط
طائف	طائف
طارق	طارق
طاس	طاس
طاق	طاق
طاقت	طاقت
طالب	طالب
طالبان	طالبان
طب	طب
طبابت	طبابت
طباعت	طباعت
طبع	طبع
طبقا	طبقا
طبقات	طبقات
طبل	طبل
طبیعیات	طبیعیات
طراز	طراز
طرح	طرح
طرز	طرز
طرزِ	طرزِ
طرف	طرف
طرفا	طرفا
طعام	طعام
طغرل	طغرل
طلاق	طلاق
طلب	طلب
طلبگار	طلبگار
طلسم	طلسم
طلعت	طلعت
طلوع	طلوع
طمع	طمع
طنز	طنز
طوائف	طوائف
طواف	طواف
طور	طور
طوس	طوس
طوطا	طوطا
طوطل	طوطل
طوفان	طوفان
طوق	طوق
طول	طول
ظ	ظ
ظالم	ظالم
ظرافت	ظرافت
ظرف	ظرف
ظفر	ظفر
ظلم	ظلم
ظلمت	ظلمت
عائد	عائد
عائشہ	عائشہ
عابد	عابد
عاج	عاج
عاجز	عاجز
عاد	عاد
عادت	عادت
عادل	عادل
عار	عار
عارف	عارف
عاشق	عاشق
عاشور	عاشور
عاشورا	عاشورا
عاصم	عاصم
عاق	عاق
عاقب	عاقب
عاقل	عاقل
عالم	عالم
عالمِ	عالمِ
عالمی	عالمی
عام	عام
عامل	عامل
عباد	عباد
عبادت	عبادت
عبارت	عبارت
عباس	عباس
عبد	عبد
عبدالحق	عبدالحق
عبداللہ	عبداللہ
عبرت	عبرت
عبور	عبور
عتاب	عتاب
عتبہ	عتبہ
عثمان	عثمان
عجائب	عجائب
عجب	عجب
عجم	عجم
عدالت	عدالت
عداوت	عداوت
عدت	عدت
عدد	عدد
عدل	عدل
عدم	عدم
عدن	عدن
عدنان	عدنان
عدو	عدو
عذاب	عذاب
عذر	عذر
عذرا	عذرا
عرار	عرار
عراق	عراق
عرب	عرب
عربستان	عربستان
عربی	عربی
عرس	عرس
عرش	عرش
عرض	عرض
عرف	عرف
عرفات	عرفات
عرفان	عرفان
عرفہ	عرفہ
عرق	عرق
عروج	عروج
عروس	عروس
عروض	عروض
عزت	عزت
عزم	عزم
عزیز	عزیز
عشر	عشر
عشرت	عشرت
عشق	عشق
عصر	عصر
عصمت	عصمت
عضو	عضو
عطا	عطا
عطار	عطار
عطارد	عطارد
عطر	عطر
عظام	عظام
عظمت	عظمت
عظیم	عظیم
عفونت	عفونت
عقائد	عقائد
عقاب	عقاب
عقبہ	عقبہ
عقد	عقد
عقل	عقل
علائق	علائق
علاج	علاج
علالت	علالت
علام	علام
علامات	علامات
علامت	علامت
علامہ	علامہ
علاوہ	علاوہ
علت	علت
علق	علق
علم	علم
علمبردار	علمبردار
علمِ	علمِ
علمی	علمی
علو	علو
علوم	علوم
علی	علی
علیہ	علیہ
عم	عم
عماد	عماد
عمارت	عمارت
عمان	عمان
عمد	عمد
عمدا	عمدا
عمدہ	عمدہ
عمر	عمر
عمران	عمران
عمرو	عمرو
عمق	عمق
عمل	عمل
عموماً	عموماً
عن	عن
عناب	عناب
عناصر	عناصر
عنان	عنان
عنبر	عنبر
عنصر	عنصر
عنوان	عنوان
عنہ	عنہ
عوام	عوام
عوامل	عوامل
عود	عود
عورت	عورت
عوض	عوض
عَلَی	عَلَی
عُمر	عُمر
عہد	عہد
عیسائیت	عیسائیت
عیسیٰ	عیسیٰ
غ	غ
غائب	غائب
غار	غار
غارت	غارت
غاصب	غاصب
غافل	غافل
غالب	غالب
غالبا	غالبا
غالباً	غالباً
غبار	غبار
غبن	غبن
غدار	غدار
غدر	غدر
غدود	غدود
غذا	غذا
غربت	غربت
غرض	غرض
غرق	غرق
غروب	غروب
غرور	غرور
غزا	غزا
غزال	غزال
غزل	غزل
غزوہ	غزوہ
غسل	غسل
غضب	غضب
غضنفر	غضنفر
غفار	غفار
غفلت	غفلت
غفور	غفور
غلاف	غلاف
غلام	غلام
غلط	غلط
غم	غم
غوث	غوث
غور	غور
غول	غول
غُربت	غُربت
غُلام	غُلام
غیر	غیر
ف	ف
فائر	فائر
فائرنگ	فائرنگ
فائز	فائز
فائق	فائق
فائل	فائل
فائن	فائن
فائنل	فائنل
فاتح	فاتح
فاتحہ	فاتحہ
فادر	فادر
فار	فار
فارغ	فارغ
فارم	فارم
فارمر	فارمر
فارمنگ	فارمنگ
فارمولا	فارمولا
فارن	فارن
فاروق	فاروق
فاسد	فاسد
فاسفورس	فاسفورس
فاسق	فاسق
فاشزم	فاشزم
فاضل	فاضل
فاطمہ	فاطمہ
فاعل	فاعل
فاعلن	فاعلن
فال	فال
فالتو	فالتو
فالج	فالج
فام	فام
فانوس	فانوس
فتح	فتح
فتوح	فتوح
فجر	فجر
فحش	فحش
فخر	فخر
فدا	فدا
فر	فر
فرائض	فرائض
فرات	فرات
فرار	فرار
فراز	فراز
فراست	فراست
فراش	فراش
فراغت	فراغت
فراق	فراق
فراموش	فراموش
فرج	فرج
فرح	فرح
فرحان	فرحان
فرحت	فرحت
فرخ	فرخ
فرد	فرد
فردوس	فردوس
فرزند	فرزند
فرش	فرش
فرصت	فرصت
فرض	فرض
فرعون	فرعون
فرق	فرق
فرقان	فرقان
فرلانگ	فرلانگ
فرم	فرم
فرما	فرما
فرمائش	فرمائش
فرمان	فرمان
فرمانبردار	فرمانبردار
فرنگ	فرنگ
فروخت	فروخت
فروش	فروش
فروغ	فروغ
فساد	فساد
فش	فش
فشان	فشان
فصاحت	فصاحت
فصل	فصل
فضا	فضا
فضائل	فضائل
فضل	فضل
فضول	فضول
فطر	فطر
فطرت	فطرت
فعال	فعال
فعل	فعل
فعلن	فعلن
فعولن	فعولن
فقدان	فقدان
فقر	فقر
فقرا	فقرا
فقرو	فقرو
فقط	فقط
فقہ	فقہ
فقیر	فقیر
فل	فل
فلاح	فلاح
فلاسفر	فلاسفر
فلاور	فلاور
فلش	فلش
فلم	فلم
فلو	فلو
فلور	فلور
فلوس	فلوس
فن	فن
فنا	فنا
فنانس	فنانس
فنانشل	فنانشل
فند	فند
فنون	فنون
فنِ	فنِ
فواد	فواد
فوت	فوت
فوج	فوج
فوجدار	فوجدار
فور	فور
فوراً	فوراً
فورس	فورس
فورم	فورم
فولاد	فولاد
فوم	فوم
فون	فون
فگار	فگار
فہرست	فہرست
فی	فی
قائد	قائد
قائداعظم	قائداعظم
قائل	قائل
قائم	قائم
قابض	قابض
قابل	قابل
قابلِ	قابلِ
قابو	قابو
قاتل	قاتل
قادر	قادر
قاز	قاز
قاسم	قاسم
قاصد	قاصد
قاصر	قاصر
قاف	قاف
قال	قال
قالب	قالب
قام	قام
قامت	قامت
قانع	قانع
قانون	قانون
قبا	قبا
قبر	قبر
قبرستان	قبرستان
قبض	قبض
قبل	قبل
قبول	قبول
قتال	قتال
قتل	قتل
قحط	قحط
قد	قد
قدامت	قدامت
قدر	قدر
قدرت	قدرت
قدس	قدس
قدم	قدم
قدیم	قدیم
قرآن	قرآن
قرات	قرات
قرار	قرار
قرارداد	قرارداد
قرب	قرب
قربان	قربان
قربت	قربت
قرت	قرت
قرض	قرض
قرع	قرع
قرن	قرن
قرون	قرون
قریب	قریب
قزاق	قزاق
قزع	قزع
قسط	قسط
قسم	قسم
قسمت	قسمت
قصاص	قصاص
قصد	قصد
قصر	قصر
قصص	قصص
قصور	قصور
قضا	قضا
قطار	قطار
قطب	قطب
قطر	قطر
قطع	قطع
قطعا	قطعا
قلب	قلب
قلت	قلت
قلعہ	قلعہ
قلم	قلم
قلندر	قلندر
قم	قم
قمر	قمر
قناعت	قناعت
قند	قند
قندھار	قندھار
قوال	قوال
قوت	قوت
قوس	قوس
قول	قول
قولنج	قولنج
قوم	قوم
قونصل	قونصل
قَد	قَد
قُرب	قُرب
قیادت	قیادت
قیام	قیام
قید	قید
قیصر	قیصر
ل	ل
لا	لا
لاء	لاء
لائسنس	لائسنس
لائف	لائف
لائق	لائق
لائم	لائم
لائن	لائن
لائنز	لائنز
لائٹ	لائٹ
لات	لات
لاتعداد	لاتعداد
لاتعلق	لاتعلق
لاج	لاج
لاجواب	لاجواب
لاجورد	لاجورد
لاحق	لاحق
لارا	لارا
لارنس	لارنس
لازم	لازم
لازماً	لازماً
لازوال	لازوال
لازَوال	لازَوال
لاش	لاش
لاشعور	لاشعور
لاطینی	لاطینی
لاعلاج	لاعلاج
لال	لال
لالچ	لالچ
لام	لام
لامحدود	لامحدود
لان	لان
لانچ	لانچ
لانچر	لانچر
لانگ	لانگ
لاوا	لاوا
لاوارث	لاوارث
لاولد	لاولد
لاچار	لاچار
لاک	لاک
لاکھ	لاکھ
لاگ	لاگ
لب	لب
لباس	لباس
لبرل	لبرل
لبنان	لبنان
لت	لت
لتا	لتا
لحاظ	لحاظ
لذت	لذت
لرزش	لرزش
لسان	لسان
لسن	لسن
لطائف	لطائف
لطافت	لطافت
لطف	لطف
لعاب	لعاب
لعل	لعل
لعنت	لعنت
لغات	لغات
لغت	لغت
لفظ	لفظ
لقب	لقب
لقمان	لقمان
لم	لم
لمس	لمس
لن	لن
لندن	لندن
لنچ	لنچ
لنگ	لنگ
لنگر	لنگر
لو	لو
لوئر	لوئر
لوب	لوب
لوبان	لوبان
لوث	لوث
لورا	لورا
لوز	لوز
لوشن	لوشن
لوط	لوط
لولا	لولا
لون	لون
لونگ	لونگ
لوپ	لوپ
لوچ	لوچ
لوگ	لوگ
لَو	لَو
لپ	لپ
لک	لک
لکا	لکا
لگا	لگا
لیا	لیا
لیکن	لیکن
لیگ	لیگ
لیے	لیے
لے	لے
م	م
مؤثر	مؤثر
مؤرخ	مؤرخ
مؤلف	مؤلف
مؤنث	مؤنث
مئی	مئی
ما	ما
ماء	ماء
ماءُ	ماءُ
ماءِ	ماءِ
مائل	مائل
مائنر	مائنر
مابعد	مابعد
مات	مات
ماتا	ماتا
ماتحت	ماتحت
ماتر	ماتر
ماترا	ماترا
ماترم	ماترم
ماتم	ماتم
ماجد	ماجد
ماجرا	ماجرا
ماحول	ماحول
ماخذ	ماخذ
ماد	ماد
مادام	مادام
مادر	مادر
مار	مار
مارا	مارا
ماربل	ماربل
مارجن	مارجن
مارس	مارس
مارشل	مارشل
مارننگ	مارننگ
مارو	مارو
مارُو	مارُو
مارچ	مارچ
ماس	ماس
ماسا	ماسا
مافوق	مافوق
مال	مال
مالا	مالا
مالش	مالش
مالن	مالن
مالو	مالو
مالوا	مالوا
مالک	مالک
ماما	ماما
مامتا	مامتا
مامور	مامور
مامون	مامون
مان	مان
مانس	مانس
مانند	مانند
مانوس	مانوس
ماورا	ماورا
ماپ	ماپ
مباح	مباح
مبادلہ	مبادلہ
مبارک	مبارک
مبتلا	مبتلا
مبشر	مبشر
مبصر	مبصر
مبلغ	مبلغ
مت	مت
متا	متا
متاثر	متاثر
متاع	متاع
متبادل	متبادل
متحد	متحد
متحدا	متحدا
متحدہ	متحدہ
متر	متر
مترا	مترا
مترادف	مترادف
مترجم	مترجم
متصل	متصل
متضاد	متضاد
متعارف	متعارف
متعدد	متعدد
متعرف	متعرف
متعصب	متعصب
متعلق	متعلق
متفرق	متفرق
متفق	متفق
متفقہ	متفقہ
متن	متن
متنازع	متنازع
متناسب	متناسب
متنفر	متنفر
متواتر	متواتر
متوازن	متوازن
متوقع	متوقع
مثال	مثال
مثبت	مثبت
مثقال	مثقال
مثل	مثل
مثلا	مثلا
مثلاً	مثلاً
مثلث	مثلث
مثمن	مثمن
مجاز	مجاز
مجال	مجال
مجاور	مجاور
مجبور	مجبور
مجبوراً	مجبوراً
مجتبیٰ	مجتبیٰ
مجدد	مجدد
مجذوب	مجذوب
مجرب	مجرب
مجرد	مجرد
مجرم	مجرم
مجروح	مجروح
مجسم	مجسم
مجلس	مجلس
مجمع	مجمع
مجموعا	مجموعا
مجموعہ	مجموعہ
مجموعی	مجموعی
مجنون	مجنون
مجھ	مجھ
محاذ	محاذ
محافظ	محافظ
محال	محال
محب	محب
محبت	محبت
محبوب	محبوب
محبّت	محبّت
محتاج	محتاج
محتاط	محتاط
محترم	محترم
محترمہ	محترمہ
محتسب	محتسب
محدث	محدث
محدود	محدود
محراب	محراب
محرم	محرم
محروم	محروم
محسن	محسن
محسود	محسود
محسوس	محسوس
محسوسات	محسوسات
محصول	محصول
محض	محض
محظوظ	محظوظ
محفل	محفل
محفوظ	محفوظ
محقق	محقق
محل	محل
محلا	محلا
محلات	محلات
محلول	محلول
محمد	محمد
محمود	محمود
محمّد	محمّد
محنت	محنت
محو	محو
محور	محور
مخاطب	مخاطب
مخالف	مخالف
مخالفت	مخالفت
مخبر	مخبر
مختار	مختار
مختص	مختص
مختصر	مختصر
مختصراً	مختصراً
مختلف	مختلف
مخدوم	مخدوم
مخروط	مخروط
مخزن	مخزن
مخزوم	مخزوم
مخصوص	مخصوص
مخطوطات	مخطوطات
مخفف	مخفف
مخلص	مخلص
مخلوط	مخلوط
مخلوق	مخلوق
مخلوقات	مخلوقات
مخمس	مخمس
مخمل	مخمل
مد	مد
مداح	مداح
مداخلت	مداخلت
مدار	مدار
مدافعت	مدافعت
مدبر	مدبر
مدت	مدت
مدح	مدح
مدد	مدد
مددگار	مددگار
مدراس	مدراس
مدرس	مدرس
مدرسہ	مدرسہ
مدعو	مدعو
مدفن	مدفن
مدلل	مدلل
مدمقابل	مدمقابل
مدن	مدن
مدنظر	مدنظر
مدھم	مدھم
مدینہ	مدینہ
مذاق	مذاق
مذمت	مذمت
مر	مر
مرا	مرا
مراد	مراد
مربع	مربع
مربوط	مربوط
مرتب	مرتب
مرتبان	مرتبان
مرتد	مرتد
مرجان	مرجان
مرجز	مرجز
مرحب	مرحب
مرحبا	مرحبا
مرحمت	مرحمت
مرحوم	مرحوم
مرد	مرد
مردار	مردار
مردان	مردان
مردف	مردف
مردم	مردم
مردن	مردن
مردہ	مردہ
مرزا	مرزا
مرسل	مرسل
مرشد	مرشد
مرض	مرض
مرعوب	مرعوب
مرغ	مرغ
مرغزار	مرغزار
مرقد	مرقد
مرمت	مرمت
مرمر	مرمر
مرنا	مرنا
مروت	مروت
مروج	مروج
مرچ	مرچ
مرچن	مرچن
مریض	مریض
مزا	مزا
مزاج	مزاج
مزاح	مزاح
مزاحمت	مزاحمت
مزار	مزار
مزدور	مزدور
مس	مس
مسئلہ	مسئلہ
مسائل	مسائل
مساج	مساج
مسافر	مسافر
مساوات	مساوات
مست	مست
مستحب	مستحب
مستحق	مستحق
مسترد	مسترد
مستزاد	مستزاد
مستشرق	مستشرق
مستعمل	مستعمل
مستقبل	مستقبل
مستقل	مستقل
مستند	مستند
مستور	مستور
مسجد	مسجد
مسجع	مسجع
مسح	مسح
مسخ	مسخ
مسخرا	مسخرا
مسدس	مسدس
مسرت	مسرت
مسرور	مسرور
مسز	مسز
مسعود	مسعود
مسقط	مسقط
مسلح	مسلح
مسلسل	مسلسل
مسلط	مسلط
مسلم	مسلم
مسلمان	مسلمان
مسمار	مسمار
مسن	مسن
مسند	مسند
مسنون	مسنون
مسور	مسور
مسیح	مسیح
مسیحی	مسیحی
مسیحیت	مسیحیت
مشائخ	مشائخ
مشاورت	مشاورت
مشت	مشت
مشتاق	مشتاق
مشتق	مشتق
مشتمل	مشتمل
مشرف	مشرف
مشرق	مشرق
مشروب	مشروب
مشروبات	مشروبات
مشروط	مشروط
مشعل	مشعل
مشغول	مشغول
مشفق	مشفق
مشق	مشق
مشقت	مشقت
مشن	مشن
مشورت	مشورت
مشہور	مشہور
مصاحب	مصاحب
مصارف	مصارف
مصالح	مصالح
مصالحت	مصالحت
مصباح	مصباح
مصحف	مصحف
مصدر	مصدر
مصر	مصر
مصرع	مصرع
مصروف	مصروف
مصطفیٰ	مصطفیٰ
مصلحت	مصلحت
مصنف	مصنف
مصنوعات	مصنوعات
مصور	مصور
مضبوط	مضبوط
مضر	مضر
مضراب	مضراب
مضطرب	مضطرب
مضمون	مضمون
مطابق	مطابق
مطابقت	مطابقت
مطالع	مطالع
مطبع	مطبع
مطبوع	مطبوع
مطلب	مطلب
مطلع	مطلع
مطلق	مطلق
مطلوب	مطلوب
مطمئن	مطمئن
مظفر	مظفر
مظلوم	مظلوم
مع	مع
معاذ	معاذ
معارف	معارف
معاش	معاش
معاشرت	معاشرت
معاصر	معاصر
معاف	معاف
معالج	معالج
معاملات	معاملات
معاون	معاون
معاونت	معاونت
معبد	معبد
معبود	معبود
معتبر	معتبر
معتدل	معتدل
معترف	معترف
معتصم	معتصم
معتقد	معتقد
معتمد	معتمد
معجون	معجون
معد	معد
معدنیات	معدنیات
معذرت	معذرت
معذور	معذور
معراج	معراج
معرفت	معرفت
معروف	معروف
معز	معز
معزز	معزز
معزول	معزول
معشر	معشر
معشوق	معشوق
معصوم	معصوم
معطر	معطر
معطل	معطل
معظم	معظم
معظمہ	معظمہ
معقول	معقول
معلم	معلم
معلوم	معلوم
معلومات	معلومات
معمار	معمار
معمر	معمر
معمور	معمور
معمول	معمول
معنا	معنا
مغرب	مغرب
مغرور	مغرور
مغز	مغز
مغفرت	مغفرت
مغل	مغل
مغلوب	مغلوب
مفاد	مفاد
مفت	مفت
مفتاح	مفتاح
مفتی	مفتی
مفرح	مفرح
مفرد	مفرد
مفردات	مفردات
مفسر	مفسر
مفصل	مفصل
مفعول	مفعول
مفلح	مفلح
مفلس	مفلس
مفلوج	مفلوج
مقابل	مقابل
مقابلہ	مقابلہ
مقاصد	مقاصد
مقالات	مقالات
مقام	مقام
مقامی	مقامی
مقبوضہ	مقبوضہ
مقبول	مقبول
مقتدر	مقتدر
مقتول	مقتول
مقدار	مقدار
مقدر	مقدر
مقدس	مقدس
مقدم	مقدم
مقدما	مقدما
مقر	مقر
مقرب	مقرب
مقرر	مقرر
مقروض	مقروض
مقصد	مقصد
مقصود	مقصود
مقطع	مقطع
مقطعات	مقطعات
مقعد	مقعد
مقناطیس	مقناطیس
مقوم	مقوم
مل	مل
ملا	ملا
ملائم	ملائم
ملاح	ملاح
ملازم	ملازم
ملازمت	ملازمت
ملاقات	ملاقات
ملامت	ملامت
ملان	ملان
ملت	ملت
ملحد	ملحد
ملحق	ملحق
ملر	ملر
ملز	ملز
ملزوم	ملزوم
ملفوظات	ملفوظات
ململ	ململ
ملن	ملن
ملنسار	ملنسار
ملو	ملو
ملوث	ملوث
ملول	ملول
ملون	ملون
ملک	ملک
ملین	ملین
مماثلت	مماثلت
ممبر	ممبر
ممتاز	ممتاز
ممدوح	ممدوح
ممنوع	ممنوع
ممنون	ممنون
من	من
منا	منا
منات	منات
مناجات	مناجات
مناسب	مناسب
مناسبت	مناسبت
مناظر	مناظر
مناف	مناف
منافع	منافع
منافقت	منافقت
مناقب	مناقب
منبر	منبر
منبع	منبع
منت	منت
منتخب	منتخب
منتر	منتر
منتشر	منتشر
منتظر	منتظر
منتظم	منتظم
منتقل	منتقل
منحرف	منحرف
منحصر	منحصر
مند	مند
مندر	مندر
مندرج	مندرج
مندن	مندن
منذر	منذر
منرل	منرل
منزل	منزل
منسا	منسا
منسلک	منسلک
منسوب	منسوب
منسوخ	منسوخ
منش	منش
منشا	منشا
منشور	منشور
منصب	منصب
منصف	منصف
منصوب	منصوب
منصوبہ	منصوبہ
منصور	منصور
منصورہ	منصورہ
منضج	منضج
منطق	منطق
منظر	منظر
منظرِ	منظرِ
منظم	منظم
منظور	منظور
منظوم	منظوم
منع	منع
منعقد	منعقد
منفرد	منفرد
منقبت	منقبت
منقطع	منقطع
منقول	منقول
مننا	مننا
منو	منو
منور	منور
منچ	منچ
منگ	منگ
منگتا	منگتا
منگل	منگل
منگول	منگول
منھ	منھ
مو	مو
مواد	مواد
مواصلات	مواصلات
موافق	موافق
موافقت	موافقت
موالات	موالات
موبائل	موبائل
موبل	موبل
موت	موت
موثر	موثر
موج	موج
موجب	موجب
موجد	موجد
موجود	موجود
موجودات	موجودات
موجودہ	موجودہ
موحد	موحد
مودود	مودود
مور	مور
مورا	مورا
مورت	مورت
مورث	مورث
مورو	مورو
مورچا	مورچا
موز	موز
موسا	موسا
موسم	موسم
موسوم	موسوم
موسی	موسی
موسیٰ	موسیٰ
موشن	موشن
موصل	موصل
موصوف	موصوف
موصول	موصول
موضع	موضع
موضوع	موضوع
موضوعات	موضوعات
موقع	موقع
موقف	موقف
موقوف	موقوف
مول	مول
مولا	مولا
مولانا	مولانا
مولف	مولف
مولو	مولو
مولود	مولود
موم	موم
مومن	مومن
مون	مون
مونا	مونا
مونس	مونس
مونو	مونو
مونوگرام	مونوگرام
موو	موو
مَت	مَت
مَر	مَر
مَل	مَل
مَن	مَن
مُجھ	مُجھ
مُجھے	مُجھے
مُختصر	مُختصر
مُراد	مُراد
مُرشد	مُرشد
مُفاد	مُفاد
مُقام	مُقام
مُلا	مُلا
مُنا	مُنا
مُند	مُند
مُون	مُون
مِرا	مِرا
مِرے	مِرے
مِس	مِس
مِل	مِل
مچ	مچ
مکمل	مکمل
مگر	مگر
مگن	مگن
میان	میان
میدان	میدان
میر	میر
میل	میل
مین	مین
میچ	میچ
میں	میں
ن	ن
نا	نا
ناؤ	ناؤ
نائب	نائب
نائلون	نائلون
نابالغ	نابالغ
نابود	نابود
ناتا	ناتا
ناتوان	ناتوان
ناجائز	ناجائز
ناحق	ناحق
ناخوش	ناخوش
ناد	ناد
نادار	نادار
نادان	نادان
نادر	نادر
نار	نار
نارائن	نارائن
ناراض	ناراض
نارد	نارد
نارمل	نارمل
نارنگ	نارنگ
نارو	نارو
ناروا	ناروا
ناز	ناز
نازش	نازش
نازل	نازل
نازو	نازو
ناس	ناس
ناساز	ناساز
ناسور	ناسور
ناشاد	ناشاد
ناشر	ناشر
ناصر	ناصر
ناظر	ناظر
ناظم	ناظم
نافذ	نافذ
نافرمان	نافرمان
نافع	نافع
ناقابل	ناقابل
ناقابلِ	ناقابلِ
ناقص	ناقص
نال	نال
نالا	نالا
نالائق	نالائق
نام	نام
نامدار	نامدار
نامراد	نامراد
نامعلوم	نامعلوم
نامناسب	نامناسب
نامنظور	نامنظور
ناموس	ناموس
نامہ	نامہ
نان	نان
نانا	نانا
نانگا	نانگا
ناواقف	ناواقف
ناول	ناول
ناپسند	ناپسند
ناچ	ناچ
ناگ	ناگ
ناگر	ناگر
ناگوار	ناگوار
نباتات	نباتات
نبض	نبض
نبوت	نبوت
نت	نت
نثار	نثار
نثر	نثر
نج	نج
نجات	نجات
نجار	نجار
نجد	نجد
نجف	نجف
نجم	نجم
نجما	نجما
نجوم	نجوم
نحو	نحو
نخلستان	نخلستان
ند	ند
ندا	ندا
ندامت	ندامت
نذر	نذر
نر	نر
نرالا	نرالا
نرت	نرت
نرخ	نرخ
نرسنگ	نرسنگ
نرم	نرم
نرمل	نرمل
نرملا	نرملا
نرو	نرو
نروار	نروار
نروس	نروس
نرگس	نرگس
نزاد	نزاد
نزار	نزار
نزول	نزول
نس	نس
نسب	نسب
نسبت	نسبت
نسبتا	نسبتا
نسبتاً	نسبتاً
نسخ	نسخ
نسر	نسر
نسق	نسق
نسل	نسل
نسوار	نسوار
نشاط	نشاط
نشان	نشان
نشانِ	نشانِ
نشتر	نشتر
نشر	نشر
نشریات	نشریات
نشست	نشست
نشو	نشو
نشوونما	نشوونما
نص	نص
نصاب	نصاب
نصب	نصب
نصر	نصر
نصرت	نصرت
نصف	نصف
نظام	نظام
نظامِ	نظامِ
نظر	نظر
نظم	نظم
نعت	نعت
نعل	نعل
نعم	نعم
نعمان	نعمان
نعمت	نعمت
نفاذ	نفاذ
نفاس	نفاس
نفاست	نفاست
نفاق	نفاق
نفرت	نفرت
نفس	نفس
نفط	نفط
نفع	نفع
نفل	نفل
نقاب	نقاب
نقاد	نقاد
نقاش	نقاش
نقد	نقد
نقرس	نقرس
نقش	نقش
نقشا	نقشا
نقشِ	نقشِ
نقص	نقص
نقصان	نقصان
نقطہ	نقطہ
نقل	نقل
نقوش	نقوش
نل	نل
نم	نم
نما	نما
نمائش	نمائش
نماز	نماز
نمازن	نمازن
نمبر	نمبر
نمبردار	نمبردار
نمر	نمر
نمرود	نمرود
نمن	نمن
نمودار	نمودار
نن	نن
نند	نند
ننگ	ننگ
ننگا	ننگا
نو	نو
نواب	نواب
نوادرات	نوادرات
نواز	نواز
نوان	نوان
نوبت	نوبت
نوبل	نوبل
نوجوان	نوجوان
نوح	نوح
نوحہ	نوحہ
نور	نور
نورا	نورا
نورس	نورس
نوروز	نوروز
نوش	نوش
نوشادر	نوشادر
نوشت	نوشت
نوع	نوع
نوفل	نوفل
نول	نول
نومبر	نومبر
نون	نون
نَر	نَر
نَو	نَو
نَہ	نَہ
نُور	نُور
نُک	نُک
نِج	نِج
نک	نک
نگار	نگار
نگارا	نگارا
نگارن	نگارن
نگر	نگر
نگران	نگران
نہ	نہ
نہیں	نہیں
نیرو	نیرو
نیشنل	نیشنل
نے	نے
و	و
وا	وا
واؤ	واؤ
وابستہ	وابستہ
وات	وات
واثق	واثق
واجب	واجب
واجبات	واجبات
واحد	واحد
واد	واد
وار	وار
وارا	وارا
وارتا	وارتا
وارث	وارث
وارد	وارد
واردات	واردات
وارن	وارن
وارنش	وارنش
واری	واری
واس	واس
واسوخت	واسوخت
واصل	واصل
واضح	واضح
واضع	واضع
واعظ	واعظ
وافر	وافر
واقع	واقع
واقعات	واقعات
واقف	واقف
وال	وال
والا	والا
والد	والد
والدہ	والدہ
والی	والی
والے	والے
وان	وان
واپس	واپس
واچ	واچ
واہ	واہ
وتر	وتر
وجد	وجد
وجدان	وجدان
وجوب	وجوب
وجود	وجود
وجہ	وجہ
وحدت	وحدت
وحشت	وحشت
ود	ود
وداع	وداع
ور	ور
وراثت	وراثت
ورد	ورد
ورزش	ورزش
ورق	ورق
ورم	ورم
ورن	ورن
وزارت	وزارت
وزن	وزن
وسائل	وسائل
وسعت	وسعت
وسواس	وسواس
وصال	وصال
وصف	وصف
وصل	وصل
وصول	وصول
وضع	وضع
وضو	وضو
وطن	وطن
وظائف	وظائف
وعظ	وعظ
وغیرہ	وغیرہ
وفا	وفا
وفات	وفات
وفادار	وفادار
وفاق	وفاق
وقار	وقار
وقت	وقت
وقعت	وقعت
وقف	وقف
وقوع	وقوع
ول	ول
ولا	ولا
ولادت	ولادت
ولد	ولد
ون	ون
ونش	ونش
وو	وو
وَ	وَ
وَر	وَر
وَقت	وَقت
وہ	وہ
ویب	ویب
ویو	ویو
پ	پ
پا	پا
پائدار	پائدار
پائمال	پائمالِ
پائن	پائن
پائپ	پائپ
پابند	پابند
پات	پات
پاتال	پاتال
پاتل	پاتل
پادر	پادر
پار	پار
پارا	پارا
پارس	پارس
پارسا	پارسا
پارک	پارک
پاس	پاس
پاسبان	پاسبان
پاشا	پاشا
پال	پال
پالتو	پالتو
پالش	پالش
پام	پام
پان	پان
پانو	پانو
پانچ	پانچ
پانگ	پانگ
پانی	پانی
پاور	پاور
پاول	پاول
پاپ	پاپ
پاپا	پاپا
پاپوش	پاپوش
پاپولر	پاپولر
پاک	پاک
پاکستان	پاکستان
پبلشر	پبلشر
پبلشنگ	پبلشنگ
پت	پت
پتا	پتا
پتر	پتر
پترا	پترا
پترن	پترن
پتل	پتل
پتلا	پتلا
پتلو	پتلو
پتلون	پتلون
پختا	پختا
پختون	پختون
پد	پد
پدم	پدم
پدما	پدما
پر	پر
پرا	پرا
پرائز	پرائز
پراثر	پراثر
پرامن	پرامن
پران	پران
پراگ	پراگ
پربت	پربت
پرت	پرت
پرتاب	پرتاب
پرتل	پرتل
پرتن	پرتن
پرتو	پرتو
پرتگال	پرتگال
پرجوش	پرجوش
پردا	پردا
پرداخت	پرداخت
پردن	پردن
پردہ	پردہ
پرزا	پرزا
پرزم	پرزم
پرس	پرس
پرساد	پرساد
پرست	پرست
پرستار	پرستار
پرستش	پرستش
پرسن	پرسن
پرسنل	پرسنل
پرسوز	پرسوز
پرش	پرش
پرشاد	پرشاد
پرشن	پرشن
پرشوتم	پرشوتم
پرفارمنس	پرفارمنس
پرم	پرم
پرمانند	پرمانند
پرن	پرن
پرنس	پرنس
پرنسپل	پرنسپل
پرو	پرو
پرواز	پرواز
پروان	پروان
پروانو	پروانو
پرور	پرور
پروردگار	پروردگار
پرورش	پرورش
پروف	پروف
پروفیسر	پروفیسر
پروموشن	پروموشن
پروگرام	پروگرام
پروگرامر	پروگرامر
پرچار	پرچار
پرچم	پرچم
پرک	پرک
پس	پس
پسار	پسار
پسان	پسان
پست	پست
پستا	پستا
پستول	پستول
پسند	پسند
پشت	پشت
پشتو	پشتو
پشپ	پشپ
پل	پل
پلا	پلا
پلازا	پلازا
پلازم	پلازم
پلان	پلان
پلاننگ	پلاننگ
پلن	پلن
پلنگ	پلنگ
پلو	پلو
پلے	پلے
پمپ	پمپ
پن	پن
پنا	پنا
پنت	پنت
پنج	پنج
پنجا	پنجا
پنجاب	پنجاب
پنجابی	پنجابی
پنجر	پنجر
پنجم	پنجم
پند	پند
پنو	پنو
پنچ	پنچ
پنچال	پنچال
پنکا	پنکا
پنگ	پنگ
پو	پو
پوت	پوت
پوتر	پوتر
پوجا	پوجا
پور	پور
پورا	پورا
پورب	پورب
پورت	پورت
پورس	پورس
پورم	پورم
پورن	پورن
پورو	پورو
پوست	پوست
پوش	پوش
پوشن	پوشن
پول	پول
پولا	پولا
پولش	پولش
پولنگ	پولنگ
پولو	پولو
پون	پون
پونا	پونا
پونجا	پونجا
پونم	پونم
پوپ	پوپ
پوکن	پوکن
پَر	پَر
پَرِ	پَرِ
پَل	پَل
پَن	پَن
پُر	پُر
پُرجوش	پُرجوش
پُل	پُل
پُور	پُور
پُورا	پُورا
پِھر	پِھر
پٹ	پٹ
پچ	پچ
پچاس	پچاس
پچن	پچن
پچو	پچو
پڑا	پڑا
پک	پک
پکا	پکا
پھ	پھ
پھر	پھر
پھل	پھل
پہ	پہ
پہلی	پہلی
پہلے	پہلے
پی	پی
پیدا	پیدا
پیدائش	پیدائش
پیر	پیر
پیش	پیش
پیغام	پیغام
پیغمبر	پیغمبر
چ	چ
چا	چا
چاء	چاء
چادر	چادر
چار	چار
چارا	چارا
چارج	چارج
چارلس	چارلس
چارو	چارو
چاشت	چاشت
چاقو	چاقو
چال	چال
چالان	چالان
چالو	چالو
چام	چام
چاند	چاند
چانس	چانس
چانسلر	چانسلر
چاپ	چاپ
چاچا	چاچا
چت	چت
چتا	چتا
چتر	چتر
چترا	چترا
چترنگ	چترنگ
چتون	چتون
چر	چر
چراغ	چراغ
چراند	چراند
چرتر	چرتر
چرخ	چرخ
چرس	چرس
چرن	چرن
چرچ	چرچ
چرچا	چرچا
چست	چست
چشم	چشم
چغل	چغل
چقندر	چقندر
چل	چل
چلا	چلا
چلت	چلت
چلتو	چلتو
چلم	چلم
چلو	چلو
چم	چم
چمر	چمر
چمن	چمن
چمپا	چمپا
چمچا	چمچا
چن	چن
چنا	چنا
چنار	چنار
چنبا	چنبا
چنتا	چنتا
چند	چند
چندا	چندا
چندر	چندر
چندرا	چندرا
چندن	چندن
چندو	چندو
چنچل	چنچل
چنگ	چنگ
چنگل	چنگل
چو	چو
چوب	چوب
چوبدار	چوبدار
چور	چور
چورس	چورس
چورن	چورن
چورو	چورو
چول	چول
چولا	چولا
چون	چون
چوگرد	چوگرد
چُر	چُر
چُن	چُن
چپ	چپ
چپل	چپل
چپن	چپن
چپو	چپو
چچ	چچ
چچا	چچا
چھ	چھ
چھل	چھل
چھوڑ	چھوڑ
چین	چین
کئی	کئی
کا	کا
کار	کار
کارا	کارا
کام	کام
کان	کان
کبھی	کبھی
کبیرا	کبیرا
کتاب	کتاب
کتب	کتب
کر	کر
کرب	کرب
کرتا	کرتا
کرتی	کرتی
کرد	کرد
کرن	کرن
کرنا	کرنا
کرنے	کرنے
کرو	کرو
کروڑ	کروڑ
کس	کس
کسی	کسی
کش	کش
کل	کل
کلا	کلا
کم	کم
کمر	کمر
کمپنی	کمپنی
کن	کن
کو	کو
کوئی	کوئی
کور	کور
کوسا	کوسا
کون	کون
کوکر	کوکر
کوکو	کوکو
کَل	کَل
کُچھ	کُچھ
کِس	کِس
کِسی	کِسی
کِیا	کِیا
کپ	کپ
کچ	کچ
کچھ	کچھ
ککر	ککر
کھلاڑی	کھلاڑی
کھیل	کھیل
کہ	کہ
کہا	کہا
کہتے	کہتے
کی	کی
کیا	کیا
کیمیائی	کیمیائی
کیوں	کیوں
کے	کے
گ	گ
گئی	گئی
گئے	گئے
گا	گا
گار	گار
گارا	گارا
گال	گال
گاما	گاما
گانا	گانا
گانو	گانو
گاہ	گاہ
گجر	گجر
گجرات	گُجرات
گد	گد
گدا	گدا
گداز	گداز
گذار	گذار
گذر	گذر
گر	گر
گراس	گراس
گراف	گراف
گرافر	گرافر
گرام	گرام
گرامر	گرامر
گراموفون	گراموفون
گرجا	گرجا
گرد	گرد
گردش	گردش
گردن	گردن
گرفت	گرفت
گرفتار	گرفتار
گرل	گرل
گرم	گرم
گرمائش	گرمائش
گرن	گرن
گرو	گرو
گروپ	گروپ
گروہ	گروہ
گرگ	گرگ
گریبان	گریبان
گرین	گرین
گز	گز
گزر	گزر
گس	گس
گشت	گشت
گفت	گفت
گفتا	گفتا
گفتار	گفتار
گفتگو	گفتگو
گل	گل
گلا	گلا
گلاب	گلاب
گلاس	گلاس
گلبدن	گُلبدن
گلبرگ	گلبرگ
گلزار	گلزار
گلستان	گلستان
گلشن	گلشن
گلف	گلف
گلفام	گلفام
گلو	گلو
گلوب	گلوب
گم	گم
گمان	گمان
گمنام	گمنام
گن	گن
گنا	گنا
گنبد	گنبد
گنج	گنج
گنجائش	گنجائش
گنجان	گنجان
گند	گند
گندا	گندا
گندن	گندن
گنگ	گنگ
گنگا	گنگا
گو	گو
گوار	گوار
گوارا	گوارا
گوتم	گوتم
گود	گود
گودام	گودام
گور	گور
گورا	گورا
گورنر	گورنر
گوش	گوش
گوشت	گوشت
گول	گول
گولا	گولا
گونج	گونج
گونگا	گونگا
گوپال	گوپال
گوھر	گوھر
گُجرات	گُجرات
گُذر	گُذر
گُر	گُر
گُرُو	گُرُو
گُل	گُل
گُم	گُم
گُمان	گُمان
گُپتا	گُپتا
گِل	گِل
گپ	گپ
گپت	گپت
گپتا	گپتا
گگن	گگن
گھ	گھ
گھاگھرا	گھاگھرا
گھر	گھر
گھر	گھرء	ء
گیا	گیا
ھل	ھَل
ہا	ہا
ہاؤس	ہاؤس
ہر	ہر
ہم	ہم
ہمیشہ	ہمیشہ
ہو	ہو
ہوئی	ہوئی
ہوئے	ہوئے
ہوا	ہوا
ہونا	ہونا
ہوں	ہوں
ہی	ہی
ہیں	ہیں
ہے	ہے
یا	یا
یاد	یاد
یعنی	یعنی
یقیناً	یقیناً
یوسف	یوسف
یونانی	یونانی
یک	یک
یہ	یہ
یہاں	یہاں