ئاباد	آباد
ئابادان	آبادان
ئابادی	آبادی
ئابدا	ابدا
ئابووی	ابوی
ئابگوون	آبگون
ئابی	ابی
ئاتێن	آتن
ئاخ	آخ
ئاخر	آخر
ئاد	اد
ئاداب	آداب
ئادابێ	آداب
ئاداری	اداری
ئادام	آدام
ئادامز	آدامز
ئادریان	آدریان
ئادۆلف	آدولف
ئادێل	ادل
ئادەم	آدم
ئادەمی	آدمی
ئارا	آرا
ئارارات	آرارات
ئاراستە	آراست
ئارام	آرام
ئارامی	آرامی
ئارامە	آرام
ئاران	آران
ئارایش	آرایش
ئارت	آرت
ئارتور	آرتور
ئارد	آرد
ئاردی	آردی
ئارسن	آرسن
ئارش	آرش
ئارمان	آرمان
ئارنۆلد	آرنولد
ئارنۆڵد	آرنولد
ئارون	آرون
ئارۆن	آرون
ئاری	آری
ئاریا	آریا
ئاریان	آریان
ئاریشێ	اریش
ئارین	آرین
ئاریێل	آریل
ئاریێن	آرین
ئارێز	ارز
ئارەزوو	آرزو
ئارەش	آرش
ئازاد	آزاد
ئازادی	آزادی
ئازادیێ	آزادی
ئازادە	آزاد
ئازار	آزار
ئازاری	آزاری
ئازارە	آزار
ئازەر	آذر
ئازەری	آذری
ئاس	آس
ئاسا	آسا
ئاسان	آسان
ئاسانتر	آسانتر
ئاسانە	آسان
ئاسایش	آسایش
ئاسایشی	آسایشی
ئاسایشێ	آسایش
ئاسایشە	آسایش
ئاسایی	آسایی
ئاساییە	آسایی
ئاست	است
ئاستێ	است
ئاستە	است
ئاسف	آسف
ئاسمان	آسمان
ئاسمانی	آسمانی
ئاسنی	اثنی
ئاسودە	آسود
ئاسوودە	آسود
ئاسک	اسک
ئاسکی	اسکی
ئاسۆشیتد	آسوشیتد
ئاسی	اسی
ئاسیا	آسیا
ئاسیایی	آسیایی
ئاسەف	آسف
ئاشتی	آشتی
ئاشتیان	آشتیان
ئاشتیانی	آشتیانی
ئاشتیێ	آشتی
ئاشلی	اشلی
ئاشنا	آشنا
ئاشنایی	آشنایی
ئاشوب	آشوب
ئاشور	آشور
ئاشوری	آشوری
ئاشووب	آشوب
ئاشوور	آشور
ئاشووری	آشوری
ئاشۆری	آشوری
ئاغا	آغا
ئاف	آف
ئاقا	آقا
ئاقایی	آقایی
ئال	آل
ئالا	آلا
ئالاسکا	آلاسکا
ئالان	الآن
ئالایی	آلایی
ئالبرت	آلبرت
ئالبێرت	آلبرت
ئالتمەن	آلتمن
ئالتۆن	التون
ئالفرێد	آلفرد
ئالن	آلن
ئالی	آلی
ئالیس	آلیس
ئالیک	الیک
ئالیێ	آلی
ئالیەکێ	الیک
ئالێ	آل
ئالێن	آلن
ئالێکس	آلکس
ئاماد	آماد
ئامادە	آماد
ئامادەگی	آمادگی
ئامار	آمار
ئامارێ	آمار
ئامارە	آمار
ئامازۆن	آمازون
ئامر	آمر
ئامراز	امراض
ئامریکا	آمریکا
ئامفی	آمفی
ئامون	آمون
ئامیری	امیری
ئامیرێ	امیر
ئامێدی	آمدی
ئامێدیێ	آمدی
ئامێر	آمر
ئامێرێ	آمر
ئامێرە	آمر
ئامەد	آمد
ئامەدی	آمدی
ئامەدێ	آمد
ئامەریکا	آمریکا
ئان	آن
ئانا	آنا
ئانت	آنت
ئانتوان	آنتوان
ئانتۆنی	آنتونی
ئانجلێس	آنجلس
ئاند	آند
ئاندرسۆن	آندرسون
ئاندری	آندری
ئاندریاس	آندریاس
ئاندرێ	اندر
ئاندرێس	آندرس
ئاندی	اندی
ئانکارا	آنکارا
ئانگ	انگ
ئانی	آنی
ئانیتا	آنیتا
ئاهوو	آهو
ئاهێن	آهن
ئاهەنگ	آهنگ
ئاهەنگی	آهنگی
ئاهەنگێ	آهنگ
ئاهەنگە	آهنگ
ئاهەنگەی	آهنگی
ئاو	او
ئاوا	آوا
ئاواتار	آواتار
ئاوارە	آوار
ئاواز	آواز
ئاوایی	آوایی
ئاور	آور
ئاون	اون
ئاوو	او
ئاوڕ	آور
ئاوڕی	آوری
ئاوێزان	اوزان
ئاوێنە	اون
ئاوە	او
ئاوەوە	او
ئاپریل	اپریل
ئاڕنۆڵد	آرنولد
ئاژانس	آژانس
ئاژانسە	آژانس
ئاڤ	او
ئاڤا	آوا
ئاڤاتار	آواتار
ئاڤان	اوان
ئاڤێ	او
ئاڤێستا	اوستا
ئاکۆ	اکو
ئاگاهی	آگاهی
ئاگر	اگر
ئاگرێ	اگر
ئاگۆست	آگوست
ئاڵ	آل
ئاڵا	آلا
ئاڵایەی	آلایی
ئاڵتون	التون
ئاڵتوون	التون
ئاڵتۆ	آلتو
ئاڵفرێد	آلفرد
ئاڵن	آلن
ئاڵو	آلو
ئای	آی
ئایا	آیا
ئاید	آید
ئایدا	آیدا
ئایدز	ایدز
ئایدین	آیدین
ئایر	ایر
ئایفۆن	آیفون
ئاین	این
ئایند	آیند
ئایندە	آیند
ئایین	آیین
ئایینێ	آیین
ئایە	آی
ئدین	دین
ئسلامی	سلامی
ئو	و
ئول	ول
ئولی	ولی
ئون	وِن
ئوو	و
ئۆ	و
ئۆل	ول
ئۆلد	ولد
ئۆلگا	ولگا
ئۆلی	ولی
ئۆن	وِن
ئۆی	وی
ئۆیل	ویل
ئۆین	وین
ئید	ید
ئیدی	یدی
ئیراق	یراق
ئیراقێ	یراق
ئیل	یل
ئیلی	یلی
ئیمانی	یمانی
ئیهود	یهود
ئیهۆد	یهود
ئیوان	یوآن
ئیڤان	یوآن
ئیک	یک
ئیکێ	یک
ئیڵ	یل
ئێبی	بی
ئێخست	خست
ئێخستن	خستن
ئێدی	دی
ئێران	ران
ئێرانم	رانم
ئێرانه	رانه
ئێرانی	رانی
ئێرانیە	رانی
ئێرانێ	ران
ئێرانێکی	رانکی
ئێرانە	ران
ئێرێک	رک
ئێرەو	رو
ئێزدی	زدی
ئێزیدی	زیدی
ئێستاکە	ستاک
ئێستایش	ستایش
ئێسک	سک
ئێسی	سی
ئێشی	شی
ئێلی	لی
ئێما	ما
ئێمری	مری
ئێمه	مه
ئێمی	می
ئێمەئەو	مو
ئێمەبوو	مبو
ئێمەبۆ	مبو
ئێمەبەو	مبو
ئێمەدان	مدان
ئێمەدوو	مدو
ئێمەش	مش
ئێمەلەم	ملم
ئێمەن	من
ئێمەهەر	مهر
ئێمەو	مو
ئێمەوە	مو
ئێمەڕێز	مرز
ئێمەکار	مکار
ئێمەکاری	مکاری
ئێمەی	می
ئێمەیان	میان
ئێمەیش	میش
ئێمەیە	می
ئێمەیەو	میو
ئێنی	نی
ئێنێستا	نستا
ئێهود	هود
ئێوارەو	وارو
ئێوە	و
ئێوەدا	ودا
ئێوەش	وش
ئێوەو	و
ئێوەی	وی
ئێوەیە	وی
ئێڕان	ران
ئێڤا	وا
ئێکس	کس
ئێکسەر	کسر
ئێکۆ	کو
ئێکی	کی
ئێکێیا	کیا
ئێکەتی	کتی
ئێکەتیێ	کتی
ئێکەم	کم
ئێکەمین	کمین
ئێکەژ	کژ
ئەبو	بو
ئەبوو	بو
ئەبی	بی
ئەبیاتی	بیاتی
ئەبێت	بت
ئەبەدی	بدی
ئەحمد	حمد
ئەحمەد	حمد
ئەحمەدی	حمدی
ئەحمەدە	حمد
ئەختەر	خطر
ئەخزەر	خزر
ئەخلاق	خلاق
ئەخەوان	خوآن
ئەدات	دات
ئەدهەم	دهم
ئەدی	دی
ئەدەب	دب
ئەدەبی	دبی
ئەدەبێ	دب
ئەدەن	دن
ئەدەین	دین
ئەراک	راک
ئەرد	رد
ئەرزی	رضی
ئەرشەد	رشد
ئەرک	رک
ئەرکی	رکی
ئەرکێ	رک
ئەرکێن	رکن
ئەرکە	رک
ئەرکەی	رکی
ئەزمڕ	زمر
ئەزمەر	زمر
ئەزمەڕ	زمر
ئەزهار	زهار
ئەزهەر	زهر
ئەستون	ستون
ئەستوور	ستور
ئەستۆن	ستون
ئەستێرە	سطر
ئەستەم	ستم
ئەستەمە	ستم
ئەسعەد	سعد
ئەسعەدی	سعدی
ئەسغەر	ثغر
ئەسغەری	صغری
ئەسلتیک	سلتیک
ئەسلی	صلی
ئەسما	سما
ئەسوەد	سود
ئەسڵی	صلی
ئەسید	سید
ئەسیدی	صیدی
ئەسیر	سیر
ئەسیل	سیل
ئەسینا	سینا
ئەسەد	سد
ئەسەدە	سد
ئەشرەف	شرف
ئەشرەفی	شرفی
ئەشڕەف	شرف
ئەشکەنجە	شکنج
ئەعزەمی	عظمی
ئەفزەلی	فضلی
ئەفشار	فشار
ئەفشاری	فشاری
ئەفغان	فغان
ئەفلێک	فلک
ئەفلەک	فلک
ئەلند	لند
ئەلوسی	لوسی
ئەلڤێس	لوث
ئەلیس	لیث
ئەلێک	لک
ئەلەڤێس	لوث
ئەمانی	مانی
ئەمانەش	مانش
ئەمانەی	مانی
ئەمجارە	مجار
ئەمجەد	مجد
ئەمرۆ	مرو
ئەمرۆی	مروی
ئەمری	مری
ئەمسال	مثال
ئەمساڵ	مثال
ئەمساڵی	مثالی
ئەمساڵە	مثال
ئەمش	مش
ئەمشەو	مشو
ئەمن	من
ئەمنو	منو
ئەمنی	منی
ئەمنیەت	منیت
ئەمه	مه
ئەمپێر	مپر
ئەمڕو	مرو
ئەمڕۆ	مرو
ئەمڕۆی	مروی
ئەمڕۆیان	مرویان
ئەمڕۆیە	مروی
ئەمی	می
ئەمیری	میری
ئەمیش	میش
ئەمین	مین
ئەمەئەو	مو
ئەمەبوو	مبو
ئەمەبۆ	مبو
ئەمەبەو	مبو
ئەمەجاری	مجاری
ئەمەش	مش
ئەمەشی	مشی
ئەمەل	مل
ئەمەو	مو
ئەمەکاری	مکاری
ئەمەی	می
ئەمەیان	میان
ئەمەیش	میش
ئەنان	نان
ئەنبار	نبار
ئەنباری	نباری
ئەنتوان	نتوان
ئەنجومەی	نجومی
ئەنخێل	نخل
ئەندانی	ندانی
ئەندرو	ندرو
ئەندرۆ	ندرو
ئەندری	ندری
ئەندرێ	ندر
ئەنسار	نثار
ئەنساری	نثاری
ئەنور	نور
ئەنوەر	نور
ئەنوەری	نوری
ئەنیس	نیس
ئەنێستا	نستا
ئەنەس	نص
ئەهل	هل
ئەهلی	هلی
ئەو	و
ئەوا	وا
ئەوان	وان
ئەوانمان	وانمان
ئەوانە	وان
ئەوتۆ	وتو
ئەودا	ودا
ئەوسەت	وست
ئەوسەتی	وسطی
ئەوش	وش
ئەون	وِن
ئەوو	و
ئەوی	وی
ئەویشی	ویشی
ئەوین	وین
ئەوێ	و
ئەوێن	وِن
ئەوە	و
ئەوەب	وب
ئەوەدا	ودا
ئەوەش	وش
ئەوەل	ول
ئەوەن	وِن
ئەوەندە	وند
ئەوەو	و
ئەوەوە	و
ئەوەڕاست	وراثت
ئەوەی	وی
ئەوەیدا	ویدا
ئەوەیشی	ویشی
ئەوەین	وین
ئەوەیە	وی
ئەوەیەکە	ویک
ئەپرێل	پرل
ئەپرێڵ	پرل
ئەپل	پل
ئەپڕێل	پرل
ئەپڕێڵ	پرل
ئەپڵ	پل
ئەڤ	و
ئەڤان	وان
ئەڤسال	وصال
ئەڤی	وی
ئەڤین	وین
ئەڤینێ	وین
ئەڤێ	و
ئەڤە	و
ئەکات	کات
ئەکبەر	کبر
ئەکبەری	کبری
ئەکتەری	کتری
ئەکتەرەی	کتری
ئەکرد	کرد
ئەکرم	کرم
ئەکرێت	کرت
ئەکرەم	کرم
ئەکسل	کسل
ئەکشی	کشی
ئەکەم	کم
ئەکەن	کن
ئەکەین	کین
ئەگەر	گر
ئەگەری	گری
ئەگەرێ	گر
ئەگەڕ	گر
ئەڵقەی	لقی
ئەڵوەن	لون
ئەڵوەند	لوند
ئەڵوەنی	لونی
ئەڵڤێس	لوث
ئەیاد	یاد
ئەیام	یام
ئەیمەن	یمن
ئەیهود	یهود
احمد	احمد
ادریس	ادریس
ادمها	آدمها
ازاد	آزاد
الیاس	الیاس
ان	آن
انا	آنا
انور	انور
اکرم	اکرم
اینجا	اینجا
با	با
باب	باب
بابا	بابا
بابایی	بابایی
بابل	بابل
بابلی	بابلی
بابێ	باب
بابێل	بابل
بابەت	بابت
بابەتێ	بابت
بابەتە	بابت
بابەک	بابک
باتری	باتری
باج	باج
باجی	باجی
باجەلان	باجلان
باخ	باخ
باد	باد
بادام	بادام
بار	بار
باران	باران
بارانی	بارانی
بارانێ	باران
بارانەی	بارانی
باراک	باراک
باربارا	باربارا
باربەد	باربد
باربەندی	باربندی
باردار	باردار
بارزانی	بارزانی
بارزانیێ	بارزانی
بارش	بارش
بارو	بارو
باروتی	باروتی
بارک	بارک
بارکێش	بارکش
باری	باری
باریک	باریک
باریکی	باریکی
بارێ	بار
بارە	بار
بارەبەر	باربر
بارەوە	بارو
بارەگەی	بارگی
بارەی	باری
بارەیێ	باری
باز	باز
بازار	بازار
بازارگەرمی	بازارگرمی
بازاری	بازاری
بازارێ	بازار
بازاڕ	بازار
بازاڕی	بازاری
بازاڕە	بازار
بازرگان	بازرگان
بازرگانی	بازرگانی
بازل	بازل
بازو	بازو
بازوبەند	بازوبند
بازگەو	بازگو
بازی	بازی
بازیچە	بازیچە
باسانەی	باسانی
باستان	باستان
باسلق	باسلق
باسک	باسک
باسکە	باسک
باسێک	باسک
باش	باش
باشم	باشم
باشی	باشی
باشە	باش
باشەئەو	باشو
باشەو	باشو
باغ	باغ
باغچەی	باغچی
باغی	باغی
بافت	بافت
باقر	باقر
باقری	باقری
باقی	باقی
بال	بال
بالا	بالا
بالایی	بالایی
بالی	بالی
بالێ	بال
بالێی	بالی
بالە	بال
بالەی	بالی
بام	بام
بامیە	بامیە
بان	بان
باندە	باند
بانو	بانو
بانک	بانک
بانکۆک	بانکوک
بانکی	بانکی
بانکە	بانک
بانگ	بانگ
بانی	بانی
بانە	بان
بانەو	بانو
بانەی	بانی
باور	باور
باوێر	باور
باوەر	باور
باوەرێ	باور
باوەڕ	باور
باڕباڕا	باربارا
باک	باک
باکس	باکس
باڵ	بال
باڵا	بالا
باڵاتر	بالاتر
باڵادەست	بالادست
باڵایی	بالایی
باڵندە	بالند
باڵۆن	بالون
باڵی	بالی
باڵەی	بالی
بایدن	بایدن
بایر	بایر
بایرام	بایرام
بایرن	بایرن
بایرەن	بایرن
بایکۆت	بایکوت
بایەر	بایر
بایەزید	بایزید
ببو	ببو
ببوو	ببو
ببین	ببین
ببینم	ببینم
ببینی	ببینی
ببینێ	ببین
ببینە	ببین
ببەخشێ	ببخش
ببەستێ	ببست
ببەین	ببین
بت	بت
بت پەرست	بت پرست
بتخانە	بتخانە
بتنێ	بتن
بتوان	بتوان
بتوانم	بتوانم
بتوانی	بتوانی
بتوانێ	بتوان
بتوێن	بتون
بختیار	بختیار
بخەت	بخت
بداوی	بداوی
بدرێ	بدر
بدل	بدل
بدن	بدن
بدە	بد
بدەست	بدست
بدەم	بدم
بدەن	بدن
بدەنێ	بدن
بدەنە	بدن
بدەی	بدی
بدەین	بدین
بدەینێ	بدین
بدەینە	بدین
بر	بر
برادلی	برادلی
برادەر	برادر
برادەری	برادری
براستی	براستی
برام	برام
بران	بران
براهیمی	براهیمی
براون	براون
براگا	براگا
برای	برای
برایان	برایان
برایانە	برایان
برایم	برایم
براین	براین
برایێ	برای
برایێن	براین
برج	برج
برد	برد
بردن	بردن
بردە	برد
برسی	برسی
برسێتی	برستی
برشتە	برشتە
برن	برن
برنابیۆ	برنابیو
برنار	برنار
برنارد	برنارد
برنج	برنج
برنجی	برنجی
برهان	برهان
بروات	بروات
بروج	بروج
بروجێرد	بروجرد
بروجێن	بروجن
بروس	بروس
بروشوور	بروشور
بروکسل	بروکسل
برکات	برکات
برگە	برگ
برۆج	بروج
برۆس	بروس
برۆم	بروم
برۆن	برون
برۆنۆ	برونو
برۆکسل	بروکسل
برۆکلین	بروکلین
برۆی	بروی
بری	بری
بریان	بریان
بریتیش	بریتیش
برین	برین
برینی	برینی
برێتنی	برتنی
برێز	برز
برێست	برست
برێمەن	برمن
برێنت	برنت
برێک	برک
برە	بر
برەو	برو
برەوی	بروی
بز	بز
بزر	بذر
بزن	بزن
بزە	بز
بسی	بسی
بسەر	بسر
بشار	بشار
بشیر	بشیر
بلا	بلا
بلال	بلال
بلبل	بلبل
بلند	بلند
بلندا	بلندا
بلندێ	بلند
بلور	بلور
بلوز	بلوز
بلوم	بلوم
بلومبێرگ	بلومبرگ
بلووری	بلوری
بلوچستان	بلوچستان
بلگراد	بلگراد
بلۆم	بلوم
بلۆمبێرگ	بلومبرگ
بلۆک	بلوک
بلۆکی	بلوکی
بلی	بلی
بلیت	بلیت
بلێ	بل
بلێر	بلر
بلێم	بلم
بلەز	بلز
بم	بم
بن	بن
بنجامین	بنجامین
بنغازی	بنغازی
بنکە	بنک
بنگرد	بنگرد
بنی	بنی
بنیاد	بنیاد
بنیادی	بنیادی
بنیامین	بنیامین
بنێ	بن
بنێین	بنین
بنە	بن
بنەما	بنما
بنەمایەی	بنمایی
بها	بها
بهجت	بهجت
بهرام	بهرام
بهێت	بهت
بهێتە	بهت
بهێڵێ	بهل
بو	بو
بوت	بت
بوتیمار	بوتیمار
بوخار	بخار
بوخاری	بخاری
بود	بود
بودجه	بودجه
بودن	بودن
بورج	برج
بوری	بوری
بوزی	بوزی
بوستانی	بوستانی
بوش	بوش
بوشەهر	بوشهر
بوشەهری	بوشهری
بول	بول
بولتون	بولتون
بولونیا	بولونیا
بولێ	بول
بوم	بوم
بوهار	بهار
بوو	بو
بووبوو	بوبو
بووری	بوری
بووش	بوش
بووشەهر	بوشهر
بووم	بوم
بوومە	بوم
بووە	بو
بووەبۆ	بوبو
بووەبەو	بوبو
بووەلە	بول
بووەکان	بوکان
بوکێر	بوکر
بویەرێ	بویر
بوێ	بو
بوێر	بور
بوێری	بوری
بوە	بو
بوەو	بو
بوەوە	بو
بچین	بچین
بچینە	بچین
بڕ	بر
بڕانی	برانی
بڕاون	براون
بڕایان	برایان
بڕبڕەی	بربری
بڕو	برو
بڕوات	بروات
بڕگە	برگ
بڕۆ	برو
بڕۆن	برون
بڕی	بری
بڕین	برین
بڕینی	برینی
بڕێک	برک
بڕە	بر
بڕەش	برش
بڕەکەشی	برکشی
بڕەی	بری
بڤێ	بو
بکار	بکار
بکارێ	بکار
بکت	بکت
بکر	بکر
بکری	بکری
بکرێ	بکر
بکن	بکن
بکێت	بکت
بکێشێت	بکشت
بکە	بک
بکەت	بکت
بکەن	بکن
بکەنە	بکن
بکەێن	بکن
بگری	بگری
بگیرێ	بگیر
بڵند	بلند
بڵندی	بلندی
بڵێ	بل
بڵێم	بلم
بڵێی	بلی
بڵێیت	بلیت
بۆ	بو
بۆئەم	بوم
بۆتان	بوتان
بۆتسوانا	بوتسوانا
بۆخۆم	بوخوم
بۆرخێس	بورخس
بۆردۆ	بوردو
بۆرن	بورن
بۆری	بوری
بۆریس	بوریس
بۆزانی	بوزانی
بۆستۆن	بوستون
بۆسنی	بوسنی
بۆسنیایی	بوسنیایی
بۆش	بوش
بۆشکە	بشکە
بۆفۆن	بوفون
بۆق	بوق
بۆل	بول
بۆلتن	بولتن
بۆلتۆن	بولتون
بۆلۆنیا	بولونیا
بۆلینگ	بولینگ
بۆم	بوم
بۆمباران	بمباران
بۆڕی	بوری
بۆکان	بوکان
بۆکس	بوکس
بۆگۆتا	بوگوتا
بۆڵتن	بولتن
بۆیەئەم	بویم
بۆیەی	بویی
بی	بی
بیابان	بیابان
بیابانی	بیابانی
بیان	بیان
بیانی	بیانی
بیانیان	بیانیان
بیبیسی	بیبیسی
بیت	بیت
بیتا	بیتا
بیتڵز	بیتلز
بیتێلز	بیتلز
بیجار	بیجار
بیدڵ	بیدل
بیروت	بیروت
بیست	بیست
بیستون	بیستون
بیستێ	بیست
بیستەم	بیستم
بیل	بیل
بیم	بیم
بیمار	بیمار
بیمارستان	بیمارستان
بیماری	بیماری
بیمە	بیم
بین	بین
بینا	بینا
بینایی	بینایی
بینایەی	بینایی
بینم	بینم
بینی	بینی
بینیم	بینیم
بینە	بین
بیوک	بیوک
بیژەن	بیژن
بیک	بیک
بیکاری	بیکاری
بیکەن	بیکن
بیگلۆ	بیگلو
بیە	بی
بیەو	بیو
بیەوێ	بیو
بێبەری	ببری
بێت	بت
بێتر	بطر
بێتری	بطری
بێتس	بتس
بێتیس	بتیس
بێتە	بت
بێجنۆرد	بجنورد
بێداری	بداری
بێر	بر
بێرتراند	برتراند
بێرد	برد
بێرن	برن
بێرنار	برنار
بێرنارد	برنارد
بێرنز	برنز
بێرگ	برگ
بێرگمەن	برگمن
بێرگەر	برگر
بێری	بری
بێزار	بزار
بێزاری	بزاری
بێسوود	بسود
بێسەر	بسر
بێل	بل
بێن	بن
بێنجامین	بنجامین
بێنین	بنین
بێنێ	بن
بێنێدیکت	بندیکت
بێنە	بن
بێهداد	بهداد
بێهروز	بهروز
بێهرووز	بهروز
بێهرووزی	بهروزی
بێهزاد	بهزاد
بێهمان	بهمان
بێهنام	بهنام
بێهۆش	بهوش
بێژ	بژ
بێکار	بکار
بێکاری	بکاری
بێکهام	بکهام
بێکەر	بکر
بێکەس	بکس
بێگەرد	بگرد
بێگەردی	بگردی
بێڵ	بل
بێی	بی
بێین	بین
بەئازار	بازار
بەئێران	بران
بەئێرانی	برانی
بەئێمە	بم
بەئێمەوە	بمو
بەئێمەی	بمی
بەئەبو	ببو
بەئەرک	برک
بەئەستۆ	بستو
بەئەستەم	بستم
بەئەم	بم
بەئەمەکی	بمکی
بەئەو	بو
بەئەیاد	بیاد
بەباری	بباری
بەباش	بباش
بەباشی	بباشی
بەباڵی	ببالی
بەبری	ببری
بەبڕی	ببری
بەبەرد	ببرد
بەبەرەی	ببری
بەبەندی	ببندی
بەترس	بترس
بەتمەن	بتمن
بەتۆڕی	بطوری
بەتێر	بطر
بەتەمەن	بتمن
بەتەوەری	بطوری
بەجا	بجا
بەجۆش	بجوش
بەجەنگ	بجنگ
بەجەنگی	بجنگی
بەحر	بحر
بەحری	بحری
بەحرین	بحرین
بەحرەین	بحرین
بەحس	بحث
بەحسێ	بحث
بەخت	بخت
بەختی	بختی
بەختیار	بختیار
بەختێکی	بختکی
بەخش	بخش
بەخشش	بخشش
بەخشی	بخشی
بەخشە	بخش
بەخوڕ	بخور
بەخێر	بخر
بەخەم	بخم
بەد	بد
بەدار	بدار
بەدانی	بدانی
بەدبین	بدبین
بەدبەخت	بدبخت
بەدبەختی	بدبختی
بەدخو	بدخو
بەدر	بدر
بەدران	بدران
بەدرۆ	بدرو
بەدری	بدری
بەدقەول	بدقول
بەدمەست	بدمست
بەدمەستی	بدمستی
بەدنام	بدنام
بەدوا	بدوا
بەدور	بدور
بەدوو	بدو
بەدوور	بدور
بەدووی	بدوی
بەدووەم	بدوم
بەدکار	بدکار
بەدکردار	بدکردار
بەدڵ	بدل
بەدڵی	بدلی
بەدۆزی	بدوزی
بەدی	بدی
بەدیع	بدیع
بەدیل	بدیل
بەدەر	بدر
بەدەست	بدست
بەدەستە	بدست
بەدەل	بدل
بەدەم	بدم
بەر	بر
بەرابەر	برابر
بەرابەری	برابری
بەرات	برات
بەرازی	برازی
بەراستی	براستی
بەراورد	برآورد
بەراوورد	برآورد
بەرای	برای
بەرایی	برآیی
بەرباد	برباد
بەرخوردار	برخوردار
بەرد	برد
بەردار	بردار
بەرداری	برداری
بەردی	بردی
بەردەم	بردم
بەردەمی	بردمی
بەرز	برز
بەرزن	برزن
بەرزو	برزو
بەرزە	برز
بەرزەو	برزو
بەرزەوە	برزو
بەرف	برف
بەرلین	برلین
بەرلینێ	برلین
بەرمەک	برمک
بەرن	برن
بەرنارد	برنارد
بەرهەم	برهم
بەرهەما	برهما
بەرهەمێ	برهم
بەرهەمە	برهم
بەرو	برو
بەرووی	بروی
بەرپا	برپا
بەرڤ	برو
بەرگ	برگ
بەرگری	برگری
بەرگێ	برگ
بەرگەشت	برگشت
بەرڵین	برلین
بەری	بری
بەریان	بریان
بەرید	برید
بەریدی	بریدی
بەرین	برین
بەرینی	برینی
بەریێ	بری
بەرێ	بر
بەرێز	برز
بەرێوە	برو
بەرێوەی	بروی
بەرە	بر
بەرەد	برد
بەرەف	برف
بەرەو	برو
بەرەڤ	برو
بەرەکات	برکات
بەرەکەت	برکت
بەرەکەتی	برکتی
بەرەی	بری
بەزاز	بزاز
بەزۆر	بذور
بەزەرەک	بزرک
بەزەیی	بزیی
بەس	بس
بەسامانی	بسامانی
بەست	بست
بەستن	بستن
بەستنی	بستنی
بەستوو	بستو
بەستووە	بستو
بەستی	بستی
بەستێک	بستک
بەستەنی	بستنی
بەستەگی	بستگی
بەستەی	بستی
بەسرا	بسرا
بەسره	بصره
بەسروودی	بسرودی
بەسری	بسری
بەسرە	بسر
بەسرەی	بسری
بەسزا	بسزا
بەسود	بسود
بەسوود	بسود
بەسوودی	بسودی
بەسوودە	بسود
بەسڕه	بصره
بەسڕە	بسر
بەسۆز	بسوز
بەسۆزی	بسوزی
بەسی	بسی
بەسیج	بسیج
بەسێ	بس
بەسە	بس
بەسەختی	بسختی
بەسەر	بسر
بەسەرا	بسرا
بەسەری	بسری
بەسەڕ	بسر
بەش	بش
بەشار	بشار
بەشارەتی	بشارتی
بەشوو	بشو
بەشووی	بشوی
بەشکست	بشکست
بەشکستی	بشکستی
بەشیر	بشیر
بەشیری	بشیری
بەشێ	بش
بەشێوەی	بشوی
بەشێکن	بشکن
بەشە	بش
بەشەو	بشو
بەشەوە	بشو
بەشەڕ	بشر
بەشەڕی	بشری
بەعس	بعث
بەعسە	بعث
بەغداد	بغداد
بەغدادی	بغدادی
بەغدادیە	بغدادی
بەفرۆشی	بفروشی
بەفشاری	بفشاری
بەقەدەر	بقدر
بەلاغی	بلاغی
بەلژیک	بلژیک
بەلژیکی	بلژیکی
بەلی	بلی
بەلێ	بل
بەلەد	بلد
بەلەم	بلم
بەلەمی	بلمی
بەم	بم
بەماڵ	بمال
بەماڵی	بمالی
بەمۆ	بمو
بەمە	بم
بەن	بن
بەنا	بنا
بەناز	بناز
بەنایی	بنایی
بەند	بند
بەندی	بندی
بەندێک	بندک
بەندە	بند
بەندەر	بندر
بەندەری	بندری
بەندەی	بندی
بەنزین	بنزین
بەنغازی	بنغازی
بەنک	بنک
بەنگ	بنگ
بەنگال	بنگال
بەنگالی	بنگالی
بەنگلادش	بنگلادش
بەنگی	بنگی
بەنی	بنی
بەنیامین	بنیامین
بەنەوت	بنوت
بەها	بها
بەهار	بهار
بەهاران	بهاران
بەهاری	بهاری
بەهارە	بهار
بەهجەت	بهجت
بەهرام	بهرام
بەهرامی	بهرامی
بەهروز	بهروز
بەهرۆز	بهروز
بەهزاد	بهزاد
بەهشت	بهشت
بەهمەن	بهمن
بەهمەنی	بهمنی
بەهی	بهی
بەهێمنی	بهمنی
بەهێڵی	بهلی
بەهەر	بهر
بەهەرحاڵ	بهرحال
بەهەشت	بهشت
بەهەشتی	بهشتی
بەهەل	بهل
بەهەمان	بهمان
بەهەڵە	بهل
بەهەڵەی	بهلی
بەو	بو
بەواسیر	بواسیر
بەوزەی	بوزی
بەوش	بوش
بەوە	بو
بەوەدا	بودا
بەوەش	بوش
بەوەوە	بو
بەپرس	بپرس
بەپرسی	بپرسی
بەپێز	بپز
بەپێزی	بپزی
بەپێک	بپک
بەپەسند	بپسند
بەپەسەند	بپسند
بەچاپ	بچاپ
بەچاپی	بچاپی
بەچڕی	بچری
بەچین	بچین
بەچەک	بچک
بەچەکی	بچکی
بەڕ	بر
بەڕابەری	برابری
بەڕاستی	براستی
بەڕای	برای
بەڕوون	برون
بەڕووی	بروی
بەڕوی	بروی
بەڕگری	برگری
بەڕی	بری
بەڕیز	بریز
بەڕێ	بر
بەڕێز	برز
بەڕێوە	برو
بەڕێوەن	برون
بەڕێوەی	بروی
بەڕێوەیە	بروی
بەڕێک	برک
بەڕێکردن	برکردن
بەڕە	بر
بەڕەو	برو
بەڕەی	بری
بەکار	بکار
بەکاری	بکاری
بەکام	بکام
بەکر	بکر
بەکردەی	بکردی
بەکری	بکری
بەکرێ	بکر
بەکرێی	بکری
بەکۆچی	بکوچی
بەکێ	بک
بەکێشانی	بکشانی
بەکێشەی	بکشی
بەکەس	بکس
بەکەسی	بکسی
بەکەشتی	بکشتی
بەگرفتی	بگرفتی
بەگری	بگری
بەگشت	بگشت
بەگشتی	بگشتی
بەگەڕان	بگران
بەڵا	بلا
بەڵی	بلی
بەڵێ	بل
بەڵێی	بلی
بەی	بی
بەیات	بیات
بەیاتی	بیاتی
بەیاد	بیاد
بەیاسا	بیاسا
بەیان	بیان
بەیانی	بیانی
بەیانێ	بیان
بەیانەی	بیانی
بەیت	بیت
بەیروت	بیروت
بەیرووت	بیروت
بەیزایی	بیضایی
بەیگی	بیگی
بەیەک	بیک
تا	تا
تابان	تابان
تابلو	تابلو
تابلۆ	تابلو
تابلۆیی	تابلویی
تابلۆیەی	تابلویی
تابناک	تابناک
تابڵۆ	تابلو
تابین	تابین
تاتوێ	تاتو
تاج	تاج
تاجیک	تاجیک
تاخیر	تاخیر
تار	تار
تارا	تارا
تارق	طارق
تارومار	تارومار
تاری	تاری
تاریخ	تاریخ
تاریک	تاریک
تاریک کردن	تاریک کردن
تاریکی	تاریکی
تازیانە	تازیانە
تازە	تازە
تازەش	تازش
تازەم	تازم
تازەکار	تازەکار
تازەی	تازی
تازەیان	تازیان
تازەیە	تازی
تاق	تاق
تاقی	تاقی
تالار	تالار
تالب	طالب
تالبی	طالبی
تام	تام
تامس	تامس
تامی	تامی
تامیل	تامیل
تانک	تانک
تانکی	تانکی
تانکەر	تانکر
تانگۆ	تانگو
تانی	تانی
تانەی	تانی
تاها	طاها
تاهر	طاهر
تاوان	تاوان
تاوانێ	تاوان
تاوانە	تاوان
تاپۆ	تاپو
تاچێر	تاچر
تاک	تاک
تاکسی	تاکسی
تاکی	تاکی
تاکێ	تاک
تاکە	تاک
تاکەی	تاکی
تاڵب	طالب
تاڵبانی	طالبانی
تایسۆن	تایسون
تایلەند	تایلند
تایم	تایم
تایمز	تایمز
تایوان	تایوان
تایوانی	تایوانی
تایپ	تایپ
تایپە	تایپ
تایەر	تایر
تایەی	تایی
تبت	تبت
تبتی	تبتی
تحسین	تحسین
تدفین	تدفین
تر	تر
ترا	ترا
ترازو	ترازو
ترافیک	ترافیک
تراک	تراک
تراکتۆر	تراکتور
ترس	ترس
ترس و لەرز	ترس و لرز
ترسا	ترسا
ترسان	ترسان
ترساندن	ترساندن
ترسناک	ترسناک
ترسناکی	ترسناکی
ترسناکە	ترسناک
ترسی	ترسی
ترسەی	ترسی
ترش	ترش
ترشاندن	ترشاندن
ترشی	ترشی
ترن	ترن
ترنج	ترنج
تروفۆ	تروفو
ترکی	ترکی
ترکیێ	ترکی
تریاک	تریاک
تریاکی	تریاکی
تریلیۆن	تریلیون
ترێ	تر
ترە	تر
ترەک	ترک
تشت	تشت
تشتێ	تشت
تشتەکێ	تشتک
تف	تف
تفو	تفو
تفەنگ	تفنگ
تفەنگساز	تفنگساز
تلوعی	طلوعی
تماشا	تماشا
تمام	تمام
تمر	تمر
تنێ	تن
تنێسی	تنسی
تهران	تهران
تو	تو
توان	تان
توان	توان
توانا	توانا
توانایی	توانایی
توانستن	توانستن
توانستی	توانستی
توانی	توانی
توانیم	توانیم
تواین	تواین
توت	توت
توتو	توتو
توتیا	توتیا
توخم	تخم
توران	توران
تورش	ترش
تورقە	تورق
تورینۆ	تورینو
تورێ	تور
تورێن	تورن
تورەج	تورج
توز	توز
توش	توش
توفیق	توفیق
تومار	طومار
توماس	توماس
توند	تند
توندی	تندی
تونس	تونس
تونسێ	تونس
تونگ	تنگ
تونی	تونی
تونێل	تونل
توو	تو
توورە	تور
توورەج	تورج
تووسی	توسی
تووش	توش
توونس	تونس
تووی	توی
توپی	توپی
توڕە	تور
توڕەن	تورن
توڕەی	توری
توی	توی
تویوتا	تویوتا
توێکاری	توکاری
توێکڵی	توکلی
تکریت	تکریت
تکریتی	تکریتی
تۆ	تو
تۆبی	طوبی
تۆتال	توتال
تۆتاڵ	توتال
تۆتی	طوطی
تۆران	توران
تۆرنتۆ	تورنتو
تۆری	توری
تۆریس	توریس
تۆرین	تورین
تۆرینو	تورینو
تۆرینۆ	تورینو
تۆرێ	تور
تۆرێنتۆ	تورنتو
تۆرەی	توری
تۆز	توز
تۆش	توش
تۆفان	توفان
تۆفانی	توفانی
تۆفیق	توفیق
تۆلستۆی	تولستوی
تۆلۆز	تولوز
تۆمار	طومار
تۆماری	طوماری
تۆماس	توماس
تۆن	تون
تۆنی	تونی
تۆپ	توپ
تۆپی	توپی
تۆپێ	توپ
تۆڕ	تور
تۆڕی	توری
تۆڕە	تور
تۆکیۆ	توکیو
تۆگۆ	توگو
تۆڵ	طول
تۆڵی	تولی
تۆڵە	طول
تۆڵەی	تولی
تۆی	توی
تۆیۆتا	تویوتا
تی	تی
تیر	تیر
تیرانا	تیرانا
تیرباران	تیرباران
تیردان	تیردان
تیغ	تیغ
تیلۆر	تیلور
تیم	تیم
تیماری	تیماری
تیمۆر	تیمور
تیمی	تیمی
تیمێ	تیم
تیمە	تیم
تیمەی	تیمی
تین	تین
تینا	تینا
تیوری	تیوری
تیپ	تیپ
تیپا	تیپا
تیپێ	تیپ
تیپە	تیپ
تیۆری	تیوری
تێبەر	تبر
تێد	تد
تێر	تر
تێرۆر	ترور
تێست	تست
تێل	تل
تێلێگراف	تلگراف
تێن	تن
تێنسی	تنسی
تێوەری	توری
تێڤێز	توز
تێک	تک
تێکدەر	تکدر
تێکی	تکی
تێکەل	تکل
تێکەڵ	تکل
تێڵا	طلا
تێی	تی
تێیلۆر	تیلور
تەب	تب
تەباخ	طباخ
تەباخی	طباخی
تەبر	تبر
تەبریزی	تبریزی
تەبەرزین	تبرزین
تەبەق	طبق
تەجاوز	تجاوز
تەحریر	تحریر
تەحریری	تحریری
تەحسین	تحسین
تەخت	تخت
تەختی	تختی
تەختەی	تختی
تەدوین	تدوین
تەرابلس	طرابلس
تەراز	تراز
تەرخون	ترخون
تەرم	ترم
تەرمێ	ترم
تەرک	ترک
تەریقەتی	طریقتی
تەرەقی	ترقی
تەزویر	تزویر
تەسلیم	تسلیم
تەسلیمی	تسلیمی
تەسویر	تسویر
تەسەلی	تسلی
تەسەور	تصور
تەسەوف	تصوف
تەشت	تشت
تەشەر	تشر
تەعبیر	تعبیر
تەعجیل	تعجیل
تەعریف	تعریف
تەعمە	طعم
تەق	تق
تەقدیری	تقدیری
تەقی	تقی
تەقە	تق
تەقەی	تقی
تەقەیان	تقیان
تەل	تل
تەلاش	تلاش
تەلاق	طلاق
تەلسک	تلسک
تەلعەت	طلعت
تەلهە	تله
تەلەبە	طلب
تەلەف	تلف
تەم	تم
تەماشا	تماشا
تەمتەراق	تمتراق
تەمر	تمر
تەمیز	تمیز
تەمیزی	تمیزی
تەمییز	تمییز
تەمەر	تمر
تەمەنا	تمنا
تەن	تن
تەنبوور	تنبور
تەنتاوی	طنطاوی
تەندیس	تندیس
تەندیسی	تندیسی
تەندەر	تندر
تەندەری	تندری
تەنز	طنز
تەنسی	تنسی
تەنها	تنها
تەنور	تنور
تەنوور	تنور
تەنک	تنک
تەنگ	تنگ
تەنگدەست	تنگدست
تەنگی	تنگی
تەنگەی	تنگی
تەنی	تنی
تەنیێن	طنین
تەنێ	تن
تەنێک	تنک
تەنێکی	تنکی
تەهران	تهران
تەهرانێ	تهران
تەهماسب	تهماسب
تەهموورس	تهمورث
تەوافق	توافق
تەوافقی	توافقی
تەوحید	توحید
تەوحیدی	توحیدی
تەوفیق	توفیق
تەوفیقی	توفیقی
تەونی	تونی
تەویل	طویل
تەوەر	تور
تەوەران	توران
تەوەری	توری
تەوەرێ	تور
تەوەرێن	تورن
تەوەرەی	توری
تەپڵی	تپلی
تەپە	تپ
تەڕ	تر
تەڤ	تو
تەڤی	توی
تەک	تک
تەکان	تکان
تەکلیف	تکلیف
تەکمیل	تکمیل
تەکنیک	تکنیک
تەڵاق	طلاق
تەڵاقی	تلاقی
تەڵعەت	طلعت
تەڵەبە	طلب
تەڵەبەی	طلبی
تەیاب	طیاب
تەیب	طیب
تەیمور	تیمور
تەیموور	تیمور
جا	جا
جابر	جابر
جابری	جابری
جاجم	جاجم
جادوو	جادو
جادوگەر	جادوگر
جادوگەری	جادوگری
جادەو	جادو
جار	جار
جاری	جاری
جارێ	جار
جارە	جار
جارەئەو	جارو
جارەو	جارو
جارەی	جاری
جاز	جاز
جاستین	جاستین
جاسم	جاسم
جاسوس	جاسوس
جاش	جاش
جام	جام
جامی	جامی
جان	جان
جاناتان	جاناتان
جانسۆن	جانسون
جانماز	جانماز
جانی	جانی
جانێ	جان
جانێت	جانت
جانەوەر	جانور
جاوید	جاوید
جاویدی	جاویدی
جاکارتا	جاکارتا
جبار	جبار
جدا	جدا
جدی	جدی
جری	جری
جسر	جسر
جسیکا	جسیکا
جعفر	جعفر
جفری	جفری
جل	جل
جلال	جلال
جلو	جلو
جلیل	جلیل
جم	جم
جمال	جمال
جمهوری	جمهوری
جمیل	جمیل
جن	جن
جنوب	جنوب
جنیفێر	جنیفر
جهان	جهان
جهی	جهی
جو	جو
جواب	جواب
جواد	جواد
جوال	جوال
جوان	جوان
جوانی	جوانی
جوانێ	جوان
جوانە	جوان
جواهێر	جواهر
جود	جود
جودا	جدا
جودی	جودی
جور	جور
جورج	جورج
جورێ	جور
جولای	جولای
جولی	جولی
جولیا	جولیا
جولەی	جولی
جون	جون
جونز	جونز
جونیۆر	جونیور
جونەی	جونی
جوهر	جوهر
جوو	جو
جوولای	جولای
جوولەی	جولی
جوون	جون
جوونی	جونی
جووڵەی	جولی
جوڵەی	جولی
جڤیا	جویا
جڤینێ	جوین
جگێری	جگری
جگەر	جگر
جگەری	جگری
جگەرە	جگر
جگەرەی	جگری
جڵەوی	جلوی
جۆ	جو
جۆدۆ	جودو
جۆر	جور
جۆراجۆر	جوراجور
جۆرج	جورج
جۆرجیا	جورجیا
جۆرناڵ	جورنال
جۆرێ	جور
جۆرە	جور
جۆزێ	جوز
جۆزێف	جوزف
جۆش	جوش
جۆلان	جولان
جۆلی	جولی
جۆلیا	جولیا
جۆن	جون
جۆنز	جونز
جۆنی	جونی
جۆنیۆر	جونیور
جۆهەر	جوهر
جۆیس	جویس
جی	جی
جیانی	جیانی
جیبۆتی	جیبوتی
جیران	جیران
جیسۆن	جیسون
جیم	جیم
جیمز	جیمز
جیمی	جیمی
جین	جین
جیوڤانی	جیووانی
جیوە	جیوە
جێت	جت
جێرارد	جرارد
جێراڵد	جرالد
جێری	جری
جێسیکا	جسیکا
جێف	جف
جێفری	جفری
جێم	جم
جێمی	جمی
جێن	جن
جێنیفێر	جنیفر
جێنیفەر	جنیفر
جێنەوا	جنوا
جێگر	جگر
جێگری	جگری
جێگرێ	جگر
جێگرێکی	جگرکی
جێی	جی
جێیسۆن	جیسون
جەبار	جبار
جەباری	جباری
جەبارە	جبار
جەبر	جبر
جەبەل	جبل
جەبەلی	جبلی
جەراح	جراح
جەزا	جزا
جەزائیر	جزایر
جەزایر	جزایر
جەزایری	جزایری
جەستە	جست
جەستەی	جستی
جەسیکا	جسیکا
جەعفەر	جعفر
جەعفەری	جعفری
جەلا	جلا
جەلاد	جلاد
جەلادەت	جلادت
جەلال	جلال
جەلالی	جلالی
جەلالیان	جلالیان
جەلاڵ	جلال
جەلیل	جلیل
جەلیلی	جلیلی
جەلیلیان	جلیلیان
جەلەبی	جلبی
جەم	جم
جەمال	جمال
جەمالی	جمالی
جەماڵ	جمال
جەمشید	جمشید
جەمشیدی	جمشیدی
جەمیل	جمیل
جەمیلی	جمیلی
جەناب	جناب
جەنابی	جنابی
جەنابێ	جناب
جەنجال	جنجال
جەنرال	جنرال
جەنڕاڵ	جنرال
جەنگ	جنگ
جەنگاوەر	جنگاور
جەنگی	جنگی
جەنگێ	جنگ
جەنگە	جنگ
جەنگەی	جنگی
جەنەتی	جنتی
جەنەرال	جنرال
جەنەراڵ	جنرال
جەنەوا	جنوا
جەنەڕاڵ	جنرال
جەهانگیر	جهانگیر
جەهی	جهی
جەو	جو
جەواد	جواد
جەوادی	جوادی
جەوان	جوان
جەودەت	جودت
جەولەی	جولی
جەوهەر	جوهر
جەوهەری	جوهری
جەوییە	جویی
جەک	جک
جەکسۆن	جکسون
جەکی	جکی
جەگەر	جگر
جەگەن	جگن
جەڵال	جلال
جەی	جی
جەیش	جیش
حاتم	حاتم
حاتەم	حاتم
حاتەمی	حاتمی
حاج	حاج
حاجی	حاجی
حاجیان	حاجیان
حارس	حارث
حازر	حاضر
حاشا	حاشا
حاشیە	حاشیە
حافز	حافظ
حافزی	حافظی
حالەت	حالت
حامد	حامد
حامدی	حامدی
حاملە	حاملە
حاکم	حاکم
حاکمی	حاکمی
حاڵ	حال
حاڵەت	حالت
حاڵەتە	حالت
حبیب	حبیب
حجاب	حجاب
حدود	حدود
حزب	حزب
حزبە	حزب
حساب	حساب
حسابی	حسابی
حسام	حسام
حسن	حسن
حسنی	حسنی
حسین	حسین
حسینی	حسینی
حسێن	حسن
حسێنی	حسنی
حلە	حل
حمایت	حمایت
حمد	حمد
حمس	حمص
حمید	حمید
حومام	حمام
حوکم	حکم
حکمت	حکمت
حکمەت	حکمت
حکومەت	حکومت
حکومەتێ	حکومت
حکومەتە	حکومت
حکوومەت	حکومت
حکیم	حکیم
حیدر	حیدر
حیلە	حیلە
حەب	حب
حەبی	حبی
حەبیب	حبیب
حەبیبی	حبیبی
حەبە	حب
حەتا	حتا
حەج	حج
حەجاج	حجاج
حەداد	حداد
حەدادی	حدادی
حەدود	حدود
حەراج	حراج
حەرام	حرام
حەرب	حرب
حەربی	حربی
حەریر	حریر
حەریری	حریری
حەرەکەت	حرکت
حەز	حظ
حەزرەتی	حضرتی
حەزم	حزم
حەساب	حساب
حەسار	حصار
حەساری	حصاری
حەسن	حسن
حەسیر	حصیر
حەسەن	حسن
حەسەنپور	حسنپور
حەسەنی	حسنی
حەسەنیان	حسنیان
حەسەنە	حسن
حەشیش	حشیش
حەشیشە	حشیش
حەشەری	حشری
حەق	حق
حەقانی	حقانی
حەقی	حقی
حەقیقی	حقیقی
حەقیقەت	حقیقت
حەقیقەتی	حقیقتی
حەلاج	حلاج
حەلوا	حلوا
حەلەب	حلب
حەلەبی	حلبی
حەماس	حماس
حەماسی	حماسی
حەمام	حمام
حەمایل	حمایل
حەمدان	حمدان
حەمدانی	حمدانی
حەمدی	حمدی
حەمس	حمص
حەمید	حمید
حەمیدی	حمیدی
حەمەد	حمد
حەنا	حنا
حەنیفی	حنیفی
حەنین	حنین
حەنەفی	حنفی
حەوا	حوا
حەواس	حواس
حەوت	حوت
حەوز	حوض
حەوێز	حوض
حەکیم	حکیم
حەکیمی	حکیمی
حەکەم	حکم
حەڵەب	حلب
حەی	حی
حەیا	حیا
حەیات	حیات
حەیاتی	حیاتی
حەیدر	حیدر
حەیدەر	حیدر
حەیدەری	حیدری
حەیران	حیران
حەیرانی	حیرانی
حەیزەران	حیزران
حەیفا	حیفا
حەیوان	حیوان
خاتری	خاطری
خاتون	خاتون
خاتوون	خاتون
خاتوونی	خاتونی
خاتەمی	خاتمی
خار	خار
خاردار	خاردار
خارش	خارش
خارکەن	خارکن
خاس	خاص
خاست	خاست
خاشاک	خاشاک
خال	خال
خالد	خالد
خالدی	خالدی
خالس	خالص
خالقی	خالقی
خالی	خالی
خام	خام
خامۆش	خاموش
خامۆشی	خاموشی
خامی	خامی
خان	خان
خانزادی	خانزادی
خانم	خانم
خانمان	خانمان
خانمی	خانمی
خانمە	خانم
خانکێ	خانک
خانی	خانی
خانیان	خانیان
خانێی	خانی
خانە	خان
خانە	خانە
خانەزاد	خانەزاد
خانەی	خانی
خانەیەکی	خانیکی
خاور	خاور
خاویێر	خاویر
خاویەر	خاویر
خاوەر	خاور
خاک	خاک
خاکسار	خاکسار
خاکشیر	خاکشیر
خاکی	خاکی
خاکێ	خاک
خاکە	خاکە
خاکەساری	خاکساری
خاڵ	خال
خاڵس	خالص
خاڵقی	خالقی
خاڵی	خالی
خاڵە	خال
خاڵەی	خالی
خایەن	خاین
خایەند	خایند
خایەنی	خاینی
خبر	خبر
خدا	خدا
خدری	خدری
خراب	خراب
خرامان	خرامان
خرس	خرس
خرما	خرما
خزر	خزر
خزم	خزم
خزێرە	خزر
خست	خست
خستن	خستن
خستنە	خستن
خستووە	خستو
خستە	خست
خستەوە	خستو
خستەوەو	خستو
خسرو	خسرو
خسرۆ	خسرو
خشت	خشت
خشتەی	خشتی
خشم	خشم
خفتان	خفتان
خلف	خلف
خلیل	خلیل
خنجێر	خنجر
خنجەر	خنجر
خو	خو
خوار	خوار
خوارێ	خوار
خواست	خواست
خواستن	خواستن
خواستی	خواستی
خواستەنی	خواستنی
خواستەی	خواستی
خوان	خوان
خواندن	خواندن
خواندنی	خواندنی
خواندنێ	خواندن
خواندی	خواندی
خوانی	خوانی
خواهش	خواهش
خوب	خوب
خود	خود
خودا	خدا
خودبینی	خودبینی
خودرەو	خودرو
خودسەری	خودسری
خودپەسند	خودپسند
خودی	خودی
خودێ	خود
خور	خور
خوراک	خوراک
خوراکی	خوراکی
خورد	خورد
خورشید	خورشید
خورشیدی	خورشیدی
خورما	خرما
خوری	خوری
خوزستان	خوزستان
خوش	خوش
خوشی	خوشی
خول	خل
خوم	خم
خومار	خمار
خوماری	خماری
خوو	خو
خووی	خوی
خووە	خو
خوڕەم	خورم
خوی	خوی
خویێ	خوی
خوێ	خو
خوێن	خون
خوێنە	خون
خوێی	خوی
خوە	خو
خوەب	خوب
خوەد	خود
خوەدێ	خود
خوەش	خوش
خوەو	خو
خوەیێ	خوی
خۆ	خو
خۆر	خور
خۆراک	خوراک
خۆراکی	خوراکی
خۆراکە	خوراک
خۆردی	خوردی
خۆری	خوری
خۆریان	خوریان
خۆش	خوش
خۆشبوو	خوشبو
خۆشبەخت	خوشبخت
خۆشبەختی	خوشبختی
خۆشتر	خوشتر
خۆشحالی	خوشحالی
خۆشحاڵ	خوشحال
خۆشحاڵی	خوشحالی
خۆشحاڵە	خوشحال
خۆشخوو	خوشخو
خۆشی	خوشی
خۆشە	خوش
خۆلیۆ	خولیو
خۆی	خوی
خۆیشی	خویشی
خۆیی	خویی
خۆێ	خو
خیابانی	خیابانی
خیار	خیار
خیانەت	خیانت
خیگ	خیگ
خێر	خر
خێراش	خراش
خێری	خری
خێرێس	خرس
خێزان	خزان
خێزانێ	خزان
خێزانە	خزان
خێمە	خم
خێڵی	خلی
خێڵەکان	خلکان
خەبەر	خبر
خەت	خط
خەتاب	خطاب
خەتی	خطی
خەتیب	خطیب
خەتیبی	خطیبی
خەر	خر
خەرامان	خرامان
خەرتوم	خرطوم
خەرج	خرج
خەرجی	خرجی
خەردەل	خردل
خەرف	خرف
خەروار	خروار
خەرەف	خرف
خەز	خز
خەزاعی	خزاعی
خەزان	خزان
خەزعەلی	خزعلی
خەست	خست
خەسرۆ	خسرو
خەسرەو	خسرو
خەسیس	خسیس
خەشایار	خشایار
خەشخاش	خشخاش
خەلدون	خلدون
خەلق	خلق
خەلیفەی	خلیفی
خەلیقی	خلیقی
خەلیل	خلیل
خەلیلی	خلیلی
خەلەف	خلف
خەلەکان	خلکان
خەم	خم
خەمی	خمی
خەمیر	خمیر
خەنازیر	خنازیر
خەنجەر	خنجر
خەنجەربازی	خنجربازی
خەندان	خندان
خەندقی	خندقی
خەندەق	خندق
خەو	خو
خەون	خون
خەوی	خوی
خەڵق	خلق
خەڵوەت	خلوت
خەڵکان	خلکان
خەڵکانی	خلکانی
خەڵی	خلی
خەڵەف	خلف
خەڵەفی	خلفی
خەیات	خیاط
خەیاتی	خیاطی
خەیار	خیار
خەیام	خیام
خەیانەت	خیانت
خەیاڵ	خیال
خەیبەر	خیبر
خەیر	خیر
خەیری	خیری
خەیمە	خیم
دئاشتی	داشتی
دئەڤ	دو
دئەڤێ	دو
دات	دات
داخل	داخل
داخلی	داخلی
داخڵ	داخل
داخڵی	داخلی
داد	داد
دادوەر	دادور
دادوەری	دادوری
دادوەریێ	دادوری
دادوەرێ	دادور
دادپەروەر	دادپرور
دادگەر	دادگر
دادی	دادی
دادێ	داد
دادەنێ	دادن
دادەوەری	دادوری
دار	دار
دارا	دارا
دارابی	دارابی
دارای	دارای
دارایی	دارایی
داراییە	دارایی
داربەست	داربست
دارستان	دارستان
دارستانێ	دارستان
دارفور	دارفور
دارفۆر	دارفور
دارم	دارم
دارو	دارو
داروغە	دارغە
داروین	داروین
دارچین	دارچین
داری	داری
داریوش	داریوش
داریووش	داریوش
داریۆ	داریو
دارێن	دارن
دارە	دار
داس	داس
داستان	داستان
داستانی	داستانی
داستین	داستین
داغ	داغ
داغان	داغان
دال	دال
دالاس	دالاس
دالایی	دالایی
دام	دام
دامان	دامان
دامێن	دامن
دامەن	دامن
دان	دان
دانا	دانا
دانایی	دانایی
دانش	دانش
دانمارک	دانمارک
دانی	دانی
دانیال	دانیال
دانیاڵ	دانیال
دانیل	دانیل
دانیێل	دانیل
دانیێلی	دانیلی
دانیەل	دانیل
دانێ	دان
دانە	دان
دانە	دانە
دانەی	دانی
داو	داو
داود	داود
داودی	داودی
داون	داون
داوود	داوود
داوودی	داوودی
داوون	داون
داوێن	داون
داوە	داو
داوەری	داوری
داوەو	داو
داڤۆس	داووس
داڤینچی	داوینچی
داڤێد	داود
داکا	داکا
داگڵاس	داگلاس
دایانا	دایانا
دایرە	دایر
دایه	دایه
دایۆ	دایو
دایی	دایی
دایە	دایە
دایەئەو	دایو
دایەن	داین
دایەو	دایو
دایەوە	دایو
دایەوەو	دایو
دبلیۆ	دبلیو
دبە	دب
دخەت	دخت
ددت	ددت
ددەت	ددت
در	در
درام	درام
درایی	درآیی
درایە	درای
درد	درد
درز	درز
درزی	درزی
درست	درست
درشت	درشت
درودی	درودی
دروست	درست
دروودی	درودی
درویش	درویش
دروێنەی	درونی
درک	درک
درۆ	درو
درۆگبا	دروگبا
درۆی	دروی
دریم	دریم
دریچە	دریچە
درێ	در
درێسی	درسی
درێک	درک
درەخت	درخت
درەختی	درختی
درەخشان	درخشان
درەنگ	درنگ
درەو	درو
درەوەی	دروی
دز	دز
دزی	دزی
دزە	دز
دزەی	دزی
دست	دست
دشمن	دشمن
دشمنی	دشمنی
دشنە	دشنە
دشوار	دشوار
دشێت	دشت
دل	دل
دلاوەر	دلاور
دلدار	دلدار
دلشاد	دلشاد
دلیر	دلیر
دلێ	دل
دن	دن
دندان	دندان
دنڤەر	دنور
دنیا	دنیا
دنیس	دنیس
دهات	دهات
دهۆل	دهل
دهێن	دهن
دو	دو
دوا	دوا
دوارێ	دوار
دوازدە	دوازدە
دوازدەهەم	دوازدهم
دوان	دوان
دوانی	دوانی
دواکەوتن	دواکەوتن
دوایی	دوایی
دواییە	دوایی
دوایەی	دوایی
دوبارە	دوبار
دوبارە	دوبارە
دوبلاژ	دوبلاژ
دوبلین	دوبلین
دوبەی	دوبی
دود	دود
دودکێش	دودکش
دودە	دودە
دور	دور
دورتموند	دورتموند
دورست	درست
دورو	دورو
دوری	دوری
دورە	دور
دوست	دوست
دوشاخە	دوشاخە
دوشمن	دشمن
دوشمنی	دشمنی
دوعا	دعا
دولولە	دولول
دوم	دوم
دوما	دوما
دومای	دومای
دومل	دمل
دونیمە	دونیمە
دوو	دوو
دووا	دوا
دووان	دوان
دووانی	دوانی
دووانە	دوان
دووانەی	دوانی
دووبار	دوبار
دووبارە	دوبار
دووبەی	دوبی
دوودڵ	دودل
دوودڵی	دودلی
دوور	دور
دووربین	دوربین
دوورتر	دورتر
دوورو	دورو
دووری	دوری
دوورە	دور
دوورەو	دورو
دووست	دوست
دووشەم	دوشم
دووشەمە	دوشم
دوولا	دولا
دووم	دوم
دوومین	دومین
دوونی	دنی
دووو	دوو
دووڤ	دوو
دووک	دوک
دووی	دوی
دوویێ	دوی
دووێ	دو
دووە	دو
دووەم	دوم
دووەمین	دومین
دووەمە	دوم
دوچار	دچار
دوچەندان	دوچندان
دوچەندانە	دوچندان
دوک	دوک
دوکان	دکان
دوکاندار	دکاندار
دویێ	دوی
دوێ	دو
دوێنی	دونی
دوێنێ	دون
دوێنێی	دونی
دوەم	دوم
دوەمین	دومین
دژ	دژ
دژاکام	دژاکام
دژە	دژ
دڤان	دوان
دڤی	دوی
دڤید	دوید
دڤێ	دو
دڤێد	دود
دکان	دکان
دکەو	دکو
دڵ	دل
دڵبەر	دلبر
دڵتەنگ	دلتنگ
دڵتەنگی	دلتنگی
دڵخۆش	دلخوش
دڵخۆشی	دلخوشی
دڵدار	دلدار
دڵسۆز	دلسوز
دڵسۆزی	دلسوزی
دڵشاد	دلشاد
دڵشادی	دلشادی
دڵە	دل
دڵەوە	دلو
دۆ	دو
دۆبلاژ	دوبلاژ
دۆر	دور
دۆران	دوران
دۆرە	دور
دۆرەی	دوری
دۆزی	دوزی
دۆزەخ	دوزخ
دۆست	دوست
دۆستان	دوستان
دۆستانە	دوستان
دۆستی	دوستی
دۆغان	دوغان
دۆما	دوما
دۆمای	دومای
دۆمینیک	دومینیک
دۆمێنیک	دومنیک
دۆن	دون
دۆنالد	دونالد
دۆناڵد	دونالد
دۆنی	دونی
دۆڕان	دوران
دۆیل	دویل
دی	دی
دیار	دیار
دیاری	دیاری
دیارە	دیار
دیاله	دیاله
دیالۆگ	دیالوگ
دیالۆگە	دیالوگ
دیترۆیت	دیترویت
دیجیتال	دیجیتال
دیجیتاڵ	دیجیتال
دید	دید
دیدا	دیدا
دیدار	دیدار
دیدارێ	دیدار
دیدارە	دیدار
دیدی	دیدی
دیدیێ	دیدی
دیدێ	دید
دیدەنی	دیدنی
دیر	دیر
دیرک	دیرک
دیزنی	دیزنی
دیس	دیس
دیلمان	دیلمان
دیلی	دیلی
دیمیتری	دیمیتری
دیمەن	دیمن
دیمەنە	دیمن
دین	دین
دینار	دینار
دیناری	دیناری
دینارە	دینار
دینارەی	دیناری
دیندار	دیندار
دینۆ	دینو
دینی	دینی
دیو	دی
دیو	دیو
دیوار	دیوار
دیوارێک	دیوارک
دیوان	دیوان
دیوانی	دیوانی
دیوانیە	دیوانی
دیوجامە	دیجامە
دیوی	دیوی
دیوید	دیوید
دیوە	دیو
دیڤ	دیو
دیڤید	دیوید
دیڤە	دیو
دیک	دیک
دیکنز	دیکنز
دیکە	دیک
دیگر	دیگر
دیگۆ	دیگو
دیۆن	دیون
دیێ	دی
دیێن	دین
دیێگۆ	دیگو
دێر	در
دێربی	دربی
دێرک	درک
دێری	دری
دێرین	درین
دێل	دل
دێم	دم
دێمی	دمی
دێن	دن
دێنیرۆ	دنیرو
دێنیس	دنیس
دێنێ	دن
دێنە	دن
دێهات	دهات
دێهاتی	دهاتی
دێهباشی	دهباشی
دێهقان	دهقان
دێهقانی	دهقانی
دێو	دو
دێوانە	دوان
دێڤد	دود
دێڤید	دوید
دێڤێد	دود
دێی	دی
دێین	دین
دێیڤید	دیوید
دێیڤیس	دیویس
دەباغ	دباغ
دەباغی	دباغی
دەبلیو	دبلیو
دەبی	دبی
دەبیری	دبیری
دەبێ	دب
دەبەی	دبی
دەخیل	دخیل
دەر	در
دەراجی	دراجی
دەرانی	درانی
دەربار	دربار
دەربارێ	دربار
دەرباز	درباز
دەربان	دربان
دەربەست	دربست
دەربەستە	دربست
دەربەند	دربند
دەرحەق	درحق
دەرد	درد
دەردمەند	دردمند
دەردی	دردی
دەرزی	درزی
دەرس	درس
دەرمان	درمان
دەرمانی	درمانی
دەرمانە	درمان
دەرمانەی	درمانی
دەرهەم	درهم
دەرونی	درونی
دەروون	درون
دەروونی	درونی
دەرویش	درویش
دەرویشی	درویشی
دەروەی	دروی
دەرڤەی	دروی
دەرڤەیێ	دروی
دەرک	درک
دەرگەهێ	درگه
دەرۆن	درون
دەری	دری
دەریا	دریا
دەریایی	دریایی
دەرێ	در
دەرەوی	دروی
دەرەوە	درو
دەرەوەو	درو
دەرەوەی	دروی
دەرەوەیە	دروی
دەرەگە	دەرەگە
دەست	دست
دەست بزێو	دەست بزێو
دەستان	دستان
دەستور	دستور
دەستوری	دستوری
دەستوریە	دستوری
دەستورێ	دستور
دەستورە	دستور
دەستورەی	دستوری
دەستوور	دستور
دەستوورێ	دستور
دەستگیر	دستگیر
دەستی	دستی
دەستێ	دست
دەستێک	دستک
دەستێکی	دستکی
دەستە	دست
دەستەکە	دستک
دەستەکەی	دستکی
دەستەی	دستی
دەستەیە	دستی
دەشت	دشت
دەشتی	دشتی
دەشێت	دشت
دەعوا	دعوا
دەعوەت	دعوت
دەعوەی	دعوی
دەغڵ	دغل
دەف	دف
دەفتەر	دفتر
دەفتەردار	دفتردار
دەفتەری	دفتری
دەفن	دفن
دەفە	دف
دەق	دق
دەقیقا	دقیقا
دەقیقەی	دقیقی
دەقێ	دق
دەلال	دلال
دەلۆ	دلو
دەلیل	دلیل
دەلێ	دل
دەم	دم
دەم کردن	دم کردن
دەما	دما
دەمار	دمار
دەماغ	دماغ
دەمان	دمان
دەمبل	دمبل
دەمی	دمی
دەمێ	دم
دەمەوێ	دمو
دەمەی	دمی
دەن	دن
دەنا	دنا
دەنگ	دنگ
دەنگێ	دنگ
دەنگە	دنگ
دەنی	دنی
دەنیس	دنیس
دەنیێل	دنیل
دەنێ	دن
دەهات	دهات
دەهان	دهان
دەهێ	ده
دەهێنێ	دهن
دەهەم	دهم
دەهەمین	دهمین
دەو	دو
دەوا	دوا
دەوات	دوات
دەوام	دوام
دەور	دور
دەورو	دورو
دەوری	دوری
دەورەی	دوری
دەولە	دول
دەولەت	دولت
دەولەتێ	دولت
دەوڵەت	دولت
دەوڵەتە	دولت
دەویست	دویست
دەوێ	دو
دەوەن	دون
دەڕڤەیێ	دروی
دەڕۆن	درون
دەڕەوەی	دروی
دەڤ	دو
دەڤەر	دور
دەڤەران	دوران
دەڤەری	دوری
دەڤەرێ	دور
دەڤەرە	دور
دەڤەرەی	دوری
دەڤەڕێ	دور
دەکەوێ	دکو
دەگری	دگری
دەگرێ	دگر
دەگەڕان	دگران
دەڵێ	دل
دەی	دی
دەیدەن	دیدن
دەیلی	دیلی
دەیلەم	دیلم
دەین	دین
دەیڤس	دیوث
دەیڤید	دیوید
دەیڵێم	دیلم
دەیەم	دیم
دەیەمی	دیمی
دەیەوێ	دیو
رائد	راد
رائید	راید
راب	راب
رابێرت	رابرت
راجێر	راجر
رادیۆ	رادیو
رازدار	رازدار
رازی	رازی
راست	راست
راست کردن	راست کردن
راستە	راست
راستە بازار	راستە بازار
راسێل	راسل
رافایێل	رافایل
رافع	رافع
رام	رام
رامۆن	رامون
رامی	رامی
رامین	رامین
ران	ران
راندن	راندن
راه	راه
راوی	راوی
راپۆرت	راپرت
راپۆرت	راپورت
رای	رای
رایس	رایس
رب	رب
رسوا	رسوا
رف	رف
رفە	رف
رقس	رقص
رواندن	راندن
روانە	روانە
روب	رب
روح	روح
روزی	روزی
رووسی	روسی
رۆبرت	روبرت
رۆبن	روبن
رۆبین	روبین
رۆبینیۆ	روبینیو
رۆبێرت	روبرت
رۆبێرتۆ	روبرتو
رۆبێن	روبن
رۆبەرت	روبرت
رۆتێردام	روتردام
رۆز	روز
رۆلاند	رولاند
رۆمانی	رومانی
رۆمەن	رومن
رۆنالدۆ	رونالدو
رۆژان	روژان
رۆی	روی
رۆیال	رویال
رۆیتەرز	رویترز
ریا	ریا
ریاز	ریاض
ریازی	ریاضی
ریال	ریال
ریحان	ریحان
ریدلی	ریدلی
ریز	ریز
ریش	ریش
ریشە	ریش
ریشە	ریشە
ریمۆند	ریموند
ریچارد	ریچارد
ریکاردۆ	ریکاردو
رێنج	رنج
رێژەی	رژی
رەجەب	رجب
رەحمان	رحمان
رەحیم	رحیم
رەخت	رخت
رەزا	رزا
رەسنە	رسن
رەسول	رسول
رەش	رش
رەشید	رشید
رەعد	رعد
رەعیەت	رعیت
رەفتار	رفتار
رەفتەنی	رفتنی
رەفیق	رفیق
رەفە	رف
رەم	رم
رەمەزان	رمضان
رەنج	رنج
رەنجبەر	رنجبر
رەندۆم	رندوم
رەنگ	رنگ
رەنگین	رنگین
رەها	رها
رەها کردن	رها کردن
رەهبەر	رهبر
رەواج	رواج
رەوش	روش
رەوشەن	روشن
رەگ	رگ
زاب	زاب
زاتی	ذاتی
زاج	زاج
زاد	زاد
زادە	زاد
زادەی	زادی
زار	زار
زاراگوزا	زاراگوزا
زاراگۆزا	زاراگوزا
زارع	زارع
زارعی	زارعی
زاری	زاری
زامبیا	زامبیا
زامن	ضامن
زامنی	ضامنی
زانویم	زانیم
زانی	زانی
زانێتی	زانتی
زاهر	ظاهر
زاک	زاک
زاڵ	ذال
زاڵە	ذال
زاید	زاید
زبان	زبان
زبر	زبر
زبل	زبل
زبڵ	زبل
زبڵی	زبلی
زرار	ضرار
زرنگ	زرنگ
زرنگی	زرنگی
زرە	زرە
زشت	زشت
زلاتان	زلاتان
زلف	زلف
زمان	زمان
زمانی	زمانی
زمانیان	زمانیان
زمانێ	زمان
زمانە	زمان
زمستان	زمستان
زمستانی	زمستانی
زمین	زمین
زنجیر	زنجیر
زنجیرێ	زنجیر
زنجیرە	زنجیر
زندگی	زندگی
زندی	زندی
زندەگی	زندگی
زور	زور
زوریخ	زوریخ
زوو	زو
زوور	زور
زووە	زو
زکری	ذکری
زکی	ذکی
زڵاتان	زلاتان
زۆر	زور
زۆریخ	زوریخ
زۆرێک	زورک
زۆرە	زور
زی	زی
زیا	ضیا
زیاد	زیاد
زیادی	زیادی
زیادە	زیاد
زیادەی	زیادی
زیارەت	زیارت
زیارەتی	زیارتی
زیان	زیان
زیانمەند	زیانمند
زیانە	زیان
زیبا	زیبا
زیتون	زیتون
زید	زید
زیدان	زیدان
زیر	زیر
زیرە	زیرە
زیرەک	زیرک
زیرەکی	زیرکی
زیرەکە	زیرک
زیمێر	زیمر
زین	زین
زینب	زینب
زیکو	زیکو
زیکۆ	زیکو
زێد	زد
زێدی	زدی
زێر	ذر
زێری	زری
زێرین	زرین
زێرینی	زرینی
زێرەڤان	زروان
زێوە	زو
زێڕ	ذر
زێڕی	زری
زێڕین	زرین
زێڕینی	زرینی
زێی	زی
زەبر	زبر
زەبری	زبری
زەبیحی	ذبیحی
زەبەر	زبر
زەحمەت	زحمت
زەحمەتە	زحمت
زەخم	زخم
زەرب	ضرب
زەرد	زرد
زەردی	زردی
زەردەشت	زردشت
زەرقاوی	زرقاوی
زەری	زری
زەریران	زریران
زەریف	ظریف
زەرەر	ضرر
زەرەی	زری
زەعفەران	زعفران
زەعفەرانی	زعفرانی
زەعیم	زعیم
زەفەر	ظفر
زەق	زق
زەلاتان	زلاتان
زەمان	زمان
زەمانی	زمانی
زەمانە	زمان
زەمانەت	ضمانت
زەمین	زمین
زەمینگیر	زمینگیر
زەمینی	زمینی
زەمینە	زمین
زەمینەی	زمینی
زەمەن	زمن
زەمەنی	ضمنی
زەن	ذن
زەنبیل	زنبیل
زەنجان	زنجان
زەنجیر	زنجیر
زەنجەفیل	زنجفیل
زەند	زند
زەندی	زندی
زەنگ	زنگ
زەنگی	زنگی
زەهرا	زهرا
زەهرەمار	زهرمار
زەواهری	ظواهری
زەکات	زکات
زەکریا	ذکریا
زەکی	ذکی
زەکەریا	ذکریا
زەڵمای	زلمای
زەیتون	زیتون
زەیتونی	زیتونی
زەیتوون	زیتون
زەیتوونی	زیتونی
زەید	زید
زەیدی	زیدی
زەین	زین
زەینەب	زینب
زەینەل	زینل
زەینەڵ	زینل
سائر	سار
سائیب	صایب
سائیر	سایر
سابت	ثابت
سابر	صابر
سابری	صابری
سابوون	صابون
سابوونی	صابونی
ساج	ساج
ساحب	صاحب
ساحل	ساحل
ساخت	ساخت
ساختمان	ساختمان
ساختومان	ساختمان
ساختە	ساخت
ساختەی	ساختی
ساختەیە	ساختی
سادات	سادات
سادق	صادق
سادقی	صادقی
سادە	صاد
سادەو	سادو
سار	سار
سارا	سارا
ساراماگۆ	ساراماگو
سارد	سارد
سارکوزی	سارکوزی
سارکۆزی	سارکوزی
ساری	ساری
سارە	سار
ساز	ساز
سازش	سازش
سازمان	سازمان
سازگار	سازگار
سازی	سازی
ساسان	ساسان
ساشا	ساشا
ساعدی	ساعدی
سافی	صافی
ساقی	ساقی
سال	سال
سالار	سالار
سالاری	سالاری
سالح	صالح
سالحی	صالحی
سالم	سالم
سالمی	سالمی
سالێ	سال
سالێن	سالن
سالێک	سالک
سالە	سال
سالەک	سالک
سالەکێ	سالک
سام	سام
سامان	سامان
سامانی	سامانی
سامانیان	سامانیان
سامانە	سامان
سامانەی	سامانی
سامسۆن	سامسون
سامسۆنگ	سامسونگ
سامی	سامی
سامەرا	سامرا
سامەڕا	سامرا
سان	سان
سانا	سانا
سانتوس	سانتوس
سانتۆس	سانتوس
ساندرا	ساندرا
ساندرۆ	ساندرو
سانسۆر	سانسور
سانچێز	سانچز
سانی	ثانی
سانیا	ثانیا
ساها	ساها
ساواڵان	ساوالان
ساوس	ساوس
ساچمە	ساچمە
ساڵ	سال
ساڵح	صالح
ساڵحی	صالحی
ساڵحیان	صالحیان
ساڵم	سالم
ساڵن	سالن
ساڵه	ساله
ساڵیان	سالیان
ساڵێ	سال
ساڵێک	سالک
ساڵێکی	سالکی
ساڵێکە	سالک
ساڵە	سال
ساڵەئەم	سالم
ساڵەکەی	سالکی
ساڵەیان	سالیان
سایت	سایت
ساید	ساید
سایمۆن	سایمون
ساینس	ساینس
سایە	سای
سایە	سایە
سایەبان	سایبان
سایەی	سایی
سبز	سبز
سبیل	سبیل
ستار	ستار
ستاری	ستاری
ستارە	ستارە
ستاند	ستاند
ستاندن	ستاندن
ستاندنێ	ستاندن
ستانی	ستانی
ستاک	ستاک
ستایش	ستایش
ستون	ستون
ستۆن	ستون
ستەم	ستم
ستەمکاری	ستمکاری
ستەمگەر	ستمگر
سدقی	صدقی
سدیق	صدیق
سدیقی	صدیقی
سراج	سراج
سردار	سردار
سرنگ	سرنگ
سرود	سرود
سرودی	سرودی
سروود	سرود
سروودی	سرودی
سرووش	سروش
سروە	سرو
سرکە	سرکە
سری	سری
سزا	سزا
سزایی	سزایی
سزایەی	سزایی
سست	سست
سستی	سستی
سعد	سعد
سعدون	سعدون
سعدی	سعدی
سعود	سعود
سعودی	سعودی
سعودیە	سعودی
سعوود	سعود
سعوودی	سعودی
سعوودیە	سعودی
سعید	سعید
سفتە	سفتە
سفر	سفر
سفری	صفری
سفرە	سفرە
سفلیس	سفلیس
سفید	سفید
سلاح	سلاح
سلام	سلام
سلبی	سلبی
سلتیک	سلتیک
سلفەی	سلفی
سلمان	سلمان
سلیم	سلیم
سلیمان	سلیمان
سلیمانی	سلیمانی
سلێمان	سلمان
سلێمانی	سلمانی
سلێمانیە	سلمانی
سم	سم
سماق	سماق
سمتراش	سمتراش
سمتەراش	سمتراش
سمدار	سمدار
سمسار	سمسار
سمیر	سمیر
سمین	سمین
سمینار	سمینار
سمینارێ	سمینار
سن	سن
سنان	سنان
سنبل	سنبل
سنتەر	سنتر
سندوق	صندوق
سندوقی	صندوقی
سندووق	صندوق
سندووقی	صندوقی
سندی	سندی
سنه	سنه
سنگ	سنگ
سنی	سنی
سنێد	سند
سنە	سن
سنەی	سنّی
سنەیە	سنّی
سوار	سوار
سواری	سواری
سوارێز	سوارز
سوارە	سوار
سوارەی	سواری
سواڵ	سوال
سوخت	سوخت
سوخرە	سخرە
سود	سود
سودان	سودان
سودمەند	سودمند
سودمەندی	سودمندی
سودی	سودی
سور	سور
سورب	سرب
سورمە	سرمە
سورن	سورن
سوروشت	سرشت
سورچی	سورچی
سوری	سوری
سورین	سرین
سوریە	سوری
سورە	سور
سورەتی	صورتی
سوز	سوز
سوزان	سوزان
سوسیال	سوسیال
سوفاڵ	سوفال
سوفیا	سوفیا
سوق	سوق
سونی	سونی
سوو	سو
سوود	سود
سوودان	سودان
سوودبەخش	سودبخش
سوودم	سودم
سوودی	سودی
سوودێک	سودک
سوودە	سود
سوور	سور
سووربن	سوربن
سوورن	سورن
سووری	سوری
سووریێ	سوری
سوورە	سور
سوورەی	سوری
سوونی	سونی
سووچی	سوچی
سووڕی	سوری
سووک	سوک
سووکی	سوکی
سووکە	سوک
سوپاس	سپاس
سوپەر	سوپر
سوپەری	سوپری
سوچی	سوچی
سوک	سوک
سوکی	سوکی
سوێد	سود
سوێدی	سودی
سوێری	سوری
سوێسن	سوسن
سپاردن	سپاردن
سپاس	سپاس
سپوردە	سپردە
سپۆر	سپور
سپۆری	سپوری
سپێر	سپر
سپێرز	سپرز
سپێهر	سپهر
سپێهری	سپهری
سپەر	سپر
سڤک	سوک
سڤکی	سوکی
سک	سک
سکان	سکان
سکرتێر	سکرتر
سکرتێری	سکرتری
سکرتێرێ	سکرتر
سکرێ	سکر
سکسی	سکسی
سکوت	سکوت
سکۆت	سکوت
سکە	سکە
سکەنجەبین	سکنجبین
سڵەواتی	صلواتی
سۆخرە	سخرە
سۆز	سوز
سۆزان	سوزان
سۆزانی	سوزانی
سۆزداری	سوزداری
سۆزی	سوزی
سۆسیال	سوسیال
سۆسیداد	سوسیداد
سۆشۆ	سوشو
سۆفی	صوفی
سۆفیا	سوفیا
سۆلانا	سولانا
سۆما	سوما
سۆماڵی	سومالی
سۆمەر	سومر
سۆمەری	سومری
سۆمەریە	سومری
سۆنی	سونی
سۆنیا	سونیا
سۆیا	سویا
سی	سی
سیئۆل	سیول
سیا	سیا
سیاتێل	سیاتل
سیاحەت	سیاحت
سیادی	صیادی
سیاری	سیاری
سیاسی	سیاسی
سیاسیە	سیاسی
سیاسەت	سیاست
سیاسەتی	سیاستی
سیاسەتێ	سیاست
سیاسەتە	سیاست
سیامەک	سیامک
سیانی	سیانی
سیانەی	سیانی
سیاهە	سیاهە
سیاوەش	سیاوش
سیبا	سیبا
سیخ	سیخ
سید	سید
سیدا	صیدا
سیدنی	سیدنی
سیدی	صیدی
سیر	سیر
سیروان	سیروان
سیروس	سیروس
سیرووس	سیروس
سیرۆ	سیرو
سیریێ	سیری
سیستان	سیستان
سیستم	سیستم
سیستمە	سیستم
سیستەم	سیستم
سیستەمێ	سیستم
سیستەمە	سیستم
سیسیل	سیسیل
سیل	سیل
سیلوێر	سیلور
سیلڤا	سیلوا
سیلڤیۆ	سیلویو
سیلی	سیلی
سیم	سیم
سیم بەند	سیم بند
سیما	سیما
سیمرغ	سیمرغ
سیمورغ	سیمرغ
سیمپسۆن	سیمپسون
سیمکێش	سیمکش
سیمۆن	سیمون
سیمین	سیمین
سین	سین
سینا	سینا
سیناترا	سیناترا
سینایی	سینایی
سینما	سینما
سینمایی	سینمایی
سینگ	سینگ
سینی	سینی
سینە	سینە
سینەباز	سینەباز
سینەما	سینما
سیورسات	سیورسات
سیگار	سیگار
سیۆل	سیول
سیێ	سی
سیێنا	سینا
سێبەر	صبر
سێبەری	صبری
سێتار	ستار
سێدا	صدا
سێر	سر
سێرجیۆ	سرجیو
سێروانتس	سروانتس
سێری	سری
سێل	سل
سێلتیک	سلتیک
سێلمانی	سلمانی
سێنت	سنت
سێهەم	سهم
سێو	سو
سێوی	سوی
سێوەکەی	سوکی
سێوەی	سوی
سێکس	سکس
سێکسی	سکسی
سێڵ	سل
سێی	سی
سێیێ	سی
سێیە	سی
سێیەم	سیم
سێیەمی	سیمی
سێیەمین	سیمین
سێیەمە	سیم
سەبا	سبا
سەباح	صباح
سەباحی	صباحی
سەباغ	صباغ
سەبر	صبر
سەبری	صبری
سەبز	سبز
سەبوری	صبوری
سەبووری	صبوری
سەبەب	سبب
سەبەل	سبل
سەتار	ستار
سەتاری	ستاری
سەجاد	سجاد
سەجادی	سجادی
سەحنە	صحن
سەحەر	سحر
سەحەری	سحری
سەخت	سخت
سەختتر	سختتر
سەختی	سختی
سەختە	سخت
سەد	سد
سەدا	صدا
سەدام	صدام
سەدر	سدر
سەدری	صدری
سەدریان	صدریان
سەدرە	سدر
سەدیق	صدیق
سەدە	سد
سەدەمین	صدمین
سەدەها	صدها
سەر	سر
سەرئێشەی	سرشی
سەرا	سرا
سەراج	سراج
سەراسەری	سراسری
سەران	سران
سەرانی	سرانی
سەراپا	سراپا
سەرب	سرب
سەرباری	سرباری
سەرباز	سرباز
سەربازگیری	سربازگیری
سەربازی	سربازی
سەربازە	سرباز
سەربە	سرب
سەرتراش	سرتراش
سەرتیپ	سرتیپ
سەرحەد	سرحد
سەرخۆش	سرخوش
سەرخۆشی	سرخوشی
سەرد	سرد
سەردار	سردار
سەرداری	سرداری
سەردەشت	سردشت
سەردەشتی	سردشتی
سەرسام	سرسام
سەرسەخت	سرسخت
سەرسەختی	سرسختی
سەرشیر	سرشیر
سەرف	صرف
سەرفراز	سرفراز
سەرفی	صرفی
سەرم	سرم
سەرما	سرما
سەرمەد	سرمد
سەرمەست	سرمست
سەرمەستی	سرمستی
سەرمەشق	سرمشق
سەرنشین	سرنشین
سەرهەنگ	سرهنگ
سەرو	سرو
سەروسیما	سروسیما
سەروو	سرو
سەروکار	سروکار
سەروەت	ثروت
سەروەر	سرور
سەروەری	سروری
سەرپایی	سرپایی
سەرپەرست	سرپرست
سەرک	سرک
سەرکار	سرکار
سەرکیس	سرکیس
سەرکێشی	سرکشی
سەرکەش	سرکش
سەرکەشی	سرکشی
سەرگین	سرگین
سەرگەردان	سرگردان
سەرۆ	سرو
سەری	سری
سەرێ	سر
سەرە	سر
سەرەخەر	سرخر
سەرەفراز	سرفراز
سەرەند	سرند
سەرەوت	ثروت
سەرەوە	سرو
سەرەوەری	سروری
سەرەک	سرک
سەعادەت	سعادت
سەعد	سعد
سەعدون	سعدون
سەعدوون	سعدون
سەعدی	سعدی
سەعدیە	سعدی
سەعودی	سعودی
سەعید	سعید
سەعیدلوو	سعیدلو
سەعیدی	سعیدی
سەعەد	سعد
سەغیر	صغیر
سەفا	صفا
سەفار	صفار
سەفوان	صفوان
سەفوەت	صفوت
سەفیر	سفیر
سەفیری	سفیری
سەفین	صفین
سەفەر	سفر
سەفەری	صفری
سەفەریان	صفریان
سەفەرەی	صفری
سەفەوی	صفوی
سەقا	سقا
سەقز	سقز
سەقفی	ثقفی
سەقەر	سقر
سەلاح	سلاح
سەلاحی	صلاحی
سەلاخ	سلاخ
سەلام	سلام
سەلامی	سلامی
سەلامەت	سلامت
سەلامەتە	سلامت
سەلبی	سلبی
سەلمان	سلمان
سەلیم	سلیم
سەلیمی	سلیمی
سەلەفی	سلفی
سەلەم	سلم
سەم	سم
سەما	سما
سەماوەر	سماور
سەمت	سمت
سەمفۆنی	سمفونی
سەمفۆنیک	سمفونیک
سەمیر	سمیر
سەمیرا	سمیرا
سەمیرە	سمیر
سەمیع	سمیع
سەمیمی	صمیمی
سەمین	ثمین
سەمینار	سمینار
سەمەد	صمد
سەمەدی	صمدی
سەمەدیان	صمدیان
سەن	سن
سەنا	ثنا
سەنایی	سنایی
سەنت	سنت
سەنتوور	سنتور
سەنتەر	سنتر
سەنتەرێ	سنتر
سەنتەرە	سنتر
سەنجاقەک	سنجاقک
سەند	سند
سەندوق	صندوق
سەندوقی	صندوقی
سەندووقی	صندوقی
سەندیکا	سندیکا
سەندەی	سندی
سەنعا	صنعا
سەنعەتی	صنعتی
سەنگ	سنگ
سەنگاپور	سنگاپور
سەنگباران	سنگباران
سەنگتراش	سنگتراش
سەنگتەراش	سنگتراش
سەنگین	سنگین
سەنگینی	سنگینی
سەنگێکی	سنگکی
سەنگەر	سنگر
سەنگەربەندی	سنگربندی
سەنگەری	سنگری
سەنگەسار	سنگسار
سەنی	سنّی
سەنەد	سند
سەنەدی	سندی
سەهبایی	صهبایی
سەهم	سهم
سەهو	سهو
سەهیم	سهیم
سەهەم	سهم
سەهەند	سهند
سەوا	سوا
سەواد	سواد
سەودا	سودا
سەورە	سور
سەورەی	سوری
سەوز	سوز
سەوزی	سوزی
سەوزیان	سوزیان
سەوزە	سوز
سەوزەی	سوزی
سەڕ	سر
سەڕبازی	سربازی
سەگ	سگ
سەگ دەست	سگ دست
سەگێک	سگک
سەگە	سگ
سەڵاح	سلاح
سەڵاحی	صلاحی
سەڵەواتی	صلواتی
سەۆکی	سوکی
سەیاحەت	سیاحت
سەیاد	صیاد
سەیارەی	سیاری
سەید	سید
سەیدا	صیدا
سەیدی	صیدی
سەیر	سیر
سەیرو	سیرو
سەیری	سیری
سەیرە	سیر
سەیف	سیف
سەیفی	سیفی
شابرۆل	شابرول
شاتێر	شاطر
شاخ	شاخ
شاخدار	شاخدار
شاخە	شاخ
شاخە	شاخە
شاد	شاد
شادان	شادان
شادمان	شادمان
شادمانی	شادمانی
شادومان	شادمان
شادی	شادی
شار	شار
شاره	شاره
شارۆن	شارون
شارە	شار
شاش	شاش
شاشەی	شاشی
شاقول	شاقول
شالۆم	شالوم
شام	شام
شامل	شامل
شاملوو	شاملو
شامی	شامی
شانزدە	شانزدە
شانس	شانس
شانسی	شانسی
شانگهای	شانگهای
شانی	شانی
شانە	شانە
شانەی	شانی
شاه	شاه
شاهانە	شاهان
شاهد	شاهد
شاهروودی	شاهرودی
شاهو	شاهو
شاهۆ	شاهو
شاهی	شاهی
شاهین	شاهین
شاهێد	شاهد
شاهێدی	شاهدی
شاکر	شاکر
شاکری	شاکری
شاگرد	شاگرد
شایان	شایان
شایانی	شایانی
شایستە	شایست
شایستە	شایستە
شایستەی	شایستی
شایەد	شاید
شب	شب
شت	شط
شتێ	شط
شتە	شط
شحنە	شحنە
شریف	شریف
شریک	شریک
شرێک	شرک
شفا	شفا
شفرە	شفرە
شفیق	شفیق
شل	شل
شلی	شلی
شمار	شمار
شمارە	شمارە
شمال	شمال
شمشیر	شمشیر
شناسایی	شناسایی
شناسنامە	شناسنامە
شناو	شنا
شنەوا	شنوا
شهاب	شهاب
شهر	شهر
شوت	شوت
شوتی	شوتی
شود	شود
شورا	شورا
شورتە	شورت
شوستەر	شوستر
شوشە	شوش
شوفێر	شوفر
شوفێری	شوفری
شوقی	شوقی
شوقەی	شوقی
شوم	شوم
شوناس	شناس
شوو	شو
شووتی	شوتی
شوور	شور
شووشە	شوش
شووی	شوی
شوڕتە	شورت
شوڕشی	شورشی
شوکت	شوکت
شک	شک
شکات	شکات
شکار	شکار
شکاندن	شکاندن
شکایەت	شکایت
شکر	شکر
شکری	شکری
شکست	شکست
شکستی	شکستی
شکسپیر	شکسپیر
شکور	شکور
شکەست	شکست
شکەستن	شکستن
شۆجی	شوجی
شۆر	شور
شۆرد	شورد
شۆرش	شورش
شۆرشگێری	شورشگری
شۆرشی	شورشی
شۆستەر	شوستر
شۆفێر	شوفر
شۆفێری	شوفری
شۆفێرە	شوفر
شۆڕش	شورش
شۆڕشگێڕ	شورشگر
شۆڕشی	شورشی
شۆڕشە	شورش
شۆک	شوک
شی	شی
شیخ	شیخ
شیر	شیر
شیراز	شیراز
شیرازی	شیرازی
شیرازەی	شیرازی
شیراک	شیراک
شیربرنج	شیربرنج
شیربەها	شیربها
شیرخشت	شیرخشت
شیرزاد	شیرزاد
شیروان	شیروان
شیروانی	شیروانی
شیری	شیری
شیرین	شیرین
شیرینکار	شیرینکار
شیرینی	شیرینی
شیشە	شیشە
شیشەک	شیشک
شیعی	شیعی
شیعە	شیعە
شیعەی	شیعی
شیعەیان	شیعیان
شیعەیە	شیعی
شیلان	شیلان
شیلی	شیلی
شیلەی	شیلی
شیما	شیما
شیمۆن	شیمون
شین	شین
شینە	شین
شیوا	شیوا
شیون	شین
شیون کردن	شین کردن
شیوەن	شیون
شیوەنی	شیونی
شیکاگۆ	شیکاگو
شێت	شط
شێخ	شخ
شێخە	شخ
شێر	شر
شێرلوک	شرلوک
شێرلۆک	شرلوک
شێروان	شروان
شێروانی	شروانی
شێروانە	شروان
شێری	شری
شێرێ	شر
شێرەی	شری
شێست	شست
شێعر	شعر
شێعری	شعری
شێل	شل
شێن	شن
شێنێ	شن
شێوێ	شو
شێوە	شو
شێوەش	شوش
شێوەو	شو
شێوەکی	شوکی
شێوەکێ	شوک
شێوەکەی	شوکی
شێوەی	شوی
شێوەیی	شویی
شێوەییە	شویی
شێوەیێ	شوی
شێوەیە	شوی
شێوەیەی	شویی
شێکسپیر	شکسپیر
شەباب	شباب
شەبدەر	شبدر
شەبستان	شبستان
شەبنەم	شبنم
شەترەنج	شطرنج
شەخسی	شخصی
شەر	شر
شەراکەت	شراکت
شەربەت	شربت
شەربەت ساز	شربت ساز
شەرع	شرع
شەرعی	شرعی
شەرق	شرق
شەرقی	شرقی
شەرم	شرم
شەرمسار	شرمسار
شەرمساری	شرمساری
شەرمەسار	شرمسار
شەرمەساری	شرمساری
شەری	شری
شەریعەت	شریعت
شەریف	شریف
شەریفی	شریفی
شەریک	شریک
شەریکی	شریکی
شەرێ	شر
شەرەف	شرف
شەرەفی	شرفی
شەرەم	شرم
شەست	شست
شەستی	شستی
شەش	شش
شەشی	ششی
شەشێ	شش
شەشەم	ششم
شەشەمین	ششمین
شەشەمە	ششم
شەعب	شعب
شەعبان	شعبان
شەعبانی	شعبانی
شەفاف	شفاف
شەفافی	شفافی
شەفتالو	شفتالو
شەفیع	شفیع
شەفیعی	شفیعی
شەفیق	شفیق
شەفەق	شفق
شەق	شق
شەل	شل
شەلاق	شلاق
شەلوار	شلوار
شەلە	شل
شەم	شم
شەمال	شمال
شەماڵ	شمال
شەمس	شمس
شەمسی	شمسی
شەمع	شمع
شەمعدان	شمعدان
شەمێرانی	شمرانی
شەمە	شم
شەمەد	شمد
شەمەر	شمر
شەمەری	شمری
شەهاب	شهاب
شەهابی	شهابی
شەهامەت	شهامت
شەهباز	شهباز
شەهبازی	شهبازی
شەهر	شهر
شەهرام	شهرام
شەهرزاد	شهرزاد
شەهریار	شهریار
شەهلا	شهلا
شەهناز	شهناز
شەهید	شهید
شەهیدان	شهیدان
شەهیدانە	شهیدان
شەهیدی	شهیدی
شەهیدیان	شهیدیان
شەهیدە	شهید
شەو	شو
شەوقی	شوقی
شەوکەت	شوکت
شەوی	شوی
شەوێک	شوک
شەوێکی	شوکی
شەپنی	شەپنی
شەڕ	شر
شەڕی	شری
شەڕیان	شریان
شەڕێ	شر
شەڕێک	شرک
شەڕە	شر
شەڕەکە	شرک
شەڕەی	شری
شەڤ	شو
شەڤێ	شو
شەکر	شکر
شەکرپەنیر	شکرپنیر
شەکری	شکری
شەکرە	شکر
شەکرەی	شکری
شەکوری	شکوری
شەکیب	شکیب
شەکەر	شکر
شەکەرپەنیر	شکرپنیر
شەیتان	شیطان
شەیتانی	شیطانی
شەیخی	شیخی
شەیدا	شیدا
شەیما	شیما
شەین	شین
عابد	عابد
عابدی	عابدی
عابدین	عابدین
عاج	عاج
عاجی	عاجی
عادل	عادل
عادڵ	عادل
عادی	عادی
عادەت	عادت
عادەت کردن	عادت کردن
عار	عار
عارف	عارف
عارفێ	عارف
عاسم	عاصم
عاسی	عاصی
عاشق	عاشق
عاشقی	عاشقی
عاشور	عاشور
عاشورا	عاشورا
عاشوور	عاشور
عاشوورا	عاشورا
عاشووڕا	عاشورا
عالم	عالم
عالمی	عالمی
عالی	عالی
عالەم	عالم
عالەمەن	عالەمەن
عامر	عامر
عامری	عامری
عامل	عامل
عاملی	عاملی
عامێر	عامر
عباس	عباس
عبد	عبد
عبور	عبور
عبید	عبید
عدنان	عدنان
عراق	عراق
عراقی	عراقی
عرب	عرب
عرفان	عرفان
عروس	عروس
عزالدین	عزالدین
عزت	عزت
عزیز	عزیز
عزەت	عزت
عسمەت	عصمت
عشایر	عشایر
عشق	عشق
علو	علو
علوم	علوم
علی	علی
علیکم	علیکم
عماد	عماد
عمر	عمر
عمران	عمران
عود	عود
عودەی	عودی
عورف	عرف
عومر	عمر
عوود	عود
عید	عید
عیسی	عیسی
عێراق	عراق
عێراقی	عراقی
عێراقیە	عراقی
عێراقێ	عراق
عێراقە	عراق
عێرق	عرق
عێزەت	عزت
عێڕاق	عراق
عێڕاقی	عراقی
عەبا	عبا
عەبادی	عبادی
عەباس	عباس
عەباسی	عباسی
عەبد	عبد
عەبد	عەبد
عەبدی	عبدی
عەتا	عطا
عەتار	عطار
عەدالەت	عدالت
عەدالەتی	عدالتی
عەداوەت	عداوت
عەداڵەت	عدالت
عەدل	عدل
عەدلی	عدلی
عەدنان	عدنان
عەدەن	عدن
عەرب	عرب
عەربی	عربی
عەرەب	عرب
عەرەبی	عربی
عەرەبیە	عربی
عەرەبە	عرب
عەرەفات	عرفات
عەزام	عزام
عەزیز	عزیز
عەزیزی	عزیزی
عەزیم	عظیم
عەزیمی	عظیمی
عەسر	عسر
عەسری	عصری
عەسکەر	عسکر
عەسکەری	عسکری
عەسەل	عسل
عەشائیری	عشایری
عەشایری	عشایری
عەشایەر	عشایر
عەشایەری	عشایری
عەشق	عشق
عەشقی	عشقی
عەقار	عقار
عەقڵ	عقل
عەقڵی	عقلی
عەقیل	عقیل
عەقیلی	عقیلی
عەلا	علا
عەلامەت	علامت
عەلاوی	علاوی
عەلایی	علایی
عەلوەی	علوی
عەلی	علی
عەلیان	علیان
عەلەم	علم
عەلەوی	علوی
عەلەیان	علیان
عەمار	عمار
عەمارە	عمار
عەمارەت	عمارت
عەمان	عمان
عەمانی	عمانی
عەمر	عمر
عەمرو	عمرو
عەمرە	عمر
عەملیاتی	عملیاتی
عەمۆ	عمو
عەمید	عمید
عەمیدی	عمیدی
عەمەر	عمر
عەمەلی	عملی
عەن	عن
عەنان	عنان
عەنبەر	عنبر
عەهد	عهد
عەورەت	عورت
عەڕەب	عرب
عەڕەبی	عربی
عەڕەفات	عرفات
عەیار	عیار
عەیاری	عیاری
عەید	عید
عەین	عین
عەینی	عینی
عەینەک	عینک
غار	غار
غاز	غاز
غازی	غازی
غازە	غازە
غالب	غالب
غانم	غانم
غریب	غریب
غرێب	غرب
غرێبی	غربی
غز	غز
غفور	غفور
غلام	غلام
غونچە	غنچە
غیابی	غیابی
غەدر	غەدر
غەدیر	غدیر
غەرب	غرب
غەربی	غربی
غەریب	غریب
غەریبی	غریبی
غەز	غەز
غەزا	غەزا
غەزال	غزال
غەزالی	غزالی
غەزه	غزه
غەزەل	غزل
غەسان	غسان
غەفار	غفار
غەفاری	غفاری
غەفور	غفور
غەفوور	غفور
غەم	غم
غەمبار	غمبار
غەمناک	غمناک
غەمگین	غمگین
غەنی	غنی
غەیب	غیب
غەیبەت	غیبت
غەیر	غیر
فائق	فاق
فابیانۆ	فابیانو
فابیۆ	فابیو
فابیۆس	فابیوس
فاتح	فاتح
فاتحی	فاتحی
فاخر	فاخر
فارابی	فارابی
فارس	فارس
فارسی	فارسی
فاروق	فاروق
فاروقی	فاروقی
فارووق	فاروق
فازل	فاضل
فازڵ	فاضل
فاستێر	فاستر
فاش	فاش
فال	فال
فان	فان
فانی	فانی
فاو	فاو
فاکس	فاکس
فایز	فایز
فایق	فایق
فایل	فایل
فایلێ	فایل
فایەق	فایق
فایەلێ	فایل
فتاح	فتاح
فتنە	فتنە
فتوا	فتوا
فتیلە	فتیلە
فخرالدین	فخرالدین
فدا	فدا
فدایی	فدایی
فدریکۆ	فدریکو
فرات	فرات
فرار	فرار
فراق	فراق
فرانس	فرانس
فرانسوا	فرانسوا
فرانسیس	فرانسیس
فرانک	فرانک
فرانکس	فرانکس
فرانکلین	فرانکلین
فرانکۆ	فرانکو
فراوان	فراوان
فراوانی	فراوانی
فراوانە	فراوان
فرت	فرط
فرج	فرج
فردریک	فردریک
فرزەند	فرزند
فرستادە	فرستادە
فرسەت	فرصت
فرسەخ	فرسخ
فرش	فرش
فرشتگان	فرشتگان
فرشتە	فرشتە
فرمان	فرمان
فرمانی	فرمانی
فرناندو	فرناندو
فرناندۆ	فرناندو
فرهاد	فرهاد
فرهنگی	فرهنگی
فروتن	فروتن
فروتنێ	فروتن
فروزش	فروزش
فرۆش	فروش
فرۆشی	فروشی
فرۆید	فروید
فری	فری
فریاد	فریاد
فریب	فریب
فرید	فرید
فریدریک	فریدریک
فریدون	فریدون
فریزوو	فریز
فرێ	فر
فرێد	فرد
فرێدریش	فردریش
فرێدریک	فردریک
فرێدی	فردی
فرە	فر
فستیڤالە	فستیوال
فشار	فشار
فشاری	فشاری
فشارێک	فشارک
فشارێکی	فشارکی
فشارەی	فشاری
فشفشە	فشفشە
فلاش	فلاش
فلان	فلان
فلستین	فلسطین
فلستینی	فلسطینی
فلفل	فلفل
فلووت	فلوت
فلۆرانس	فلورانس
فلۆریدا	فلوریدا
فلینی	فلینی
فلیپ	فلیپ
فلێمینگ	فلمینگ
فنجان	فنجان
فندق	فندق
فهمی	فهمی
فوئاد	فواد
فواد	فواد
فوارە	فوارە
فوت	فوت
فوتساڵ	فوتسال
فورمێن	فورمن
فوزی	فوزی
فوون	فوون
فڕانس	فرانس
فڕانسوا	فرانسوا
فڕانک	فرانک
فڕانکۆ	فرانکو
فڕی	فری
فڕێ	فر
فکر	فکر
فکری	فکری
فۆتسال	فوتسال
فۆتۆ	فوتو
فۆرد	فورد
فۆرمەن	فورمن
فۆلکلۆر	فولکلور
فۆلکلۆرە	فولکلور
فۆکس	فوکس
فی	فی
فیدل	فیدل
فیدڵ	فیدل
فیزیکی	فیزیکی
فیس	فیس
فیش	فیش
فیشێر	فیشر
فیشەر	فیشر
فیفا	فیفا
فیل	فیل
فیلد	فیلد
فیلم	فیلم
فیلمساز	فیلمساز
فیلمە	فیلم
فیلیپ	فیلیپ
فیلیپس	فیلیپس
فیلیپین	فیلیپین
فیلیپینی	فیلیپینی
فینیکس	فینیکس
فیگارۆ	فیگارو
فێدراڵ	فدرال
فێدراڵی	فدرالی
فێر	فر
فێرز	فرز
فێری	فری
فێرێر	فرر
فێست	فست
فێیس	فیث
فەتاح	فتاح
فەتاحی	فتاحی
فەتاحیان	فتاحیان
فەتح	فتح
فەتحی	فتحی
فەتق	فتق
فەتوا	فتوا
فەجر	فجر
فەجری	فجری
فەخری	فخری
فەدرال	فدرال
فەدەرال	فدرال
فەر	فر
فەرامۆش	فراموش
فەرامەرز	فرامرز
فەراهانی	فراهانی
فەراهەم	فراهم
فەرج	فرج
فەرد	فرد
فەردا	فردا
فەردین	فردین
فەرز	فرز
فەرزاد	فرزاد
فەرزی	فرضی
فەرزین	فرزین
فەرسەت	فرصت
فەرش	فرش
فەرشاد	فرشاد
فەرشی	فرشی
فەرشید	فرشید
فەرق	فرق
فەرمان	فرمان
فەرمانبەردار	فرمانبردار
فەرمانی	فرمانی
فەرمانە	فرمان
فەرمایش	فرمایش
فەرهاد	فرهاد
فەرهادی	فرهادی
فەرهەنگ	فرهنگ
فەریبا	فریبا
فەرید	فرید
فەریدون	فریدون
فەرەج	فرج
فەرەجی	فرجی
فەرەح	فرح
فەزل	فضل
فەزلی	فضلی
فەزڵ	فضل
فەستیڤال	فستیوال
فەسڵ	فصل
فەقیر	فقیر
فەلاح	فلاح
فەلستین	فلسطین
فەلستینی	فلسطینی
فەلسەفی	فلسفی
فەلەج	فلج
فەلەکی	فلکی
فەن	فن
فەندەک	فندک
فەنەر	فنر
فەهد	فهد
فەهم	فهم
فەهمی	فهمی
فەهیم	فهیم
فەهیمی	فهیمی
فەوج	فوج
فەوزی	فوزی
فەڕش	فرش
فەکس	فکس
فەیاز	فیاض
فەیروز	فیروز
فەیزی	فیضی
فەیس	فیث
فەیسبوک	فیسبوک
فەیسەل	فیصل
فەیسەڵ	فیصل
قائید	قاید
قائیم	قایم
قائیمی	قایمی
قاب	قاب
قابیل	قابیل
قاتمە	قاتمە
قادر	قادر
قادری	قادری
قادسیە	قادسی
قارچ	قارچ
قازی	قاضی
قاسم	قاسم
قاسملۆ	قاسملو
قاسمی	قاسمی
قافیە	قافیە
قاقم	قاقم
قاقوم	قاقم
قاقوولە	قاقلە
قالب	قالب
قالیچە	قالیچە
قانع	قانع
قانعی	قانعی
قانون	قانون
قانونی	قانونی
قانونێ	قانون
قانوون	قانون
قانوونی	قانونی
قاوەتوون	قاوەتوون
قاپ	قاپ
قاپی	قاپی
قاڵی	قالی
قایل	قایل
قایم	قایم
قبول	قبول
قبوول	قبول
قبووڵ	قبول
قبووڵی	قبولی
قبوڵ	قبول
قبوڵی	قبولی
قرتی	قرتی
قرمز	قرمز
قرنی	قرنی
قسمەت	قسمت
قسەم	قسم
قلیان	قلیان
قهرمان	قهرمان
قوت	قوت
قوربانی	قربانی
قورت	قورت
قورعە	قرعە
قوفل	قفل
قولاب	قلاب
قولی	قولی
قولە	قلە
قوم	قوم
قومار	قمار
قومار کردن	قمار کردن
قومارباز	قمارباز
قومارخانە	قمارخانە
قوماش	قماش
قومری	قمری
قومقومە	قمقمە
قووڵ	قول
قووڵی	قولی
قوڵ	قول
قوڵی	قولی
قوە	قو
قوەی	قوی
قۆلی	قولی
قۆڵ	قول
قۆڵی	قولی
قیام	قیام
قیر	قیر
قیمە	قیمە
قیمەت	قیمت
قەبر	قبر
قەبرستان	قبرستان
قەبول	قبول
قەبوول	قبول
قەبووڵ	قبول
قەبووڵی	قبولی
قەبوڵ	قبول
قەتران	قطران
قەتەر	قطر
قەتەڕ	قطر
قەد	قد
قەداسەتی	قداستی
قەدر	قدر
قەدری	قدری
قەدیم	قدیم
قەدەر	قدر
قەدەری	قدری
قەدەم	قدم
قەران	قران
قەرز	قرض
قەرزی	قرضی
قەرزە	قرض
قەرزەی	قرضی
قەرەنی	قرنی
قەز	قز
قەزا	قضا
قەزافی	قذافی
قەزایی	قضایی
قەزوین	قزوین
قەساب	قصاب
قەسر	قصر
قەسری	قصری
قەسرێ	قصر
قەسقان	قەسقان
قەسەب	قصب
قەشقاوی	قشقاوی
قەشقایی	قشقایی
قەشەنگ	قشنگ
قەفەس	قفس
قەقنەس	ققنس
قەلەم	قلم
قەلەمی	قلمی
قەمەر	قمر
قەنات	قنات
قەناری	قناری
قەناعەت	قناعت
قەنبەر	قنبر
قەنبەری	قنبری
قەند	قند
قەندان	قندان
قەندیل	قندیل
قەهار	قهار
قەوامی	قوامی
قەپاندار	قپاندار
قەڵات	قلات
قەڵەم	قلم
قەڵەمی	قلمی
قەڵەو	قلو
قەی	قی
قەیس	قیس
قەیسی	قیسی
قەیسەر	قیصر
قەیسەری	قیصری
قەیچی	قیچی
لئۆن	لون
لا	لا
لابەلای	لابلای
لات	لات
لاتین	لاتین
لاتینی	لاتینی
لاجوەرد	لاجورد
لاجوەردی	لاجوردی
لادن	لادن
لادێ	لاد
لادێی	لادی
لادەن	لادن
لارا	لارا
لاری	لاری
لارێنس	لارنس
لازم	لازم
لازیۆ	لازیو
لاس	لاس
لاستیک	لاستیک
لاشە	لاش
لاشە	لاشە
لاف	لاف
لال	لال
لالایی	لالایی
لالی	لالی
لالیگا	لالیگا
لالەزار	لالەزار
لام	لام
لاما	لاما
لامپە	لامپ
لانس	لانس
لانگ	لانگ
لانە	لان
لاهور	لاهور
لاوان	لاوان
لاوانە	لاوان
لاڕێ	لار
لاڤرۆف	لاوروف
لاک	لاک
لاکی	لاکی
لای	لای
لایین	لایین
لایێ	لای
لایە	لای
لباس	لباس
لبنان	لبنان
لبنانی	لبنانی
لبنانێ	لبنان
لحیم	لحیم
لق	لق
لقا	لقا
لقمان	لقمان
لقی	لقی
لقێ	لق
لم	لم
لنگ	لنگ
لنگە	لنگ
لوئیز	لوئیز
لوئیس	لوئیس
لوئەی	لوی
لوت	لوت
لوتی	لوطی
لوتەر	لوتر
لوری	لوری
لوس	لوس
لوسی	لوسی
لوعاب	لعاب
لوقمە	لقمە
لولا	لولا
لولەی	لولی
لوند	لوند
لووت	لوت
لووتی	لوطی
لوولەی	لولی
لووچ	لوچ
لووی	لوی
لوویی	لویی
لوچ	لوچ
لوچە	لوچ
لوڕ	لور
لوڕی	لوری
لوک	لوک
لوکارنۆ	لوکارنو
لوکاس	لوکاس
لوی	لوی
لویس	لویس
لویی	لویی
لوێرێ	لور
لچک	لچک
لکە	لکە
لۆرا	لورا
لۆرد	لرد
لۆرکا	لورکا
لۆری	لوری
لۆریس	لوریس
لۆرێن	لورن
لۆرێنس	لورنس
لۆس	لوث
لۆسی	لوسی
لۆسیۆ	لوسیو
لۆلا	لولا
لۆمۆند	لوموند
لۆپ	لپ
لۆپێز	لوپز
لۆڤەر	لوور
لۆک	لوک
لۆکارنۆ	لوکارنو
لۆکاس	لوکاس
لۆگۆ	لوگو
لۆی	لوی
لی	لی
لیاو	لیاو
لیبرال	لیبرال
لیبرالی	لیبرالی
لیبراڵی	لیبرالی
لیبی	لیبی
لیبیایی	لیبیایی
لیتر	لیتر
لیدز	لیدز
لیدی	لیدی
لیز	لیز
لیزا	لیزا
لیسبۆن	لیسبون
لیست	لیست
لیستێ	لیست
لیستە	لیست
لیسی	لیسی
لیل	لیل
لیلی	لیلی
لیمۆ	لیمو
لینا	لینا
لیندا	لیندا
لینچ	لینچ
لیو	لیو
لیوان	لیوان
لیون	لیون
لیگ	لیگ
لیگا	لیگا
لیۆ	لیو
لیۆن	لیون
لیۆنارد	لیونارد
لێئۆنێ	لون
لێبوو	لبو
لێت	لت
لێدان	لێدان
لێرە	لر
لێم	لم
لێوی	لوی
لێوەر	لور
لێوەی	لوی
لێک	لک
لێکی	لکی
لێی	لی
لێیە	لی
لێیەو	لیو
لێیەوە	لیو
لەئابی	لابی
لەئارا	لارا
لەئێش	لش
لەئەبو	لبو
لەئەرک	لرک
لەئەم	لم
لەب	لب
لەبالەب	لبالب
لەبلەبی	لبلبی
لەبۆ	لبو
لەبێ	لب
لەت	لت
لەتیف	لطیف
لەتیفی	لطیفی
لەجێ	لج
لەحیم	لحیم
لەرزەی	لرزی
لەسان	لسان
لەش	لش
لەشکر	لشکر
لەشکری	لشکری
لەشکرێ	لشکر
لەشکەر	لشکر
لەشکەری	لشکری
لەشکەرێ	لشکر
لەشی	لشی
لەشێ	لش
لەعل	لعل
لەعنەت	لعنت
لەق	لق
لەقاندن	لەقاندن
لەقەب	لقب
لەقەم کردن	لەقەم کردن
لەلە	لەلە
لەم	لم
لەمس	لمس
لەمە	لم
لەنجباز	لەنجباز
لەندن	لندن
لەندەن	لندن
لەنگ	لنگ
لەنگی	لنگی
لەنگەری	لنگری
لەوتەی	لوطی
لەوح	لوح
لەوحەی	لوحی
لەورا	لورا
لەوزەی	لوزی
لەوی	لوی
لەوێن	لون
لەوێنەی	لونی
لەوەتەی	لوطی
لەوەی	لوی
لەپێ	لپ
لەچک	لچک
لەچەک	لچک
لەڕێ	لر
لەڕێزی	لرزی
لەک	لک
لەکم	لەکم
لەگەن	لگن
لەی	لی
لەیدی	لیدی
لەیزین	لەیزین
لەیس	لیث
لەیلا	لیلا
لەیلاج	لیلاج
لەیلی	لیلی
لەیەک	لیک
لەیەکێ	لیک
ما	ما
مات	مات
ماتریکس	ماتریکس
ماتیاس	ماتیاس
ماتیک	ماتیک
ماتیۆ	ماتیو
ماتەم	ماتم
ماتەمین	ماتمین
ماجد	ماجد
مادام	مادام
مادلین	مادلین
مادی	مادی
مادیان	مادیان
مادێ	ماد
مادە	ماد
مادەر	مادر
مادەرزاد	مادرزاد
مادەی	مادی
مادەیە	مادی
مادەەی	مادی
مار	مار
مارا	مارا
مارتا	مارتا
مارتن	مارتن
مارتین	مارتین
مارس	مارس
مارسی	مارسی
مارسێل	مارسل
مارسێلۆ	مارسلو
مارشال	مارشال
مارشاڵ	مارشال
مارلۆن	مارلون
مارلین	مارلین
مارچ	مارچ
مارک	مارک
مارکس	مارکس
مارکوس	مارکوس
مارکۆ	مارکو
مارکۆس	مارکوس
مارکێز	مارکز
مارگیر	مارگیر
ماری	ماری
ماریا	ماریا
ماریانۆ	ماریانو
مارینا	مارینا
ماریۆ	ماریو
مارێک	مارک
مارە	مار
مازی	ماضی
مازیار	مازیار
ماساژ	ماساژ
ماست	ماست
ماسک	ماسک
ماسکە	ماسک
ماسی	ماسی
ماسیمۆ	ماسیمو
ماسە	ماسە
ماعدە	ماعدە
مافی	مافی
مافیا	مافیا
مافیای	مافیای
مافەی	مافی
مال	مال
مالا	مآلا
مالامال	مالامال
مالاوی	مالاوی
مالم	مالم
مالک	مالک
مالکی	مالکی
مالکین	مالکین
مالی	مالی
مالێ	مال
مالێک	مالک
مام	مام
ماما	ماما
مانا	مانا
مانایی	مانایی
مانایەی	مانایی
ماندی	ماندی
ماندێلا	ماندلا
مانسینی	مانسینی
مانع	مانع
مانی	مانی
مانیا	مانیا
مانەند	مانند
مانەوەی	مانوی
ماهر	ماهر
ماهوور	ماهور
ماهی	ماهی
ماچ	ماچ
ماچە	ماچە
ماژ	ماژ
ماک	ماک
ماکس	ماکس
ماڵ	مال
ماڵانەی	مالانی
ماڵدیڤ	مالدیو
ماڵی	مالی
ماڵێک	مالک
ماڵێکی	مالکی
ماڵە	مال
ماڵەکە	مالک
ماڵەکەی	مالکی
ماڵەی	مالی
مایر	مایر
مایلی	مایلی
ماین	ماین
مایو	مایو
مایورکا	مایورکا
مایک	مایک
مایکل	مایکل
مایکڵ	مایکل
مایۆ	مایو
مایۆرکا	مایورکا
مایەر	مایر
مایەوە	مایو
مایەوەو	مایو
ماە	ما
مبارک	مبارک
مبارەک	مبارک
مبالات	مبالات
مت	مت
متران	مطران
متەحەیر	متحیر
متەهەم	متهم
مجری	مجری
مجو	مجو
مجید	مجید
محسن	محسن
محمد	محمد
محمود	محمود
محمەد	محمد
محەمەد	محمد
محەمەدی	محمدی
محەمەدە	محمد
مخالف	مخالف
مخمور	مخمور
مدارا	مدارا
مدیر	مدیر
مدەت	مدت
مراد	مراد
مرادی	مرادی
مراسم	مراسم
مرد	مرد
مردار	مردار
مردار کردن	مردار کردن
مردن	مردن
مرز	مرز
مرمەکی	مرمکی
مرواری	مرواری
مرواریدی	مرواریدی
مرکز	مرکز
مرۆی	مروی
مری	مری
مرید	مرید
مریل	مریل
مریم	مریم
مریوان	مریوان
مریەم	مریم
مرەبا	مربا
مزد	مزد
مزوری	مزوری
مزووری	مزوری
مزەور	مزور
مس	مس
مسافر	مسافر
مسافەرەت	مسافرت
مستند	مستند
مستەحەق	مستحق
مستەر	مستر
مسر	مسر
مسری	مسری
مسرێ	مسر
مسعود	مسعود
مسقاڵ	مثقال
مسلم	مسلم
مسوار	مسوار
مسگەر	مسگر
مسگەری	مسگری
مسین	مسین
مش	مش
مشایخ	مشایخ
مشایەخ	مشایخ
مشت	مشت
مشتاق	مشتاق
مشتە	مشتە
مشعەل	مشعل
مشک	مشک
مشکانەی	مشکانی
مشکی	مشکی
مشیر	مشیر
معروف	معروف
معەمەر	معمر
مغازە	مغازە
مفت	مفت
مفتێ	مفت
مقداد	مقداد
مقدادیە	مقدادی
مقەوا	مقوا
مل	مل
ملا	ملا
ملازم	ملازم
ملازمی	ملازمی
ملاقات	ملاقات
ملایم	ملایم
ملت	ملت
ملم	ملم
ملی	ملی
ملیۆنێر	ملیونر
ملێ	مل
ملێون	ملون
ملێۆن	ملون
ملەت	ملت
ممفیس	ممفیس
ممکون	ممکن
من	من
منا	منا
مناجات	مناجات
منارە	منارە
منارەی	مناری
مناسب	مناسب
منافق	منافق
مناڵ	منال
مناڵان	منالان
منم	منم
منی	منی
منێ	من
منە	من
منەت	منت
منەو	منو
منەوە	منو
مهاباد	مهاباد
مهدی	مهدی
مهر	مهر
مهری	مهری
مو	مو
موئەید	موید
موئەیەد	موید
موبایل	موبایل
مودیر	مدیر
مور	مور
موردار	مردار
مورسیا	مورسیا
مورگان	مورگان
موزیک	موزیک
موزیکێ	موزیک
موس	موس
موساد	موساد
موسل	موصل
موسلێ	موصل
موسڵ	موصل
موسڵە	موصل
موسی	موسی
موسەوی	موسوی
موشەک	موشک
موفتی	مفتی
موفق	موفق
موفەق	موفق
مولا	مولا
مولاقات	ملاقات
مولود	مولود
مولێر	مولر
مولەر	مولر
مونا	مونا
مونتاژ	مونتاژ
موهر	مهر
موو	مو
مووخل	مووخل
موود	موود
مووسل	موصل
مووسڵ	موصل
مووسەوی	موسوی
مووشەک	موشک
موولێر	مولر
مووچ	مچ
موژدە	مژدە
موڵەتی	مولتی
موێش	موش
موەفەق	موفق
مژدە	مژدە
مژە	مژە
مژەو	مژە
مۆبایل	موبایل
مۆبایلە	موبایل
مۆتۆرۆلا	موتورولا
مۆر	مور
مۆراتی	موراتی
مۆرفی	مورفی
مۆرگان	مورگان
مۆرگن	مورگن
مۆریس	موریس
مۆرینیۆ	مورینیو
مۆز	موز
مۆزیک	موزیک
مۆفق	موفق
مۆفەق	موفق
مۆلن	مولن
مۆلەتی	مولتی
مۆلەر	مولر
مۆم	موم
مۆنا	مونا
مۆناکۆ	موناکو
مۆنتاژ	مونتاژ
مۆنتراڵ	مونترال
مۆنتێر	مونتر
مۆندۆ	موندو
مۆنیکا	مونیکا
مۆڵ	مول
مۆڵن	مولن
مۆڵەتی	مولتی
مۆڵەتەی	مولتی
می	می
میا	میا
میامی	میامی
میان	میان
میانمار	میانمار
میانی	میانی
میانە	میانە
میت	میت
میترا	میترا
میتران	میتران
میتەران	میتران
میدل	میدل
میدڵ	میدل
میرا	میرا
میرزا	میرزا
میرند	میرند
میرۆسلاڤ	میروسلاو
میری	میری
میز	میز
میساق	میثاق
میساقی	میثاقی
میسان	میسان
میسر	میسر
میسرە	میسر
میسڕ	میسر
میشائیل	میشائیل
میشل	میشل
میشیگان	میشیگان
میشێل	میشل
میشێڵ	میشل
میل	میل
میلاد	میلاد
میلادی	میلادی
میلان	میلان
میلز	میلز
میلیارد	میلیارد
میلیشیا	میلیشیا
میلیۆن	میلیون
میلێر	میلر
میلەر	میلر
مین	مین
مینا	مینا
میندا	میندا
مینوو	مینو
مینە	مین
میهمان	میهمان
میوە	میو
میوە	میوە
میوەجات	میوەجات
میوەو	میو
میچڵ	میچل
میچێل	میچل
میکا	میکا
میکرۆب	میکروب
میکس	میکس
میکل	میکل
میکۆلی	میکولی
میکی	میکی
میگ	میگ
میگێل	میگل
مێترۆ	مترو
مێرد	مرد
مێردم	مردم
مێردی	مردی
مێردێک	مردک
مێرکل	مرکل
مێرکڵ	مرکل
مێرکێل	مرکل
مێریل	مریل
مێزی	مذی
مێش	مش
مێشک	مشک
مێشکی	مشکی
مێل	مل
مێلبۆرن	ملبورن
مێلبۆڕن	ملبورن
مێلۆدی	ملودی
مێلی	ملّی
مێن	من
مێهدی	مهدی
مێهر	مهر
مێهران	مهران
مێهرداد	مهرداد
مێهری	مهری
مێهرەبان	مهربان
مێو	مو
مێگا	مگا
مێگاوات	مگاوات
مێینە	مین
مێینەو	مینو
مەئەڤ	مو
مەبلەغ	مبلغ
مەبو	مبو
مەت	مت
مەتر	متر
مەتران	مطران
مەترانی	مطرانی
مەترو	مترو
مەترێک	مترک
مەترە	متر
مەترەو	مترو
مەتی	متی
مەتین	متین
مەتیۆ	متیو
مەجدی	مجدی
مەجنون	مجنون
مەجید	مجید
مەجیدی	مجیدی
مەجەری	مجری
مەحاڵ	محال
مەحاڵە	محال
مەحجوب	محجوب
مەحرەم	محرم
مەحفوز	محفوظ
مەحمود	محمود
مەحمودی	محمودی
مەحموود	محمود
مەحمەد	محمد
مەحکوم	محکوم
مەحکووم	محکوم
مەحکەم	محکم
مەحەمەد	محمد
مەحەک	محک
مەخمور	مخمور
مەخموری	مخموری
مەخموور	مخمور
مەخمووری	مخموری
مەد	مد
مەدنی	مدنی
مەدەدکار	مددکار
مەدەنی	مدنی
مەرام	مرام
مەرامی	مرامی
مەراکش	مراکش
مەرجان	مرجان
مەرجانە	مرجان
مەرجەعی	مرجعی
مەرحەبا	مرحبا
مەرحەمەت	مرحمت
مەردان	مردان
مەردم	مردم
مەردید	مردید
مەردەن	مردن
مەرز	مرز
مەرزی	مرضی
مەرسومی	مرسومی
مەرقەدی	مرقدی
مەرهەم	مرهم
مەروان	مروان
مەرکەزی	مرکزی
مەرگ	مرگ
مەریخ	مریخ
مەریخی	مریخی
مەرید	مرید
مەریدی	مریدی
مەریوان	مریوان
مەریەم	مریم
مەریەمی	مریمی
مەرەم	مرم
مەرەکەب	مرکب
مەزار	مزار
مەزن	مزن
مەزنێ	مزن
مەزنە	مزن
مەزهەب	مذهب
مەزهەبی	مذهبی
مەزهەر	مظهر
مەزهەری	مظهری
مەست	مست
مەست کردن	مست کردن
مەستی	مستی
مەستەر	مستر
مەسرور	مسرور
مەسروور	مسرور
مەسعود	مسعود
مەسعودی	مسعودی
مەسعوود	مسعود
مەسعوودی	مسعودی
مەسعەب	مصعب
مەسقەت	مسقط
مەسیح	مسیح
مەسیحی	مسیحی
مەسیحیان	مسیحیان
مەسەلە	مثل
مەسەلەی	مصلی
مەشایخی	مشایخی
مەشایی	مشایی
مەشعەل	مشعل
مەشق	مشق
مەشقە	مشق
مەشهەد	مشهد
مەشهەدی	مشهدی
مەشک	مشک
مەعارفی	معارفی
مەعاف	معاف
مەعدەن	معدن
مەعروف	معروف
مەعرووف	معروف
مەعسوم	معصوم
مەعسووم	معصوم
مەعسوومی	معصومی
مەعنەوی	معنوی
مەعنەوەی	معنوی
مەعەمەر	معمر
مەغرب	مغرب
مەغربی	مغربی
مەغز	مغز
مەفاخری	مفاخری
مەقام	مقام
مەقامی	مقامی
مەل	مل
مەلا	ملا
مەلایر	ملایر
مەلایری	ملایری
مەلمەل	ململ
مەلە	مل
مەلەس	ملس
مەلەوانی	ملوانی
مەلەک	ملک
مەلەکان	ملکان
مەلەکی	ملکی
مەلەی	ملّی
مەملەکەت	مملکت
مەمک	ممک
مەن	من
مەنامە	منام
مەنتقی	منطقی
مەنجوق	منجوق
مەنجەنیق	منجنیق
مەند	مند
مەنزەل	منزل
مەنسور	منثور
مەنسوری	منصوری
مەنسوور	منثور
مەنفەعەت	منفعت
مەنی	منی
مەهاباد	مهاباد
مەهار	مهار
مەهار کردن	مهار کردن
مەهارەت	مهارت
مەهتاب	مهتاب
مەهدی	مهدی
مەهدەوی	مهدوی
مەهشید	مهشید
مەهناز	مهناز
مەهین	مهین
مەهێ	مه
مەو	مو
مەوجود	موجود
مەولانا	مولانا
مەولود	مولود
مەولودی	مولودی
مەولوود	مولود
مەولەوی	مولوی
مەچ	مچ
مەڕدار	مردار
مەڕو	مرو
مەڕی	مری
مەک	مک
مەکبێس	مکبث
مەکتوب	مکتوب
مەکتەب	مکتب
مەکتەبی	مکتبی
مەکزیک	مکزیک
مەکزیکی	مکزیکی
مەکس	مکث
مەکی	مکی
مەکە	مک
مەکەن	مکن
مەگەر	مگر
مەگەس	مگس
مەڵەوانی	ملوانی
مەی	می
مەیا	میا
مەیامی	میامی
مەیان	میان
مەیجەر	میجر
مەیدان	میدان
مەیدانی	میدانی
مەیسون	میسون
مەیسەر	میسر
مەیسەم	میثم
مەیل	میل
مەیل	مەیل
مەیمون	میمون
مەیموون	میمون
مەیمەنەت	میمنت
مەیوە	مەیوە
مەیێ	می
مەیێن	مین
نا	نا
نائارام	ناآرام
ناباب	ناباب
نابینا	نابینا
نابێ	ناب
ناتالی	ناتالی
ناتوانی	ناتوانی
ناتوانێ	ناتوان
ناتۆ	ناتو
ناتەوان	ناتوان
ناجی	ناجی
ناحیە	ناحیە
ناخودا	ناخدا
ناخون	ناخن
ناخۆش	ناخوش
ناخۆشی	ناخوشی
ناخۆشە	ناخوش
نادر	نادر
نادری	نادری
نادرێ	نادر
نادیا	نادیا
نادەم	نادم
نارازی	ناراضی
نارنج	نارنج
نارنجۆک	نارنجک
نارنجەک	نارنجک
نارنگی	نارنگی
ناز	ناز
ناز کردن	ناز کردن
نازانێ	نازان
نازری	ناظری
نازم	نازم
نازونیمناز	نازونیمناز
نازک	نازک
نازکەش	نازکش
نازکەی	نازکی
نازی	نازی
نازێ	ناز
نازێری	ناظری
نازەنین	نازنین
ناس	ناس
ناسا	ناسا
ناسازگار	ناسازگار
ناساف	ناصاف
ناسح	ناصح
ناسر	ناصر
ناسری	ناصری
ناسریە	ناصری
ناشاد	ناشاد
ناشایستە	ناشایست
ناشایستە	ناشایستە
ناشتا	ناشتا
ناشرین	ناشرین
ناشی	ناشی
ناف	ناف
نافع	نافع
نافەرمان	نافرمان
نالی	نالی
نام	نام
نامجوو	نامجو
نامردی	نامردی
ناموس	ناموس
نامووس	ناموس
نامی	نامی
نامێ	نام
نامە	نام
نامە	نامە
نامەحرەم	نامحرم
نامەدار	نامدار
نامەرد	نامرد
نامەی	نامی
نامەیە	نامی
نان	نان
نان بەیات	نان بیات
نان ساجی	نان ساجی
نانسی	نانسی
نانە	نان
نانەوا	نانوا
نانەوایی	نانوایی
ناهید	ناهید
ناهەموار	ناهموار
ناهەنجار	ناهنجار
ناو	ناو
ناوکە	ناوکە
ناوێ	ناو
ناوێک	ناوک
ناوە	ناو
ناوەو	ناو
ناوەوە	ناو
ناپاکی	ناپاکی
ناپلیۆن	ناپلیون
ناپۆلی	ناپولی
ناپەسند	ناپسند
ناپەسەند	ناپسند
ناچار	ناچار
ناچاری	ناچاری
ناڕازی	ناراضی
ناڕاستی	ناراستی
ناڕەوا	ناروا
ناڤ	ناو
ناڤبری	ناوبری
ناڤێ	ناو
ناکازاکی	ناکازاکی
ناکام	ناکام
ناکۆک	ناکوک
ناکەس	ناکس
ناگەهان	ناگهان
ناڵێم	نالم
ناڵەی	نالی
نای	نای
نایاب	نایاب
نایابی	نایابی
نایتلی	نایتلی
نایە	نای
نبی	نبی
نجم	نجم
نجێفی	نجفی
ندارند	ندارند
ندارە	ندار
نرخ	نرخ
نرخە	نرخ
نریمان	نریمان
نزا	نزا
نزار	نزار
نزدیک	نزدیک
نزدیکی	نزدیکی
نزم	نظم
نزمە	نظم
نسار	نثار
نشاستە	نشاستە
نشتێر	نشتر
نشین	نشین
نشینان	نشینان
نشینی	نشینی
نعمان	نعمان
نعمت	نعمت
نعمەت	نعمت
نفرین	نفرین
نم	نم
نم نم	نم نم
نما	نما
نماز	نماز
نمایش	نمایش
نمایشە	نمایش
نمدار	نمدار
نمەد	نمد
نمەک	نمک
نمەک گیر	نمک گیر
نمەکدان	نمکدان
نهێلی	نهلی
نو	نو
نوبڵ	نوبل
نوح	نوح
نور	نور
نورالدین	نورالدین
نوری	نوری
نوزاد	نوزاد
نوزەری	نوذری
نوو	نو
نوور	نور
نوورانی	نورانی
نووربەخش	نوربخش
نووری	نوری
نوچەیێن	نوچین
نوکە	نوک
نوکەیا	نوکیا
نویێن	نوین
نوێ	نو
نوێن	نون
نوێوە	نو
نوێێ	نو
نژاد	نژاد
نڤیسی	نویسی
نگهبان	نگهبان
نگین	نگین
نۆ	نو
نۆبل	نوبل
نۆبڵ	نوبل
نۆرتۆن	نورتون
نۆرس	نورس
نۆرماڵ	نورمال
نۆرمەن	نورمن
نۆریس	نوریس
نۆرەی	نوری
نۆزدە	نوزد
نۆزدەهەم	نوزدهم
نۆشادر	نشادر
نۆلان	نولان
نۆک	نوک
نۆک	نک
نۆکیا	نوکیا
نۆێ	نو
نی	نی
نیا	نیا
نیاز	نیاز
نیازی	نیازی
نیازە	نیاز
نیان	نیان
نیت	نیت
نیرۆ	نیرو
نیس	نیس
نیسان	نیسان
نیسانێ	نیسان
نیست	نیست
نیل	نیل
نیلسۆن	نیلسون
نیلووفەر	نیلوفر
نیم	نیم
نیما	نیما
نیمچە	نیمچە
نینا	نینا
نینەو	نینو
نیو	نیو
نیوتن	نیوتن
نیوجێرسی	نیوجرسی
نیوز	نیوز
نیوکاسل	نیوکاسل
نیوکاسڵ	نیوکاسل
نیویۆرک	نیویورک
نیوە	نیو
نیڤ	نیو
نیک	نیک
نیکبەخت	نیکبخت
نیکسۆن	نیکسون
نیکلاس	نیکلاس
نیکولا	نیکولا
نیکولاس	نیکولاس
نیکۆتین	نیکوتین
نیکۆل	نیکول
نیکۆلا	نیکولا
نیکۆلاس	نیکولاس
نیکۆڵ	نیکول
نیکۆڵاس	نیکولاس
نیکی	نیکی
نیۆ	نیو
نیۆیۆرک	نیویورک
نیۆیۆرکێ	نیویورک
نیە	نی
نیەئەو	نیو
نیەتی	نیتی
نیەو	نیو
نێت	نت
نێدا	ندا
نێر	نر
نێرو	نرو
نێروەو	نرو
نێروەیی	نرویی
نێرگس	نرگس
نێستا	نستا
نێعمەتی	نعمتی
نێلسۆن	نلسون
نێو	نو
نێڤ	نو
نێیسۆن	نیسون
نەئەو	نو
نەبات	نبات
نەباتی	نباتی
نەبرد	نبرد
نەبو	نبو
نەبوو	نبو
نەبووە	نبو
نەبوە	نبو
نەبۆ	نبو
نەبی	نبی
نەبیل	نبیل
نەبین	نبین
نەبینی	نبینی
نەبەرد	نبرد
نەبەز	نبض
نەترس	نترس
نەتوانێ	نتوان
نەجات	نجات
نەجاتی	نجاتی
نەجار	نجار
نەجاری	نجاری
نەجم	نجم
نەجوا	نجوا
نەجیب	نجیب
نەجەف	نجف
نەجەفی	نجفی
نەجەفیان	نجفیان
نەخێر	نخر
نەدا	ندا
نەداری	نداری
نەدان	ندان
نەدانی	ندانی
نەدرێ	ندر
نەدرێت	ندرت
نەدیدە	ندید
نەدیم	ندیم
نەرخ	نرخ
نەرد	نرد
نەرم	نرم
نەرمی	نرمی
نەروێژ	نروژ
نەروێژی	نروژی
نەرگس	نرگس
نەریمان	نریمان
نەریمانی	نریمانی
نەرێ	نر
نەزار	نزار
نەزدیک	نزدیک
نەزیر	نذیر
نەزیف	نظیف
نەزەری	نذری
نەزەند	نزند
نەسار	نثار
نەسر	نثر
نەسری	نسری
نەسرین	نسرین
نەسل	نسل
نەسیر	نصیر
نەسیری	نصیری
نەسیم	نسیم
نەشئەت	نشت
نەشنال	نشنال
نەشێت	نشت
نەعل	نعل
نەعمەت	نعمت
نەعیم	نعیم
نەعیمی	نعیمی
نەفت	نفت
نەفتالین	نفتالین
نەفرین	نفرین
نەفرەت	نفرت
نەفس	نفس
نەفەر	نفر
نەفەرات	نفرات
نەفەس	نفس
نەقدی	نقدی
نەقش	نقش
نەقی	نقی
نەقیب	نقیب
نەقیبی	نقیبی
نەقیبێ	نقیب
نەقەب	نقب
نەل	نل
نەم	نم
نەما	نما
نەمان	نمان
نەمانی	نمانی
نەمرود	نمرود
نەمروود	نمرود
نەنگ	ننگ
نەنگین	ننگین
نەهرۆ	نهرو
نەهی	نهی
نەهێ	نه
نەهێشت	نهشت
نەهێشتن	نهشتن
نەهەم	نهم
نەهەمین	نهمین
نەهەنگ	نهنگ
نەو	نو
نەو	نە
نەوا	نوا
نەوار	نوار
نەواز	نواز
نەوازش	نوازش
نەوجوان	نوجوان
نەوجەوان	نوجوان
نەوروز	نوروز
نەوروزێ	نوروز
نەورۆز	نوروز
نەورۆزی	نوروزی
نەورۆزێ	نوروز
نەورەس	نورس
نەوزاد	نوزاد
نەوش	نوش
نەوع	نوع
نەوید	نوید
نەوەد	نود
نەوەک	نوک
نەڕەی	نری
نەژاد	نژاد
نەژادی	نژادی
نەژادیان	نژادیان
نەک	نک
نەکا	نکا
نەکات	نکات
نەکرد	نکرد
نەکردن	نکردن
نەکردنی	نکردنی
نەکو	نکو
نەکەن	نکن
نەگین	نگین
نەگەری	نگری
نەی	نی
نەیاسایی	نیاسایی
نەیجەر	نیجر
نەیسۆن	نیسون
نەیشەکر	نیشکر
نەیشەکەر	نیشکر
نەینەوا	نینوا
نەیەت	نیت
نەیەتە	نیت
هائیتی	هائیتی
هابێرماس	هابرماس
هات	هات
هاتە	هات
هاجەر	هاجر
هادی	هادی
هار	هار
هاردی	هاردی
هارمۆنی	هارمونی
هاروارد	هاروارد
هارون	هارون
هارپێر	هارپر
هارڤارد	هاروارد
هارۆڵد	هارولد
هاری	هاری
هاریسۆن	هاریسون
هاشم	هاشم
هاشمی	هاشمی
هافمەن	هافمن
هال	هال
هالو	هالو
هالە	هال
هامبورگ	هامبورگ
هامبوورگ	هامبورگ
هامبۆرگ	هامبورگ
هاملێت	هاملت
هاموون	هامون
هانا	هانا
هانس	هانس
هانۆڤەر	هانوور
هانی	هانی
هانیبال	هانیبال
هاوارد	هاوارد
هاوایی	هاوایی
هاوس	هاوس
هاوسێ	هاوس
هاون	هاون
هاوێل	هاول
هاوەن	هاون
هاپکینز	هاپکینز
هاڤانا	هاوانا
هاگ	هاگ
هاڵ	هال
هاینز	هاینز
هاینزە	هاینز
هاینێر	هاینر
هزار	هزار
هزاران	هزاران
هشام	هشام
هشتن	هشتن
هشیار	هشیار
هلمەند	هلمند
هلێن	هلن
همین	همین
هند	هند
هندۆراس	هندوراس
هندی	هندی
هندێ	هند
هنر	هنر
هنری	هنری
هنەر	هنر
هنەرمەند	هنرمند
هوا	هوا
هوارد	هوارد
هود	هود
هوشیار	هشیار
هوشیار	هوشیار
هوشیاری	هشیاری
هوشیاری	هوشیاری
هوشەنگ	هوشنگ
هوما	هما
هومەر	هومر
هومەن	هومن
هوو	هوو
هوود	هود
هوور	هور
هووشمەند	هوشمند
هووشەنگ	هوشنگ
هوومەن	هومن
هوویچ	هیچ
هوپێر	هوپر
هوگۆ	هوگو
هۆر	هر
هۆراسان	هراسان
هۆردو	هردو
هۆرە	هور
هۆستۆن	هوستون
هۆش	هوش
هۆشبەری	هوشبری
هۆشمەند	هوشمند
هۆشیار	هشیار
هۆشیار	هوشیار
هۆشیاری	هشیاری
هۆشیاری	هوشیاری
هۆشەنگ	هوشنگ
هۆل	هول
هۆلمز	هولمز
هۆمەر	هومر
هۆندا	هوندا
هۆنگ	هونگ
هۆگۆ	هوگو
هۆڵ	هول
هۆڵمز	هولمز
هیتلێر	هیتلر
هیتلەر	هیتلر
هیس	هیس
هیل	هیل
هیلاری	هیلاری
هیلتۆن	هیلتون
هیو	هیو
هیوا	هیوا
هیوایەی	هیوایی
هیوز	هیوز
هیوستن	هیوستن
هیوندای	هیوندای
هیچ	هیچ
هیچکارە	هیچکارە
هیچکاک	هیچکاک
هیچی	هیچی
هیڵ	هیل
هیۆستن	هیوستن
هێدی	هدی
هێرتا	هرتا
هێرتزوگ	هرتزوگ
هێرتزۆگ	هرتزوگ
هێرناندز	هرناندز
هێرکول	هرکول
هێرە	هرە
هێشت	هشت
هێشتن	هشتن
هێل	هل
هێلمەند	هلمند
هێلی	هلی
هێلێن	هلن
هێما	هما
هێند	هند
هێندە	هند
هێنری	هنری
هێنریک	هنریک
هێنەر	هنر
هێنەری	هنری
هێور	هور
هێچ	هچ
هێکتار	هکتار
هێڵ	هل
هێڵی	هلی
هێڵە	هل
هەجو	هجو
هەدەر	هدر
هەدەف	هدف
هەر	هر
هەراسان	هراسان
هەراسە	هراس
هەردەم	هردم
هەرس	هرس
هەرسێ	هرس
هەرچەند	هرچند
هەرکەس	هرکس
هەریس	هریس
هەریسۆن	هریسون
هەریەک	هریک
هەریەکە	هریک
هەرێم	هرم
هەرێمێ	هرم
هەرێمە	هرم
هەرە	هر
هەرەس	هرس
هەرەندی	هرندی
هەرەیەک	هریک
هەزار	هزار
هەزاران	هزاران
هەزارپا	هزارپا
هەزارە	هزار
هەست	هست
هەست و نیست	هست و نیست
هەستم	هستم
هەستی	هستی
هەستە	هست
هەشت	هشت
هەشتم	هشتم
هەشتی	هشتی
هەشتێ	هشت
هەشتەم	هشتم
هەفت	هفت
هەفتێ	هفت
هەفتە	هفت
هەفتەم	هفتم
هەل	هل
هەلاهەل	هلاهل
هەلو	هلو
هەلۆ	هلو
هەلی	هلی
هەلێر	هلر
هەلەو	هلو
هەلەی	هلی
هەم	هم
هەم پەیمان	هم پیمان
هەمام	همام
هەمان	همان
هەمانە	همان
هەمبەرگر	همبرگر
هەمبەری	همبری
هەمدەرد	همدرد
هەمدەم	همدم
هەمسەر	همسر
هەمشەهری	همشهری
هەمو	همو
هەموار	هموار
هەمواری	همواری
هەموو	همو
هەمین	همین
هەمە	هم
هەمەدان	همدان
هەمەدانی	همدانی
هەند	هند
هەندێ	هند
هەنکس	هنکس
هەنگ	هنگ
هەنەر	هنر
هەوا	هوا
هەوار	هوار
هەوایی	هوایی
هەور	هور
هەول	هول
هەوڵ	هول
هەوڵە	هول
هەوەس	هوس
هەڕ	هر
هەژموونی	هژمونی
هەڤرا	هورا
هەڵ	هل
هەڵم	هلم
هەڵو	هلو
هەڵۆ	هلو
هەڵی	هلی
هەڵە	هل
هەڵەن	هلن
هەڵەو	هلو
هەڵەی	هلی
هەڵەیە	هلی
هەیبەت	هیبت
هەیسەم	هیثم
هەیهات	هیهات
هەیڤا	هیوا
هەیڤێ	هیو
هەیڤێن	هیون
هەیکەل	هیکل
هەیکەلی	هیکلی
هەیەئەو	هیو
هەیەو	هیو
و	و
وئێستا	وسطا
وا	وا
وائل	وال
وائلی	والی
وات	وات
واتسۆن	واتسون
واتە	وات
واجب	واجب
واجبی	واجبی
واحد	واحد
وادار	وادار
وادار کردن	وادار کردن
وادی	وادی
وادەی	وادی
وادەیە	وادی
وارد	وارد
وارسی	وارسی
وارنێر	وارنر
واز	واز
واست	واسط
واستی	واسطی
واسق	واثق
واشەر	واشر
واقع	واقع
واقعی	واقعی
وال	وال
والاس	والاس
والتێر	والتر
والتەر	والتر
والی	والی
وام	وام
وامداری	وامداری
وان	وان
وانا	وانا
وانگ	وانگ
وانێ	وان
وانە	وان
واژە	واژە
واکس	واکس
واکسی	واکسی
واکێر	واکر
واگنێر	واگنر
واگۆن	واگن
واڵ	وال
واڵا	والا
واڵتەر	والتر
وای	وای
وایز	وایز
واین	واین
وایەر	وایر
وبێ	وب
وبە	وب
وتن	وطن
وتنی	وطنی
وتو	وتو
وتووە	وتو
وتوە	وتو
وتی	وطی
وتەو	وتو
وتەی	وطی
وجدان	وجدان
ودی	ودی
ورد	ورد
وردی	وردی
وردیان	وردیان
وردە	ورد
ورمێ	ورم
وز	وز
وزارەتی	وزارتی
وزیری	وزیری
وزەو	وضو
وزەوز	وزوز
وزەی	وذی
وست	وست
وسمە	وسمە
وسواس	وسواس
وسووقی	وثوقی
وشتر	شتر
وشە	وش
ول	ول
ولایەتی	ولایتی
ولایەتە	ولایت
ولی	ولی
ولید	ولید
ولە	ول
ولەو	ولو
ون	وِن
وهاب	وهاب
ووتنی	وطنی
ووتی	وطی
ووتەی	وطی
وود	وود
وودی	وودی
وورد	ورد
ووردی	وردی
ووزەو	وضو
ووزەی	وذی
وون	وِن
وۆدی	وودی
وۆلف	وولف
وۆڵف	وولف
وی	وی
ویت	ویت
ویدا	ویدا
ویدیۆیی	ویدیویی
ویس	ویس
ویسی	ویسی
ویل	ویل
ویلسۆن	ویلسون
ویلی	ویلی
ویلیام	ویلیام
ویلیامز	ویلیامز
ویمبلدۆن	ویمبلدون
ویمبلی	ویمبلی
وین	وین
ویندۆز	ویندوز
ویک	ویک
ویکتۆر	ویکتور
ویکی	ویکی
ویێ	وی
ویێن	وین
ویەک	ویک
وێ	و
وێب	وب
وێرای	ورای
وێرایی	ورآیی
وێردی	وردی
وێزەی	وذی
وێست	وست
وێستێرن	وسترن
وێل	ول
وێلز	ولز
وێلزی	ولزی
وێن	وِن
وێنیز	ونیز
وێنێ	وِن
وێنە	وِن
وێنەکە	ونک
وێنەکەی	ونکی
وێنەگر	ونگر
وێنەگرێ	ونگر
وێڕای	ورای
وێڕایی	ورآیی
وێڵ	ول
وێڵز	ولز
وە	و
وەئێستا	وسطا
وەبەر	وبر
وەتەن	وطن
وەتەنی	وطنی
وەجبەی	وجبی
وەجدی	وجدی
وەحدەت	وحدت
وەحدەتی	وحدتی
وەحید	وحید
وەحیدی	وحیدی
وەدی	ودی
وەرزش	ورزش
وەرزشێ	ورزش
وەرزشە	ورزش
وەرزی	ورزی
وەرزەی	ورزی
وەرشکست	ورشکست
وەرشکستە	ورشکست
وەرشەو	ورشو
وەرەم	ورم
وەزارت	وزارت
وەزارتی	وزارتی
وەزارەت	وزارت
وەزارەتێ	وزارت
وەزی	وذی
وەزیر	وزیر
وەزیران	وزیران
وەزیرانێ	وزیران
وەزیری	وزیری
وەزیریان	وزیریان
وەزیرێ	وزیر
وەزیرە	وزیر
وەزیرەی	وزیری
وەزەی	وذی
وەستا	وسطا
وەسف	وصف
وەسەت	وست
وەفا	وفا
وەفات	وفات
وەفادار	وفادار
وەقایعی	وقایعی
وەقت	وقت
وەقف	وقف
وەقفی	وقفی
وەل	ول
وەلا	ولا
وەلی	ولی
وەلید	ولید
وەلیدی	ولیدی
وەلێ	ول
وەلەو	ولو
وەن	وِن
وەند	وند
وەنسان	ونسان
وەنگۆگ	ونگوگ
وەهاب	وهاب
وەهابی	وهابی
وەهبی	وهبی
وەو	و
وەکالەت	وکالت
وەکیل	وکیل
وەکیلی	وکیلی
وەی	وی
وەیس	ویس
وەیسی	ویسی
وەیلان	ویلان
پا	پا
پابلۆ	پابلو
پابەند	پابند
پابەندی	پابندی
پابەندە	پابند
پاتریس	پاتریس
پاتریک	پاتریک
پاتریۆت	پاتریوت
پاداش	پاداش
پار	پار
پارت	پارت
پارتی	پارتی
پارتیزان	پارتیزان
پارتە	پارت
پارتەی	پارتی
پارس	پارس
پارسال	پارسال
پارساڵ	پارسال
پارسی	پارسی
پارسیان	پارسیان
پارسەنگ	پارسنگ
پارما	پارما
پارچین	پارچین
پارچە	پارچ
پارچەی	پارچی
پارک	پارک
پارکێ	پارک
پاریس	پاریس
پارێ	پار
پارە	پار
پارەو	پارو
پارەکە	پارک
پاس	پاس
پاسداری	پاسداری
پاسوخ	پاسخ
پاسپۆرت	پاسپورت
پاسپۆڕت	پاسپورت
پاسکاڵ	پاسکال
پاسی	پاسی
پاسیفیک	پاسیفیک
پاسە	پاس
پاسەبان	پاسبان
پاشا	پاشا
پاشایی	پاشایی
پاشی	پاشی
پال	پال
پالاس	پالاس
پالان	پالان
پاناما	پاناما
پاندا	پاندا
پاول	پاول
پاوڵ	پاول
پاوەڵ	پاول
پاچینۆ	پاچینو
پاک	پاک
پاکار	پاکار
پاکدەست	پاکدست
پاکسازی	پاکسازی
پاکستان	پاکستان
پاکستانێ	پاکستان
پاکستانە	پاکستان
پاکی	پاکی
پاکەت	پاکت
پاڵ	پال
پاڵاس	پالاس
پای	پای
پایان	پایان
پایتەخت	پایتخت
پاییز	پاییز
پایین	پایین
پایەتەخت	پایتخت
پایەدار	پایدار
پایەداری	پایداری
پایەی	پایی
پتر	پتر
پتەو	پتو
پدرۆ	پدرو
پر	پر
پراگ	پراگ
پرایس	پرایس
پرتەقاڵ	پرتقال
پرد	پرد
پردێ	پرد
پرس	پرس
پرسانە	پرسان
پرسی	پرسی
پرسە	پرس
پرسەش	پرسش
پرسەو	پرسو
پرسەی	پرسی
پرۆستات	پروستات
پری	پری
پرێ	پر
پرێز	پرز
پرێس	پرس
پرێسی	پرسی
پرەنس	پرنس
پزشکی	پزشکی
پسر	پسر
پشت	پشت
پشتی	پشتی
پشتەوە	پشتو
پشک	پشک
پشکێ	پشک
پف	پف
پل	پل
پلاتینی	پلاتینی
پلاستیک	پلاستیک
پلان	پلان
پلانێ	پلان
پلانێک	پلانک
پلانە	پلان
پلانەکە	پلانک
پلگرینی	پلگرینی
پلە	پل
پلەو	پلو
پلەکەی	پلکی
پنتاگۆن	پنتاگون
پوتین	پوتین
پور	پور
پورتسموس	پورتسموث
پوسان	پوسان
پوستەر	پوستر
پوش	پوش
پوف	پف
پول	پول
پولیس	پولیس
پونا	پونا
پوور	پور
پووران	پوران
پووسان	پوسان
پووستەر	پوستر
پووش	پوش
پوول	پول
پوویا	پویا
پڕ	پر
پڕاگ	پراگ
پڕبار	پربار
پڕی	پری
پۆتین	پوتین
پۆرتو	پورتو
پۆرتۆ	پورتو
پۆست	پوست
پۆست کردن	پست کردن
پۆستێ	پوست
پۆستە	پوست
پۆستەر	پوستر
پۆش	پوش
پۆشکین	پوشکین
پۆشی	پوشی
پۆل	پول
پۆلیس	پلیس
پۆلیس	پولیس
پۆلیسە	پولیس
پۆلێک	پولک
پۆلێکی	پولکی
پۆپ	پوپ
پۆڵ	پول
پۆیۆل	پویول
پی	پی
پیاز	پیاز
پیانۆ	پیانو
پیانیست	پیانیست
پیت	پیت
پیتر	پیتر
پیتزا	پیتزا
پیتێر	پیتر
پیتەر	پیتر
پیر	پیر
پیرا	پیرا
پیران	پیران
پیرس	پیرس
پیرو	پیرو
پیروز	پیروز
پیرۆ	پیرو
پیرۆز	پیروز
پیرۆزی	پیروزی
پیرۆزە	پیروز
پیری	پیری
پیرە	پیر
پیس	پیس
پیش	پیش
پیشانی	پیشانی
پیشاوەر	پیشاور
پیشاوەری	پیشاوری
پیشتر	پیشتر
پیشکەش	پیشکش
پیشە	پیش
پیشەکار	پیشکار
پیشەی	پیشی
پیل	پیل
پینتۆ	پینتو
پیواز	پیاز
پیپ	پیپ
پیک	پیک
پیکاسۆ	پیکاسو
پیکێ	پیک
پیۆنگ	پیونگ
پیێ	پی
پیێر	پیر
پێت	پت
پێتر	پتر
پێترا	پترا
پێتەر	پتر
پێدرۆ	پدرو
پێرز	پرز
پێرس	پرس
پێرسی	پرسی
پێرۆ	پرو
پێری	پری
پێریز	پریز
پێرێ	پر
پێرێز	پرز
پێرێس	پرس
پێست	پست
پێستی	پستی
پێش	پش
پێشم	پشم
پێشە	پش
پێشەنگ	پشنگ
پێشەنگی	پشنگی
پێن	پن
پێنج	پنج
پێنجێ	پنج
پێنجەم	پنجم
پێنجەمە	پنجم
پێهێنا	پهنا
پێوست	پوست
پێوستە	پوست
پێوەر	پور
پێوەرە	پور
پێوەست	پوست
پێڕۆ	پرو
پێژمان	پژمان
پێک	پک
پێکر	پکر
پێکی	پکی
پێکێ	پک
پێڵاو	پلاو
پێی	پی
پێیدا	پیدا
پێیە	پی
پێیەش	پیش
پێیەکانی	پیکانی
پەت	پت
پەتا	پتا
پەتو	پتو
پەتی	پتی
پەخش	پخش
پەخشێ	پخش
پەرت	پرت
پەرتەو	پرتو
پەردە	پرد
پەرست	پرست
پەرستار	پرستار
پەرستش	پرستش
پەرستی	پرستی
پەرش	پرش
پەروا	پروا
پەرواری	پرواری
پەرواز	پرواز
پەروردەی	پروردی
پەرویز	پرویز
پەروین	پروین
پەروەر	پرور
پەروەردگار	پروردگار
پەروەردی	پروردی
پەروەری	پروری
پەرچ	پرچ
پەری	پری
پەریزاد	پریزاد
پەریسا	پریسا
پەریشان	پریشان
پەرە	پر
پەرەست	پرست
پەرەستوو	پرستو
پەرەی	پری
پەست	پست
پەستو	پستو
پەستی	پستی
پەسند	پسند
پەسند کردن	پسند کردن
پەسندی	پسندی
پەسەند	پسند
پەسەندی	پسندی
پەسەندە	پسند
پەشم	پشم
پەشمەک	پشمک
پەشیمان	پشیمان
پەشیمانی	پشیمانی
پەشەنگ	پشنگ
پەل	پل
پەلە	پل
پەلەشتی	پلشتی
پەلەنگ	پلنگ
پەلەور	پلور
پەلەوەر	پلور
پەلەوەڕ	پلور
پەلەکان	پلکان
پەناهی	پناهی
پەنج	پنج
پەنجاب	پنجاب
پەنجاهەمین	پنجاهمین
پەنجە	پنج
پەند	پند
پەنهان	پنهان
پەنهانی	پنهانی
پەنیر	پنیر
پەهلەوی	پهلوی
پەڕی	پری
پەڕەی	پری
پەک	پک
پەکی	پکی
پەکەر	پکر
پەی	پی
پەی بردن	پی بردن
پەی کردن	پی کردن
پەیام	پیام
پەیامبەر	پیامبر
پەیامی	پیامی
پەیامێک	پیامک
پەیامە	پیام
پەیامەی	پیامی
پەیاپەی	پیاپی
پەیدا	پیدا
پەیدا کردن	پیدا کردن
پەیرەو	پیرو
پەیرەوی	پیروی
پەیس	پیس
پەیغام	پیغام
پەیغەمبەر	پیغمبر
پەیمان	پیمان
پەیمان بەستن	پیمان بستن
پەیمانی	پیمانی
پەین	پین
پەیوندی	پیوندی
پەیوەست	پیوست
پەیوەستی	پیوستی
پەیوەند	پیوند
پەیڕەو	پیرو
پەیڕەوی	پیروی
پەیڕەوەی	پیروی
پەیک	پیک
پەیکار	پیکار
پەیکەر	پیکر
پەیکەرێ	پیکر
پەیکەرە	پیکر
چابوک	چابک
چابک	چابک
چاد	چاد
چادر	چادر
چادرنشین	چادرنشین
چارلز	چارلز
چارلی	چارلی
چارلێز	چارلز
چارک	چارک
چارڵز	چارلز
چارڵی	چارلی
چارۆک	چارک
چارەکی	چارکی
چاشت	چاشت
چاشنی	چاشنی
چاق	چاق
چالاک	چالاک
چالاکی	چالاکی
چالاکیێ	چالاکی
چالاکیە	چالاکی
چالاکە	چالاک
چان	چان
چانگ	چانگ
چاودار	چاودار
چاپ	چاپ
چاپلین	چاپلین
چاپڵین	چاپلین
چاپی	چاپی
چاپێ	چاپ
چاڤێز	چاوز
چاک	چاک
چاکە	چاک
چاڵ	چال
چاڵاک	چالاک
چاڵاکی	چالاکی
چای	چای
چاینا	چاینا
چایچی	چایچی
چایی	چایی
چرا	چرا
چرک	چرک
چرکە	چرک
چرکەی	چرکی
چرکەیە	چرکی
چریکە	چریک
چشم	چشم
چلی	چلی
چلە	چلە
چلەی	چلی
چنار	چنار
چند	چند
چنگ	چنگ
چنین	چنین
چوب	چوب
چوست	چست
چوستی	چستی
چون	چون
چونی	چونی
چوو	چو
چوون	چون
چوونی	چونی
چوونێ	چون
چوونە	چون
چووە	چو
چڕی	چری
چۆ	چو
چۆرت	چرت
چۆل	چول
چۆلی	چولی
چۆن	چون
چۆنی	چونی
چۆنە	چون
چۆک	چوک
چۆڵ	چول
چۆڵی	چولی
چی	چی
چیان	چیان
چیت	چیت
چیدی	چیدی
چیرە	چیر
چیغ	چیغ
چیمەن	چیمن
چین	چین
چینی	چینی
چینێ	چین
چینە	چین
چینە	چینە
چیە	چی
چیەو	چیو
چێشتە	چشتە
چێلسی	چلسی
چێک	چک
چێڵسی	چلسی
چەتر	چتر
چەترباز	چترباز
چەرخ	چرخ
چەرخی	چرخی
چەرم	چرم
چەفت	چفت
چەلۆ	چلو
چەلەبی	چلبی
چەم	چم
چەموش	چموش
چەمەدان	چمدان
چەمەن	چمن
چەمەنی	چمنی
چەند	چند
چەندان	چندان
چەندانی	چندانی
چەندی	چندی
چەندین	چندین
چەندێ	چند
چەندە	چند
چەندەمین	چندمین
چەنگ	چنگ
چەنگیز	چنگیز
چەو	چو
چەپ	چپ
چەپی	چپی
چەک	چک
چەکانەی	چکانی
چەکی	چکی
چەکێ	چک
چەکێن	چکن
چەکە	چک
چەینی	چینی
ڕا	را
ڕائب	راب
ڕائد	راد
ڕائید	راید
ڕاب	راب
ڕابین	رابین
ڕاد	راد
ڕادار	رادار
ڕادان	رادان
ڕادی	رادی
ڕادیو	رادیو
ڕادیک	رادیک
ڕادیکاڵ	رادیکال
ڕادیۆ	رادیو
ڕادیۆیی	رادیویی
ڕادیەک	رادیک
ڕادەی	رادی
ڕادەیە	رادی
ڕادەیەک	رادیک
ڕاز	راز
ڕازی	رازی
ڕاس	راس
ڕاست	راست
ڕاستگۆ	راستگو
ڕاستی	راستی
ڕاستین	راستین
ڕاستیە	راستی
ڕاستە	راست
ڕاسل	راسل
ڕاسینگ	راسینگ
ڕاسێل	راسل
ڕاش	راش
ڕاشد	راشد
ڕاغب	راغب
ڕافایل	رافایل
ڕافایێل	رافایل
ڕافع	رافع
ڕام	رام
ڕامبرانت	رامبرانت
ڕامسفێڵد	رامسفلد
ڕامۆن	رامون
ڕامی	رامی
ڕامین	رامین
ڕان	ران
ڕانی	رانی
ڕانیێری	رانیری
ڕانیە	رانی
ڕاوی	راوی
ڕاویان	راویان
ڕاپورت	راپورت
ڕاپۆرت	راپورت
ڕاپۆرتێ	راپورت
ڕاپۆرتە	راپورت
ڕاک	راک
ڕاڵف	رالف
ڕای	رای
ڕایت	رایت
ڕایتێر	رایتر
ڕایس	رایس
ڕاین	راین
ڕایی	رایی
ڕایەی	رایی
ڕحمان	رحمان
ڕحمن	رحمن
ڕحیم	رحیم
ڕزا	رزا
ڕستم	رستم
ڕستن	رستن
ڕستەی	رستی
ڕسول	رسول
ڕشتن	رشتن
ڕشید	رشید
ڕفعت	رفعت
ڕفو	رفو
ڕفیق	رفیق
ڕقیب	رقیب
ڕمزی	رمزی
ڕهبر	رهبر
ڕوئیا	رویا
ڕواندا	روآندا
ڕوبن	روبن
ڕوبین	روبین
ڕوبەروی	روبروی
ڕوبەرێ	روبر
ڕوبەڕوی	روبروی
ڕوح	روح
ڕوحانی	روحانی
ڕوحی	روحی
ڕود	رود
ڕوز	روز
ڕوزگاری	روزگاری
ڕوزی	روزی
ڕوس	روس
ڕوسی	روسی
ڕومانی	رومانی
ڕوناڵدۆ	رونالدو
ڕونی	رونی
ڕوو	رو
ڕووبەرێ	روبر
ڕووحانی	روحانی
ڕووحی	روحی
ڕوودەکی	رودکی
ڕووس	روس
ڕووسی	روسی
ڕووم	روم
ڕوونی	رونی
ڕووی	روی
ڕوویان	رویان
ڕووە	رو
ڕوژان	روژان
ڕوی	روی
ڕویان	رویان
ڕویتەرز	رویترز
ڕویێ	روی
ڕوەو	رو
ڕوەوە	رو
ڕژیم	رژیم
ڕک	رک
ڕکابی	رکابی
ڕکن	رکن
ڕۆبرت	روبرت
ڕۆبن	روبن
ڕۆبۆت	روبوت
ڕۆبۆتە	روبوت
ڕۆبین	روبین
ڕۆبینیۆ	روبینیو
ڕۆبێرت	روبرت
ڕۆبێرتۆ	روبرتو
ڕۆبێن	روبن
ڕۆبەرت	روبرت
ڕۆتردام	روتردام
ڕۆتین	روتین
ڕۆتینی	روتینی
ڕۆتێردام	روتردام
ڕۆح	روح
ڕۆحانی	روحانی
ڕۆحی	روحی
ڕۆد	رود
ڕۆدریگز	رودریگز
ڕۆدریگۆ	رودریگو
ڕۆز	روز
ڕۆس	روس
ڕۆستایی	روستایی
ڕۆسی	روسی
ڕۆشن	روشن
ڕۆشنا	روشنا
ڕۆشنایی	روشنایی
ڕۆلاند	رولاند
ڕۆم	روم
ڕۆمانی	رومانی
ڕۆمانەی	رومانی
ڕۆمی	رومی
ڕۆمیۆ	رومیو
ڕۆمێرۆ	رومرو
ڕۆمەن	رومن
ڕۆنالدۆ	رونالدو
ڕۆناڵد	رونالد
ڕۆناڵدۆ	رونالدو
ڕۆنی	رونی
ڕۆژان	روژان
ڕۆژانە	روژان
ڕۆی	روی
ڕۆیال	رویال
ڕۆیاڵ	رویال
ڕۆیترز	رویترز
ڕۆیتەر	رویتر
ڕۆیتەرز	رویترز
ڕی	ری
ڕیا	ریا
ڕیاحی	ریاحی
ڕیاز	ریاض
ڕیازی	ریاضی
ڕیال	ریال
ڕیاڵ	ریال
ڕیتم	ریتم
ڕید	رید
ڕیدلی	ریدلی
ڕیدی	ریدی
ڕیدینگ	ریدینگ
ڕیز	ریز
ڕیزی	ریزی
ڕیش	ریش
ڕیشە	ریش
ڕیمۆند	ریموند
ڕینۆ	رینو
ڕیچارد	ریچارد
ڕیچاردز	ریچاردز
ڕیکاردۆ	ریکاردو
ڕیۆ	ریو
ڕیۆس	ریوس
ڕێز	رز
ڕێزا	رزا
ڕێزم	رزم
ڕێزن	رزن
ڕێزی	رضی
ڕێزێ	رز
ڕێزێن	رزن
ڕێسا	رثا
ڕێمان	رمان
ڕێو	رو
ڕێژی	رژی
ڕێژەی	رژی
ڕێژەیە	رژی
ڕێڤەبەر	روبر
ڕێڤەبەڕێ	روبر
ڕێک	رک
ڕێکی	رکی
ڕێکێ	رک
ڕێکێن	رکن
ڕێگە	رگ
ڕێی	ری
ڕێیا	ریا
ڕەئس	رس
ڕەئی	ری
ڕەبانی	ربانی
ڕەبیعە	ربیع
ڕەبیعەی	ربیعی
ڕەجایی	رجایی
ڕەجەب	رجب
ڕەجەبی	رجبی
ڕەجەوی	رجوی
ڕەحمان	رحمان
ڕەحمانی	رحمانی
ڕەحمەت	رحمت
ڕەحمەتی	رحمتی
ڕەحیم	رحیم
ڕەحیمی	رحیمی
ڕەحیمە	رحیم
ڕەخ	رخ
ڕەخشان	رخشان
ڕەد	رد
ڕەدیف	ردیف
ڕەز	رز
ڕەزا	رزا
ڕەزاعی	رضاعی
ڕەزاق	رزاق
ڕەزایی	رضایی
ڕەزم	رزم
ڕەزوان	رضوان
ڕەزەوی	رضوی
ڕەسام	رسام
ڕەستەن	رستن
ڕەسول	رسول
ڕەسوول	رسول
ڕەسووڵ	رسول
ڕەسووڵی	رسولی
ڕەسوڵ	رسول
ڕەسوڵی	رسولی
ڕەسەن	رسن
ڕەسەنێ	رسن
ڕەش	رش
ڕەشت	رشت
ڕەشید	رشید
ڕەشیدی	رشیدی
ڕەشە	رش
ڕەعد	رعد
ڕەفتار	رفتار
ڕەفعەت	رفعت
ڕەفیق	رفیق
ڕەفەح	رفح
ڕەقیب	رقیب
ڕەمزی	رمزی
ڕەمەزان	رمضان
ڕەمەزانێ	رمضان
ڕەمەزانە	رمضان
ڕەنج	رنج
ڕەنجی	رنجی
ڕەنگ	رنگ
ڕەنگین	رنگین
ڕەنگینی	رنگینی
ڕەنگێ	رنگ
ڕەنگە	رنگ
ڕەها	رها
ڕەهبەر	رهبر
ڕەهبەری	رهبری
ڕەهەند	رهند
ڕەوا	روا
ڕەوان	روان
ڕەوانی	روانی
ڕەوانە	روان
ڕەوانەی	روانی
ڕەوایی	روایی
ڕەوایەتی	روایتی
ڕەوش	روش
ڕەوشە	روش
ڕەوشەن	روشن
ڕەوی	روی
ڕەوەز	روز
ڕەوەند	روند
ڕەگ	رگ
ڕەی	ری
ژان	ژان
ژانگ	ژانگ
ژاک	ژاک
ژن	ژن
ژنێڤ	ژنو
ژنە	ژن
ژوراسیک	ژوراسیک
ژولیا	ژولیا
ژیان	ژیان
ژیانێ	ژیان
ژیانە	ژیان
ژیل	ژیل
ژەن	ژن
ژەنراڵ	ژنرال
ژەنڕاڵ	ژنرال
ژەنەرال	ژنرال
ژەنەراڵ	ژنرال
ژەنەراڵی	ژنرالی
ژەنەڕال	ژنرال
ژەنەڕاڵ	ژنرال
ڤاتیکان	واتیکان
ڤارۆ	وارو
ڤالا	والا
ڤالنسیا	والنسیا
ڤالێری	والری
ڤان	وان
ڤاڵتەر	والتر
ڤاڵنسیا	والنسیا
ڤلادمیر	ولادمیر
ڤودی	وودی
ڤی	وی
ڤیاریال	ویاریال
ڤیتامین	ویتامین
ڤیتامینە	ویتامین
ڤیتنام	ویتنام
ڤیتۆریا	ویتوریا
ڤیدا	ویدا
ڤیدیۆ	ویدیو
ڤیدیۆیی	ویدیویی
ڤیزا	ویزا
ڤیلا	ویلا
ڤیلیام	ویلیام
ڤین	وین
ڤیکتۆر	ویکتور
ڤیەتنام	ویتنام
ڤێ	و
ڤێرۆنا	ورونا
ڤێلا	ولا
ڤێنیز	ونیز
ڤێنیزیا	ونیزیا
ڤێگاس	وگاس
ڤە	و
ڤەب	وب
ڤەل	ول
ڤەلەد	ولد
ڤەنکۆڤێر	ونکوور
کابینە	کابین
کات	کات
کاتا	کاتا
کاترین	کاترین
کاترینا	کاترینا
کاتێ	کات
کاتە	کات
کاخ	کاخ
کادر	کادر
کادرێ	کادر
کار	کار
کار کردن	کار کردن
کارا	کارا
کارایی	کارایی
کارت	کارت
کارتۆن	کارتون
کارتە	کارت
کارتەر	کارتر
کارخانە	کارخانە
کارد	کارد
کاردینال	کاردینال
کارساز	کارساز
کارل	کارل
کارلوس	کارلوس
کارلۆ	کارلو
کارلۆس	کارلوس
کارم	کارم
کارمەند	کارمند
کارمەندە	کارمند
کارن	کارن
کارنامە	کارنامە
کارنینا	کارنینا
کاروان	کاروان
کاروانسەرا	کاروانسرا
کاروانی	کاروانی
کاروانەی	کاروانی
کاروبار	کاروبار
کارون	کارون
کارگوزار	کارگزار
کارگیری	کارگیری
کارگێر	کارگر
کارگێری	کارگری
کارگێڕی	کارگری
کارگەر	کارگر
کارڵ	کارل
کارۆل	کارول
کارۆلین	کارولین
کارۆلینا	کارولینا
کارۆڵ	کارول
کاری	کاری
کارێ	کار
کارێن	کارن
کارێک	کارک
کارە	کار
کارە	کارە
کارەم	کارم
کارەکێ	کارک
کارەکە	کارک
کارەی	کاری
کازم	کاظم
کازمی	کاظمی
کازمە	کاظم
کازمەی	کاظمی
کازینۆ	کازینو
کاس	کاس
کاسانۆ	کاسانو
کاسب	کاسب
کاسبی	کاسبی
کاستا	کاستا
کاسترۆ	کاسترو
کاستنەر	کاستنر
کاسنی	کاسنی
کاسێت	کاست
کاسێتی	کاستی
کاسە	کاس
کاسە	کاسە
کاشان	کاشان
کاشانی	کاشانی
کاشکی	کاشکی
کاشی	کاشی
کاغەز	کاغذ
کافر	کافر
کافکا	کافکا
کافی	کافی
کال	کال
کالین	کالین
کام	کام
کامبیز	کامبیز
کامران	کامران
کامل	کامل
کامکار	کامکار
کامکاری	کامکاری
کامڵ	کامل
کامڵی	کاملی
کامۆ	کامو
کامیل	کامیل
کامیۆن	کامیون
کامێران	کامران
کامێرۆن	کامرون
کامەران	کامران
کان	کان
کانادا	کانادا
کاناڤارۆ	کاناوارو
کاندید	کاندید
کاندیدا	کاندیدا
کاندیدە	کاندید
کانون	کانون
کانی	کانی
کانێ	کان
کانە	کان
کاهو	کاهو
کاهێل	کاهل
کاوەی	کاوی
کاپولا	کاپولا
کاپوولا	کاپولا
کاپێریۆ	کاپریو
کاپێلۆ	کاپلو
کاک	کاک
کاکا	کاکا
کاکایی	کاکایی
کاکل	کاکل
کاکول	کاکل
کاکی	کاکی
کاکەی	کاکی
کاڵ	کال
کاڵا	کالا
کاڵی	کالی
کاڵێ	کال
کای	کای
کایرا	کایرا
کایە	کای
کبریت	کبریت
کتاب	کتاب
کتری	کتری
کتی	کتی
کتێب	کتب
کتێبی	کتبی
کتێبە	کتب
کتێبەی	کتبی
کدو	کدو
کر	کر
کرامێر	کرامر
کران	کران
کرانی	کرانی
کرد	کرد
کردار	کردار
کردارە	کردار
کردستان	کردستان
کردم	کردم
کردن	کردن
کردنە	کردن
کردی	کردی
کردە	کرد
کردەوانە	کردوان
کردەی	کردی
کرس	کرس
کرم	کرم
کرمان	کرمان
کرمانج	کرمانج
کرمانجی	کرمانجی
کرمانی	کرمانی
کرملین	کرملین
کرمی	کرمی
کرنا	کرنا
کروز	کروز
کرکوک	کرکوک
کرۆز	کروز
کرۆم	کروم
کرۆکی	کروکی
کری	کری
کریس	کریس
کریستال	کریستال
کریستاڵ	کریستال
کریستۆف	کریستوف
کریستی	کریستی
کریستین	کریستین
کریستیەن	کریستین
کریسمس	کریسمس
کریم	کریم
کریە	کری
کرێ	کر
کرێدان	کردان
کرێم	کرم
کرێک	کرک
کرێی	کری
کش	کش
کشت	کشت
کشمیر	کشمیر
کشمیری	کشمیری
کفر	کفر
کفن	کفن
کفک	کفک
کلارا	کلارا
کلارک	کلارک
کلاس	کلاس
کلاسیک	کلاسیک
کلاوس	کلاوس
کلدانی	کلدانی
کلم	کلم
کلوب	کلوب
کلود	کلود
کلک	کلک
کلۆب	کلوب
کلۆد	کلود
کلۆدیا	کلودیا
کلۆر	کلور
کلۆفت	کلفت
کلی	کلی
کلید	کلید
کلیسا	کلیسا
کلینتۆن	کلینتون
کلیپ	کلیپ
کلیک	کلیک
کلێر	کلر
کم	کم
کمال	کمال
کمر	کمر
کنشت	کنشت
کنگر	کنگر
کنێدی	کندی
کو	کو
کوبا	کوبا
کوبایی	کوبایی
کوبریک	کوبریک
کوبی	کوبی
کوت	کوت
کوخ	کوخ
کودەتا	کودتا
کور	کور
کوران	کوران
کورانی	کورانی
کوردستان	کردستان
کوردستانی	کردستانی
کورسی	کرسی
کورم	کرم
کوروش	کوروش
کورووش	کوروش
کورک	کرک
کوری	کوری
کورێ	کور
کورە	کور
کورەی	کوری
کوزە	کوز
کوشتار	کشتار
کوشتن	کشتن
کوشندە	کشندە
کوشندە	کوشند
کوفار	کفار
کوفتە	کوفت
کوفر	کفر
کوفک	کفک
کوفی	کوفی
کول	کل
کول	کول
کولی	کولی
کومارێ	کومار
کون	کون
کونج	کنج
کوه	کوه
کوو	کو
کوپێر	کوپر
کوپەر	کوپر
کوچ	کوچ
کوچک	کوچک
کوچک	کچک
کوچی	کوچی
کوڕ	کور
کوڕان	کوران
کوڕانی	کورانی
کوڕی	کوری
کوڕە	کور
کوڕەی	کوری
کوژ	کوژ
کویت	کویت
کوین	کوین
کوێ	کو
کوێت	کوت
کوێر	کور
کوێرانە	کورانە
کوێرکوێرانە	کورکورانە
کوێری	کوری
کوێی	کوی
کوەیت	کویت
کوەیتی	کویتی
کوەێت	کوت
کڕی	کری
کۆ	کو
کۆئێن	کون
کۆبانی	کوبانی
کۆبی	کوبی
کۆت	کت
کۆت	کوت
کۆد	کود
کۆر	کور
کۆرس	کورس
کۆرۆساوا	کوروساوا
کۆرۆساڤا	کوروساوا
کۆری	کوری
کۆز	کۆز
کۆشش	کوشش
کۆشک	کوشک
کۆشکی	کوشکی
کۆفی	کوفی
کۆل	کول
کۆلین	کولین
کۆمار	کومار
کۆمارێ	کومار
کۆمارە	کومار
کۆن	کون
کۆندرا	کوندرا
کۆنگرە	کنگرە
کۆنە	کون
کۆهن	کوهن
کۆهێن	کوهن
کۆهەن	کوهن
کۆپەر	کوپر
کۆچ	کوچ
کۆچی	کوچی
کۆڕ	کور
کۆڕی	کوری
کۆڕێ	کور
کۆک	کوک
کۆڵ	کول
کۆڵین	کولین
کۆی	کوی
کۆیە	کوی
کی	کی
کیا	کیا
کیان	کیان
کیانووش	کیانوش
کیانی	کیانی
کیانیان	کیانیان
کیبۆرد	کیبورد
کیت	کیت
کیدمەن	کیدمن
کیر	کیر
کیس	کیس
کیسە	کیسە
کیش	کیش
کیف	کیف
کیفێر	کیفر
کیلو	کیلو
کیلومەتر	کیلومتر
کیلۆ	کیلو
کیم	کیم
کیمیا	کیمیا
کیمیاوی	کیمیاوی
کیمیاگەر	کیمیاگر
کیمیایی	کیمیایی
کین	کین
کینگ	کینگ
کینگزلی	کینگزلی
کینە	کین
کینە	کینە
کیومەرس	کیومرث
کیوومەرس	کیومرث
کیپ	کیپ
کیک	کیک
کیێڤ	کیو
کیێڤی	کیوی
کێبەریێ	کبری
کێت	کت
کێر	کر
کێری	کری
کێس	کس
کێش	کش
کێشانی	کشانی
کێشانەی	کشانی
کێشدار	کشدار
کێشمەکێش	کشمکش
کێشی	کشی
کێشێ	کش
کێشە	کش
کێشەش	کشش
کێشەم	کشم
کێشەو	کشو
کێشەکە	کشک
کێشەکەی	کشکی
کێشەی	کشی
کێشەیە	کشی
کێشەیەش	کشیش
کێشەیەک	کشیک
کێف	کف
کێلکی کوڕ	کێلکی کوڕ
کێلی	کلی
کێلێ	کل
کێم	کم
کێمتر	کمتر
کێمی	کمی
کێن	کن
کێنێدی	کندی
کێوی	کوی
کێڤین	کوین
کێک	کک
کێڵی	کلی
کێی	کی
کێیت	کیت
کێیج	کیج
کێیە	کی
کێیەو	کیو
کەئاستی	کاستی
کەئاشتی	کاشتی
کەئاوی	کاوی
کەئێران	کران
کەئەم	کم
کەئەمرۆ	کمرو
کەئەمڕۆ	کمرو
کەئەمەی	کمی
کەئەو	کو
کەئەوەی	کوی
کەباب	کباب
کەبابچی	کبابچی
کەبری	کبری
کەبڕی	کبری
کەبیر	کبیر
کەبیری	کبیری
کەبەر	کبر
کەبەرەی	کبری
کەت	کت
کەتاب	کتاب
کەتایوون	کتایون
کەتری	کتری
کەتی	کتی
کەج	کج
کەجۆری	کجوری
کەجێی	کجی
کەد	کد
کەدوو	کدو
کەدکەنی	کدکنی
کەر	کر
کەرار	کرار
کەرامات	کرامات
کەرامەت	کرامت
کەراچی	کراچی
کەربلا	کربلا
کەربەلا	کربلا
کەرت	کرت
کەرتێ	کرت
کەرتە	کرت
کەرخ	کرخ
کەرخی	کرخی
کەرزای	کرزای
کەرستێن	کرستن
کەرم	کرم
کەروبی	کروبی
کەرکووک	کرکوک
کەرکووکە	کرکوک
کەرکوک	کرکوک
کەرکوکێ	کرکوک
کەرکوکە	کرکوک
کەرگەدەن	کرگدن
کەری	کری
کەریم	کریم
کەریمی	کریمی
کەریمیان	کریمیان
کەرەج	کرج
کەرەزای	کرزای
کەرەستێ	کرست
کەرەستە	کرست
کەرەم	کرم
کەرەمی	کرمی
کەرەوەی	کروی
کەزازی	کزازی
کەس	کس
کەسانی	کسانی
کەسانەی	کسانی
کەسانەیە	کسانی
کەسب	کسب
کەسبەی	کسبی
کەسی	کسی
کەسێ	کس
کەسە	کس
کەسەر	کسر
کەسەی	کسی
کەش	کش
کەش و فش	کش و فش
کەشان کەشان	کشان کشان
کەشاندی	کشاندی
کەشاوەرز	کشاورز
کەشاکەش	کشاکش
کەشتی	کشتی
کەشمیر	کشمیر
کەشمیری	کشمیری
کەشمەکەش	کشمکش
کەشو	کشو
کەشک	کشک
کەشی	کشی
کەشیش	کشیش
کەشێک	کشک
کەشێکی	کشکی
کەشە	کش
کەشەش	کشش
کەف	کف
کەفالەت	کفالت
کەفتار	کفتار
کەفش	کفش
کەفگیر	کفگیر
کەفەن	کفن
کەل	کل
کەلا	کلا
کەلات	کلات
کەلو	کلو
کەلێن	کلن
کەلێی	کلی
کەلە	کل
کەلەف	کلف
کەلەم	کلم
کەلەهەر	کلهر
کەلەو	کلو
کەلەوێ	کلو
کەلەک	کلک
کەلەیەک	کلیک
کەم	کم
کەما	کما
کەمال	کمال
کەمالی	کمالی
کەمان	کمان
کەمانگەر	کمانگر
کەماڵ	کمال
کەماڵی	کمالی
کەمبریج	کمبریج
کەمتر	کمتر
کەمترین	کمترین
کەمترە	کمتر
کەمپ	کمپ
کەمپین	کمپین
کەمپە	کمپ
کەمی	کمی
کەمیسر	کمیسر
کەمین	کمین
کەمینە	کمین
کەمێک	کمک
کەمە	کم
کەمەر	کمر
کەمەربەند	کمربند
کەمەرکەش	کمرکش
کەمەند	کمند
کەمەندی	کمندی
کەن	کن
کەنار	کنار
کەنان	کنان
کەند	کند
کەنداڵ	کەنداڵ
کەندن	کندن
کەندی	کندی
کەنشتە	کنشت
کەنعان	کنعان
کەنعانی	کنعانی
کەنگر	کنگر
کەنەدی	کندی
کەهر	کهر
کەهریز	کهریز
کەهرەبا	کهربا
کەهەر	کهر
کەهەن	کهن
کەو	کو
کەوت	کوت
کەوتە	کوت
کەودەن	کودن
کەوسەر	کوثر
کەوسەری	کوثری
کەولی	کولی
کەوچک	کوچک
کەوی	کوی
کەوێت	کوت
کەوەک	کوک
کەپر	کپر
کەپێک	کپک
کەپێی	کپی
کەپەر	کپر
کەچی	کەچی
کەچەلەی	کچلی
کەچەڵ	کچل
کەڕ	کر
کەڕوبی	کروبی
کەڕووبی	کروبی
کەڕوون	کرون
کەڕووی	کروی
کەڕکوک	کرکوک
کەڕێ	کر
کەڤالا	کوالا
کەڤن	کون
کەک	کک
کەکێ	کک
کەڵک	کلک
کەڵکی	کلکی
کەی	کی
کەیان	کیان
کەیانەی	کیانی
کەیت	کیت
کەیج	کیج
کەیس	کیس
کەیسە	کیس
کەیف	کیف
کەیفی	کیفی
کەین	کین
کەیهان	کیهان
کەیوان	کیوان
کەیوانی	کیوانی
کەیڤی	کیوی
کەیک	کیک
کەیەک	کیک
کەیەکێ	کیک
گابریل	گابریل
گابریێل	گابریل
گابریەل	گابریل
گابۆن	گابون
گارت	گارت
گاردیەن	گاردین
گارسیا	گارسیا
گارنەر	گارنر
گاری	گاری
گاریە	گاری
گاز	گاز
گازر	گازر
گازی	گازی
گازێ	گاز
گازە	گاز
گازەی	گازی
گاس	گاس
گالاکسی	گالاکسی
گالێری	گالری
گالەری	گالری
گام	گام
گامە	گام
گاندی	گاندی
گاو	گاو
گاودانە	گادانە
گاودانە	گاودانە
گاورس	گارس
گای	گای
گراس	گراس
گرافیست	گرافیست
گرافیک	گرافیک
گرام	گرام
گرامی	گرامی
گرامە	گرام
گران	گران
گرانبەها	گرانبها
گرانت	گرانت
گرانجان	گرانجان
گراند	گراند
گرانی	گرانی
گرانە	گران
گراهام	گراهام
گرد	گرد
گردی	گردی
گرفت	گرفت
گرفتار	گرفتار
گرفتاری	گرفتاری
گرفتی	گرفتی
گرفتە	گرفت
گرفتەی	گرفتی
گرووپ	گروپ
گرووپێ	گروپ
گرووپە	گروپ
گروپ	گروپ
گروپێ	گروپ
گروپە	گروپ
گرۆپ	گروپ
گرۆپێ	گروپ
گری	گری
گریان	گریان
گریاندن	گریاندن
گریانی	گریانی
گریس	گریس
گریم	گریم
گریوە	گریە
گریگۆری	گریگوری
گریە	گریە
گرێ	گر
گرێدان	گردان
گرێدانی	گردانی
گرێگ	گرگ
گرێی	گری
گرەو	گرو
گشت	گشت
گشتی	گشتی
گشتیێ	گشتی
گشتیە	گشتی
گفت	گفت
گفتار	گفتار
گفتگۆ	گفتگو
گل	گل
گلادباخ	گلادباخ
گلاسکۆ	گلاسکو
گلۆریا	گلوریا
گلی	گلی
گلیم	گلیم
گلین	گلین
گلێن	گلن
گلە	گلە
گلەو	گلو
گم	گم
گم کردن	گم کردن
گمی	گمی
گوارا	گوارا
گوتی	گوتی
گوتیە	گوتی
گوتەی	گوتی
گور	گور
گورز	گرز
گورگ	گرگ
گوری	گوری
گوستاخ	گستاخ
گوشاد	گشاد
گوشەی	گوشی
گول	گول
گولزار	گلزار
گولی	گولی
گولە	گول
گولەی	گولی
گوم	گم
گومان	گمان
گومی	گمی
گوناه	گناه
گوناهکار	گناهکار
گونیا	گونیا
گونەی	گونی
گووتی	گوتی
گووتەی	گوتی
گوودەرزی	گودرزی
گووری	گوری
گوول	گول
گوولەی	گولی
گووگڵ	گوگل
گوڕ	گور
گوڕی	گوری
گوگل	گوگل
گوگڵ	گوگل
گوڵ	گول
گوڵی	گولی
گوڵە	گول
گوی	گوی
گوێر	گور
گوێرەی	گوری
گوێز	گوز
گوێزی	گوزی
گوێنی	گونی
گوێڕ	گور
گوێی	گوی
گوێیان	گویان
گوەش	گوش
گڕکان	گرکان
گڕکانی	گرکانی
گڕی	گری
گڕیان	گریان
گۆتی	گوتی
گۆتیە	گوتی
گۆتەی	گوتی
گۆر	گور
گۆردۆن	گوردون
گۆری	گوری
گۆرێکی	گورکی
گۆرە	گور
گۆزۆ	گوزو
گۆزە	گوز
گۆستاڤ	گوستاو
گۆشت	گوشت
گۆشەی	گوشی
گۆل	گول
گۆلی	گولی
گۆمان	گمان
گۆمێز	گومز
گۆنگ	گنگ
گۆنەی	گونی
گۆڕ	گور
گۆڕی	گوری
گۆڕێکی	گورکی
گۆڕە	گور
گۆڕەکان	گورکان
گۆڕەکەی	گورکی
گۆکان	گوکان
گۆکانی	گوکانی
گۆگڵ	گوگل
گۆڵ	گول
گۆڵی	گولی
گۆڵە	گول
گۆی	گوی
گۆیان	گویان
گۆیەی	گویی
گیبسۆن	گیبسون
گیتار	گیتار
گیتس	گیتس
گیج	گیج
گیر	گیر
گیرا	گیرا
گیرانی	گیرانی
گیرو	گیرو
گیرودار	گیرودار
گیروگرفت	گیروگرفت
گیری	گیری
گیرەم	گیرم
گیسو	گیس
گیل	گیل
گیلان	گیلان
گیلانی	گیلانی
گینس	گینس
گیوە	گیوە
گیگز	گیگز
گێر	گر
گێرا	گرا
گێران	گران
گێرما	گرما
گێری	گری
گێزەر	گذر
گێل	گل
گێم	گم
گێچ	گچ
گێچکار	گچکار
گێچکاری	گچکاری
گێڕا	گرا
گێڕان	گران
گێڕانی	گرانی
گەبر	گبر
گەدا	گدا
گەدایی	گدایی
گەر	گر
گەرا	گرا
گەران	گران
گەرد	گرد
گەردش	گردش
گەردن	گردن
گەردنبەند	گردنبند
گەردوون	گردون
گەردی	گردی
گەردەن	گردن
گەرم	گرم
گەرم کردن	گرم کردن
گەرما	گرما
گەرمک	گرمک
گەرمی	گرمی
گەرمە	گرم
گەرووی	گروی
گەروی	گروی
گەرگەری	گرگری
گەری	گری
گەشت	گشت
گەشتی	گشتی
گەشتە	گشت
گەشتەی	گشتی
گەل	گل
گەلی	گلی
گەلیێ	گلی
گەلێ	گل
گەلێن	گلن
گەلێک	گلک
گەلێکی	گلکی
گەلە	گل
گەلەو	گلو
گەلەک	گلک
گەلەکی	گلکی
گەلەکەی	گلکی
گەلەی	گلی
گەنج	گنج
گەنجانی	گنجانی
گەنجی	گنجی
گەنجێ	گنج
گەنجە	گنج
گەنجەی	گنجی
گەندم	گندم
گەندمی	گندمی
گەواه	گواه
گەواهی	گواهی
گەورە	گور
گەورەکەی	گورکی
گەورەی	گوری
گەورەیە	گوری
گەون	گون
گەوهەر	گوهر
گەوهەری	گوهری
گەوێڵی	گولی
گەوەری	گوری
گەوەرەی	گوری
گەوەزن	گوزن
گەوەن	گون
گەچ	گچ
گەچکاری	گچکاری
گەڕ	گر
گەڕا	گرا
گەڕان	گران
گەڕانی	گرانی
گەڕی	گری
گەڕەکانە	گرکان
گەڕەی	گری
گەڵ	گل
گەڵی	گلی
گەیتس	گیتس
گەیلان	گیلان
گەیلانی	گیلانی
یا	یا
یاجوج	یاجوج
یاد	یاد
یادگار	یادگار
یادگاری	یادگاری
یادە	یاد
یار	یار
یارا	یارا
یاران	یاران
یارد	یارد
یاردە	یارد
یاری	یاری
یاریێ	یاری
یازدە	یازد
یازدە	یازدە
یازدەهەم	یازدهم
یازدەهەمین	یازدهمین
یاس	یاس
یاسا	یاسا
یاسر	یاسر
یاسری	یاسری
یاسین	یاسین
یاسینی	یاسینی
یاسەمین	یاسمین
یاغی	یاغی
یاقووتی	یاقوتی
یال	یال
یالدار	یالدار
یانگ	یانگ
یانەکەی	یانکی
یاهو	یاهو
یاهوو	یاهو
یاور	یار
یاور	یاور
یاوەر	یاور
یاوەری	یاوری
یحیی	یحیی
یعقوب	یعقوب
یوئێن	یون
یوان	یوان
یوتا	یوتا
یورۆ	یورو
یورۆنیوز	یورونیوز
یوری	یوری
یوسر	یسر
یوسف	یوسف
یوسفی	یوسفی
یون	یون
یونان	یونان
یونانی	یونانی
یونایتد	یونایتد
یونس	یونس
یونسکۆ	یونسکو
یونسی	یونسی
یونگ	یونگ
یونیسێف	یونیسف
یووسف	یوسف
یووشیج	یوشیج
یوونس	یونس
یک	یک
یۆتا	یوتا
یۆرو	یورو
یۆرک	یورک
یۆرگن	یورگن
یۆرۆ	یورو
یۆرۆنیوز	یورونیوز
یۆرۆیی	یورویی
یۆزێف	یوزف
یۆسف	یوسف
یۆسفی	یوسفی
یۆن	یون
یۆنان	یونان
یۆنانی	یونانی
یۆنایتد	یونایتد
یۆنس	یونس
یۆنسکۆ	یونسکو
یۆنسی	یونسی
یۆنگ	یونگ
یۆنیسێف	یونیسف
یۆنیۆن	یونیون
یۆنێسکۆ	یونسکو
یۆهان	یوهان
یۆگا	یوگا
یەتیم	یتیم
یەخ کردن	یخ کردن
یەخبەندان	یخبندان
یەخنی	یخنی
یەد	ید
یەدەک	یدک
یەرموک	یرموک
یەرەقان	یرقان
یەزد	یزد
یەزدان	یزدان
یەزدانی	یزدانی
یەزدی	یزدی
یەشم	یشم
یەعقوب	یعقوب
یەعقوبی	یعقوبی
یەعقووب	یعقوب
یەعقووبی	یعقوبی
یەعنی	یعنی
یەل	یل
یەلدا	یلدا
یەلەک	یلک
یەمین	یمین
یەمینی	یمینی
یەمەن	یمن
یەمەنی	یمنی
یەهودی	یهودی
یەواش	یواش
یەواشکی	یواشکی
یەک	یک
یەکان	یکان
یەکانە	یکان
یەکتاپەرست	یکتاپرست
یەکتاپەرستی	یکتاپرستی
یەکسان	یکسان
یەکسانی	یکسانی
یەکساڵ	یکسال
یەکسەر	یکسر
یەکم	یکم
یەکپا	یکپائاب	آب
یەکی	یکی
یەکێ	یک
یەکە	یک
یەکەم	یکم
یەکەمین	یکمین
یەکەمە	یکم
یەکەی	یکی
یەڵدا	یلدا
ەمین	مین
ەو	و
ەوە	و