ئاب	آب
ئاباد	آباد
ئابدا	ابدآ
ئابی	آبي
ئاتێن	آتن
ئاخ	آخ
ئاخر	آخر
ئاخفت	اخفت
ئاخۆ	اخو
ئاداب	آداب
ئادابێ	آداب
ئادارا	ادارآ
ئادام	آدام
ئادریان	ادريان
ئادێل	ادل
ئادەم	آدم
ئادەمی	آدمي
ئار	آر
ئارام	آرام
ئارامی	آرامي
ئارامە	آرام
ئارت	ارت
ئارد	ارد
ئاردی	اردي
ئارسن	ارسن
ئارش	ارش
ئارمی	آرمي
ئارون	ارون
ئارۆ	ارو
ئارۆن	ارون
ئاری	آري
ئارین	آرين
ئاریێن	آرين
ئارێز	ارض
ئارەش	ارش
ئازا	آضا
ئازار	آذار
ئازارە	آذار
ئازەر	آزر
ئازەری	آذري
ئاس	آس
ئاست	اسط
ئاستی	اسطي
ئاستێ	اسط
ئاستێک	اصطك
ئاستێکی	اصطكي
ئاستە	اسط
ئاستەی	اسطي
ئاسف	آسف
ئاسمان	آثمان
ئاسن	آسن
ئاسنی	اثني
ئاسنین	اثنين
ئاسودە	اسود
ئاسوودە	اسود
ئاسۆ	اثو
ئاسۆس	اسوس
ئاسۆی	اثوي
ئاسۆیێن	اثوين
ئاسی	آسي
ئاسیا	آسيا
ئاسەف	آسف
ئاشت	اشت
ئاشتون	اشتون
ئاشتۆن	اشتون
ئاشتی	اشتي
ئاشتیێ	اشتي
ئاشنا	اشنآ
ئاشوری	آشوري
ئاشووری	آشوري
ئاشکر	اشكر
ئاشکرا	اشكرا
ئاشکران	اشكران
ئاشکەرا	اشكرا
ئاشۆری	آشوري
ئاف	آف
ئافرتان	افرطان
ئافرەت	افرط
ئافرەتا	افرطا
ئافرەتن	افرطن
ئافرەتی	افرطي
ئافرەتێ	افرط
ئافرەتە	افرط
ئافەند	افند
ئال	آل
ئالان	الآن
ئالتمەن	الطمن
ئالتۆن	التون
ئالن	آلن
ئالوسی	الوثي
ئالی	آلي
ئالیا	آليا
ئالیان	آليان
ئالیێ	آلي
ئالیێن	آلين
ئالێ	آل
ئالێن	آلن
ئاماد	آماد
ئامادە	آماد
ئامر	آمر
ئامون	آمون
ئامێدی	آمدي
ئامێدیێ	آمدي
ئامێر	آمر
ئامێرانە	امرآن
ئامێری	آمري
ئامێرێ	آمر
ئامێرێن	امرن
ئامێرە	آمر
ئامێرەی	آمري
ئامێز	امض
ئامێزی	امضي
ئامەد	آمد
ئامەدی	آمدي
ئامەدێ	آمد
ئان	آن
ئانت	انت
ئانتوان	انتوان
ئانتی	انتي
ئانجی	انجي
ئاند	اند
ئاندری	اندري
ئاندرێ	اندر
ئاندرێس	اندرس
ئاندی	اندي
ئاندیان	انديان
ئانی	آني
ئانین	آنين
ئاهوو	اهو
ئاو	آو
ئاون	آون
ئاوو	آو
ئاوی	آوي
ئاویان	آويان
ئاوێنە	آون
ئاوە	آو
ئاوەوە	آو
ئاوەی	آوي
ئاڕ	آر
ئاڤ	آو
ئاڤی	آوي
ئاڤێ	آو
ئاکام	آكام
ئاکری	اكري
ئاکرێ	آكر
ئاکرێی	اكري
ئاکۆ	اكو
ئاکۆیان	اكويان
ئاڵ	آل
ئاڵتون	التون
ئاڵتوون	التون
ئاڵتۆ	التو
ئاڵتی	التي
ئاڵقەی	القي
ئاڵن	آلن
ئاڵو	الو
ئای	آي
ئاید	ايد
ئایدا	ايدآ
ئایدن	ايدن
ئایدین	ايدين
ئایر	اير
ئایرس	آيرس
ئایرین	ايرين
ئایرێس	آيرس
ئایس	آيس
ئایە	آي
ئدین	دين
ئنجا	نجا
ئو	و
ئور	ور
ئوردن	وردن
ئوردنێ	وردن
ئوردەن	وردن
ئوسامە	وسام
ئول	ول
ئولی	ولي
ئومێد	ومد
ئون	ون
ئوو	و
ئۆ	و
ئۆج	وج
ئۆدین	ودين
ئۆردن	وردن
ئۆز	وز
ئۆزێل	وظل
ئۆستن	وسطن
ئۆسمان	وصمان
ئۆف	وف
ئۆل	ول
ئۆلد	ولد
ئۆلی	ولي
ئۆمێد	ومد
ئۆن	ون
ئۆهان	وهان
ئۆی	وي
ئۆیل	ويل
ئۆین	وين
ئی	ي
ئیئتلاف	يتلاف
ئیبن	يبن
ئیبنی	يبني
ئیتا	يطآ
ئیتان	يطان
ئیتر	يطر
ئیتلاف	يتلاف
ئیتۆ	يطو
ئیحسان	يحصان
ئید	يد
ئیداری	يداري
ئیدارە	يدار
ئیدارەکە	يدارك
ئیدارەی	يداري
ئیدانە	يدان
ئیدانەی	يداني
ئیدی	يدي
ئیدین	يدين
ئیراسان	يراسان
ئیراسۆن	يراسون
ئیراق	يراق
ئیراقێ	يراق
ئیران	يران
ئیرانێ	يران
ئیرجی	يرجي
ئیرنا	يرنا
ئیرو	يرو
ئیرک	يرك
ئیرۆ	يرو
ئیرینا	يرينا
ئیرەج	يرج
ئیزن	يزن
ئیزنی	يزني
ئیزیدی	يزيدي
ئیس	يس
ئیسال	يصال
ئیست	يسط
ئیستا	يسطا
ئیسرا	يسرا
ئیسنا	يصنا
ئیسک	يسك
ئیسکان	يسكان
ئیسیان	يسيان
ئیسێوە	يصو
ئیش	يش
ئیشق	يشق
ئیشقی	يشقي
ئیشو	يشو
ئیشکەر	يشكر
ئیشی	يشي
ئیف	يف
ئیفادێ	يفاد
ئیفادێن	يفادن
ئیفادەی	يفادي
ئیل	يل
ئیلاف	يلاف
ئیلام	يلام
ئیلنا	يلنا
ئیلی	يلي
ئیلیا	يليا
ئیلین	يلين
ئیلینا	يلينا
ئیم	يم
ئیما	يمآ
ئیمام	يمام
ئیمان	يمان
ئیمانی	يماني
ئیمزا	يمضا
ئیمێل	يمل
ئیمێلی	يملي
ئیمە	يم
ئیمەش	يمش
ئیمەیل	يميل
ئیمەیڵ	يميل
ئین	ين
ئینتەر	ينطر
ئینجا	ينجآ
ئینجی	ينجي
ئیندیا	ينديا
ئینسان	ينصان
ئینی	يني
ئینێستا	ينصتا
ئیهاب	يهاب
ئیهود	يهود
ئیهۆد	يهود
ئیوارەی	يواري
ئیڤاری	يواري
ئیڤرا	يورآ
ئیکس	يكث
ئیکسۆن	يكثون
ئیکۆ	يكو
ئیکەر	يكر
ئیڵ	يل
ئێبی	بي
ئێحسان	حسان
ئێخست	خست
ئێخستن	خستن
ئێد	د
ئێدی	دي
ئێر	ر
ئێراق	راق
ئێراقا	راقا
ئێراقی	راقي
ئێراقێ	راق
ئێران	ران
ئێرانێ	ران
ئێرانە	ران
ئێرێک	رك
ئێرە	ر
ئێرەبکە	ربك
ئێرەو	رو
ئێزدی	ضدي
ئێزیدی	زيدي
ئێس	ث
ئێست	ست
ئێستا	سطا
ئێستە	ست
ئێسقان	سقان
ئێسک	سك
ئێسکی	سكي
ئێسی	سي
ئێش	ش
ئێشی	شي
ئێشە	ش
ئێف	ف
ئێل	ل
ئێلی	لي
ئێم	م
ئێما	ما
ئێمری	مري
ئێمناهیێ	مناهي
ئێمه	مه
ئێمی	مي
ئێمە	م
ئێمەئەم	مم
ئێمەتا	متا
ئێمەدا	مدا
ئێمەدان	مدان
ئێمەزۆر	مزور
ئێمەش	مش
ئێمەلەم	ملم
ئێمەن	من
ئێمەهەر	مهر
ئێمەهەیە	مهي
ئێمەڕێز	مرض
ئێمەکار	مكار
ئێمەکاری	مكاري
ئێمەی	مي
ئێمەیە	مي
ئێن	ن
ئێنی	ني
ئێنێستا	نصتا
ئێهود	هود
ئێوار	وار
ئێواری	واري
ئێوارێ	وار
ئێوارە	وار
ئێوارەدا	واردا
ئێوارەی	واري
ئێوارەیە	واري
ئێوە	و
ئێوەدا	ودا
ئێوەش	وش
ئێوەو	و
ئێوەی	وي
ئێوەیە	وي
ئێڕان	ران
ئێڤا	وا
ئێڤاری	واري
ئێڤاریا	واريا
ئێڤارێ	وار
ئێڤرا	ورآ
ئێک	ك
ئێکس	كث
ئێکسۆن	كسون
ئێکسەر	كسر
ئێکۆ	كو
ئێکی	كي
ئێکێ	ك
ئێکەتی	كتي
ئێکەتیێ	كتي
ئێکەم	كم
ئێکەمین	كمين
ئێڵ	ل
ئێی	ي
ئە	
ئەبی	بي
ئەبێ	ب
ئەبێت	بط
ئەبەدی	بدي
ئەتروشی	تروشي
ئەتلەسی	طلسي
ئەتهەر	طهر
ئەتوانن	توانن
ئەتوانێت	توانت
ئەتڵەسی	طلسي
ئەتۆم	توم
ئەحدەب	حدب
ئەحرار	حرار
ئەحراری	حراري
ئەحمد	حمد
ئەحمەد	حمد
ئەحمەدی	حمدي
ئەحمەدە	حمد
ئەحمەی	حمي
ئەخبار	خبار
ئەختەر	خطر
ئەخزەر	خضر
ئەخلاق	خلاق
ئەخەوان	خوان
ئەد	د
ئەدا	دآ
ئەدرێت	درت
ئەدلەب	دلب
ئەدهەم	دهم
ئەدی	دي
ئەدیب	ديب
ئەدیبان	ديبان
ئەدەب	دب
ئەدەبی	دبي
ئەدەبێ	دب
ئەدەن	دن
ئەدەین	دين
ئەربێلوا	ربلوا
ئەربێلۆا	ربلوا
ئەرد	رد
ئەردی	ردي
ئەردەن	ردن
ئەردەنێ	ردن
ئەرزی	رضي
ئەرشیف	رشيف
ئەرشەد	رشد
ئەرمن	رمن
ئەرمەن	رمن
ئەرک	رك
ئەرکان	ركان
ئەرکی	ركي
ئەرکێ	رك
ئەرکێن	ركن
ئەرکێک	ركك
ئەرکێکی	رككي
ئەرکە	رك
ئەرکەکێ	ركك
ئەرکەی	ركي
ئەرینا	رينا
ئەرێ	ر
ئەرێنی	رني
ئەرێنیان	رنيان
ئەرەبی	ربي
ئەز	ذ
ئەزمڕ	زمر
ئەزمەر	زمر
ئەزمەڕ	زمر
ئەزهار	ظهار
ئەزهەر	زهر
ئەس	ث
ئەسانج	صانج
ئەستون	ستون
ئەستوور	ستور
ئەستۆ	سطو
ئەستۆن	ستون
ئەستێرە	ستر
ئەسعەد	صعد
ئەسعەدی	صعدي
ئەسغەر	ثغر
ئەسغەری	صغري
ئەسفەهان	سفهان
ئەسلی	صلي
ئەسما	صما
ئەسوات	سواط
ئەسوەد	سود
ئەسڵان	صلان
ئەسڵی	صلي
ئەسید	صيد
ئەسیدی	صيدي
ئەسیر	سير
ئەسیل	ثيل
ئەسینا	صينا
ئەسەد	سد
ئەسەددا	سددا
ئەسەدی	ثدي
ئەسەدە	سد
ئەشتۆن	شتون
ئەشرەف	شرف
ئەشرەفی	شرفي
ئەشواق	شواق
ئەشڕەف	شرف
ئەشکان	شكان
ئەشکرا	شكرا
ئەعرەجی	عرجي
ئەعزەمی	عظمي
ئەف	ف
ئەفزەلی	فضلي
ئەفسانە	فصان
ئەفسوون	فسون
ئەفسەر	فسر
ئەفسەران	فسران
ئەفسەرن	فسرن
ئەفسەری	فسري
ئەفسەرە	فسر
ئەفسەرەی	فسري
ئەفلێک	فلك
ئەفلەک	فلك
ئەفەندی	فندي
ئەل	ل
ئەلئومەی	لومي
ئەلبا	لبا
ئەلبی	لبي
ئەلبێدا	لبدا
ئەلشەرع	لشرع
ئەلف	لف
ئەلوسی	لوثي
ئەلڤێس	لوث
ئەلیس	ليس
ئەلیسا	ليسا
ئەلێک	لك
ئەلەڤێس	لوث
ئەم	م
ئەمان	مان
ئەمانە	مان
ئەمباری	مباري
ئەمجەد	مجد
ئەمر	مر
ئەمرۆ	مرو
ئەمرۆی	مروي
ئەمری	مري
ئەمسال	مثال
ئەمساڵ	مثال
ئەمساڵی	مصالي
ئەمساڵە	مثال
ئەمش	مش
ئەمشەوی	مشوي
ئەمن	من
ئەمنی	مني
ئەمنیان	منيان
ئەمنیەت	منيط
ئەمه	مه
ئەمڕؤ	مرؤ
ئەمڕو	مرو
ئەمڕۆ	مرو
ئەمڕۆی	مروي
ئەمڕۆیە	مروي
ئەمی	مي
ئەمیر	مير
ئەمە	م
ئەمەجاری	مجاري
ئەمەخۆی	مخوي
ئەمەدا	مدا
ئەمەزۆر	مزور
ئەمەش	مش
ئەمەشی	مشي
ئەمەل	مل
ئەمەڕەت	مرت
ئەمەکاری	مكاري
ئەمەی	مي
ئەنبار	نبار
ئەنباری	نباري
ئەنتوان	نتوان
ئەنتی	نتي
ئەنتێنا	نتنا
ئەنتەر	نطر
ئەنجا	نجا
ئەنجلس	نجلس
ئەنجلێس	نجلس
ئەنجێلا	نجلا
ئەنجێلس	نجلس
ئەنجێلۆ	نجلو
ئەنخێل	نخل
ئەند	ند
ئەندام	ندام
ئەندامن	ندامن
ئەندامێ	ندام
ئەندامە	ندام
ئەندانی	نداني
ئەندرسن	ندرسن
ئەندری	ندري
ئەندرێ	ندر
ئەندرێس	ندرس
ئەندی	ندي
ئەنسار	نثار
ئەنساری	نساري
ئەنفال	نفال
ئەنفالێ	نفال
ئەنفالە	نفال
ئەنفاڵ	نفال
ئەنقەرا	نقرا
ئەنقەرە	نقر
ئەنقەرەی	نقري
ئەنقەست	نقسط
ئەنمار	نمار
ئەنور	نور
ئەنوەر	نور
ئەنوەری	نوري
ئەنکەرا	نكرا
ئەنکەرە	نكر
ئەنکەرەو	نكرو
ئەنیس	نيس
ئەنێستا	نصتا
ئەنێسکا	نسكا
ئەنەس	نص
ئەهل	هل
ئەهلی	هلي
ئەهواز	هواز
ئەو	و
ئەوا	وا
ئەوانی	واني
ئەوانەی	واني
ئەوجا	وجا
ئەوجار	وجار
ئەودا	ودا
ئەوس	وص
ئەوسا	وصا
ئەوسەت	وسط
ئەوسەتی	وسطي
ئەوش	وش
ئەوشی	وشي
ئەوقاف	وقاف
ئەون	ون
ئەوو	و
ئەوی	وي
ئەوین	وين
ئەوێ	و
ئەوێن	ون
ئەوە	و
ئەوەب	وب
ئەوەبدەن	وبدن
ئەوەتا	وطا
ئەوەتان	وتان
ئەوەد	ود
ئەوەدا	ودا
ئەوەدان	ودان
ئەوەدێت	ودت
ئەوەدێن	ودن
ئەوەش	وش
ئەوەشی	وشي
ئەوەل	ول
ئەوەمن	ومن
ئەوەن	ون
ئەوەنین	ونين
ئەوەهەیە	وهي
ئەوەو	و
ئەوەوە	و
ئەوەڕەت	ورط
ئەوەکرا	وكرا
ئەوەی	وي
ئەوەین	وين
ئەوەیە	وي
ئەڤ	و
ئەڤسال	وصال
ئەڤی	وي
ئەڤین	وين
ئەڤینێ	وين
ئەڤێ	و
ئەڤە	و
ئەکات	كات
ئەکاد	كاد
ئەکبەر	كبر
ئەکبەری	كبري
ئەکرم	كرم
ئەکرێت	كرت
ئەکرەم	كرم
ئەکسل	كثل
ئەکشن	كشن
ئەکشی	كشي
ئەکیتۆ	كيتو
ئەکەم	كم
ئەکەن	كن
ئەکەین	كين
ئەڵقەی	لقي
ئەڵماس	لماس
ئەڵمان	لمان
ئەڵوەن	لون
ئەڵوەنی	لوني
ئەڵڤێس	لوث
ئەی	ي
ئەیسی	يسي
ئەیمار	يمار
ئەیمەن	يمن
ئەینی	يني
ئەیهود	يهود
احمد	احمد
ان	آن
اکرم	اكرم
بؤ	بؤ
باب	باب
بابا	بابا
بابل	بابل
بابلی	بابلي
بابێ	باب
بابێل	بابل
بات	بات
باج	باج
باخ	باخ
باد	باد
بادی	بادي
بادینان	بادينان
بار	بار
بارا	بارا
بارزان	بارزان
بارن	بارن
بارون	بارون
بارک	بارك
بارۆن	بارون
باری	باري
بارین	بارين
بارینێ	بارين
بارێ	بار
بارێکی	باركي
بارە	بار
بارەکەی	باركي
بارەی	باري
بارەیێ	باري
باز	باز
بازار	بازار
بازارێ	بازار
بازاڕ	بازار
بازاڕە	بازار
بازل	بازل
باس	باس
باست	باست
باستان	باسطان
باستۆری	باستوري
باسل	باسل
باسم	باسم
باسک	باسك
باسکی	باسكي
باسکە	باسك
باسکەی	باسكي
باسێ	باص
باسێک	باسك
باسێکی	باسكي
باسە	باص
باسەئەم	باسم
باسەتا	باسطا
باسەوا	باسوا
باش	باش
باشا	باشا
باشە	باش
باغی	باغي
باقر	باقر
باقی	باقي
بال	بال
بالا	بالا
بالی	بالي
بالێ	بال
بالێی	بالي
بالە	بال
بالەی	بالي
بان	بان
بانکۆک	بانكوك
بانی	باني
بانە	بان
بانەی	باني
باک	باك
باکور	باكور
باکورێ	باكور
باکوور	باكور
باکوورێ	باكور
باکوورە	باكور
باکی	باكي
باڵ	بال
باڵا	بالا
باڵاو	بالاو
باڵۆن	بالون
باڵی	بالي
باڵەی	بالي
باڵەیان	باليان
بایدن	بايدن
بایکال	بايكال
بایکاڵ	بايكال
بتنێ	بطن
بتوێن	بطون
بتڵ	بطل
بتەوێت	بتوت
بخرێت	بخرت
بخرێتە	بخرت
بخرێن	بخرن
بخرێنە	بخرن
بخەت	بخت
بخەن	بخن
بخەنە	بخن
بدا	بدا
بدرێ	بدر
بدرێت	بدرت
بدرێتێ	بدرت
بدرێتە	بدرت
بدرێن	بدرن
بدل	بدل
بدن	بدن
بدوێت	بدوت
بدە	بد
بدەت	بدت
بدەن	بدن
بدەنێ	بدن
بدەنە	بدن
بدەی	بدي
بدەیت	بديت
بدەین	بدين
بدەینێ	بدين
بدەینە	بدين
بر	بر
برا	برا
براد	براد
برادلی	برادلي
برازیل	برازيل
برام	برام
بران	بران
برای	براي
برایێ	براي
برد	برد
بردن	بردن
بردە	برد
برن	برن
برهان	برهان
بروج	بروج
بروک	بروك
بروکسل	بروكسل
برۆج	بروج
برۆم	بروم
برۆنز	برونز
برۆکسل	بروكسل
بری	بري
بریا	بريا
بریت	بريت
بریتانی	بريطاني
بریدج	بريدج
برین	برين
برێز	برز
برێست	برصت
برێمەن	برمن
برێک	برك
برێکا	بركا
برێکی	بركي
برێیا	بريا
برە	بر
بزانێ	بضان
بزر	بزر
بزن	بزن
بسی	بثي
بسەر	بسر
بشیر	بشير
بشێت	بشت
بشێن	بشن
بلا	بلا
بلال	بلال
بلو	بلو
بلوو	بلو
بلووری	بلوري
بلۆ	بلو
بلۆک	بلوك
بلی	بلي
بلیت	بليت
بلیتێن	بليتن
بلیۆن	بليون
بلێ	بل
بلێم	بلم
بلێن	بلن
بلێید	بليد
بلێین	بلين
بم	بم
بمێنێ	بمن
بن	بن
بنکە	بنك
بنی	بني
بنێ	بن
بنێت	بنت
بنێین	بنين
بنەما	بنما
بها	بها
بهجت	بهجت
بهرام	بهرام
بهێت	بهت
بهێتە	بهت
بهێز	بهظ
بهێن	بهن
بهێنێ	بهن
بهێنە	بهن
بوار	بوار
بواری	بواري
بوارێ	بوار
بوارە	بوار
بوارەی	بواري
بواس	بواث
بوبێت	بوبت
بوترێت	بوطرت
بوخارست	بوخارست
بورما	بورما
بورمی	بورمي
بوری	بوري
بورینا	بورينا
بوریێن	بورين
بوزا	بوذا
بوزی	بوذي
بوش	بوش
بوشرا	بوشرا
بول	بول
بولا	بولا
بولێ	بول
بوم	بوم
بون	بون
بونا	بونا
بونی	بوني
بونە	بون
بووانی	بواني
بووبن	بوبن
بووبێ	بوب
بووبێت	بوبت
بووری	بوري
بووش	بوش
بووم	بوم
بوومە	بوم
بوون	بون
بوونا	بونا
بوونی	بوني
بوونێ	بون
بوونە	بون
بوونەی	بوني
بووەلە	بول
بووەلەو	بولو
بوکێر	بوكر
بوێر	بور
بوێری	بوري
بوەستن	بوسطن
بوەستێت	بوسطت
بڕ	بر
بڕا	برا
بڕاد	براد
بڕانی	براني
بڕبڕەی	بربري
بڕوا	بروا
بڕی	بري
بڕین	برين
بڕێک	برك
بڕێکی	بركي
بڕە	بر
بڕەش	برش
بڕەکەی	بركي
بڕەی	بري
بکت	بكت
بکر	بكر
بکری	بكري
بکرێ	بكر
بکرێت	بكرت
بکرێتە	بكرت
بکرێن	بكرن
بکرێنە	بكرن
بکن	بكن
بکڕن	بكرن
بکڕێت	بكرت
بکێت	بكت
بکە	بك
بکەت	بكت
بکەم	بكم
بکەن	بكن
بکەنە	بكن
بکەی	بكي
بکەیت	بكيت
بکەین	بكين
بکەینە	بكين
بکەێن	بكن
بڵین	بلين
بڵێ	بل
بڵێت	بلط
بڵێم	بلم
بڵێن	بلن
بڵێی	بلي
بڵێیت	بليت
بڵێین	بلين
بۆئەم	بوم
بۆب	بوب
بۆبی	بوبي
بۆتان	بوتان
بۆتسوانا	بوتسوانا
بۆرتلاند	بورتلاند
بۆرما	بورما
بۆرن	بورن
بۆرکینا	بوركينا
بۆری	بوري
بۆسان	بوسان
بۆستن	بوسطن
بۆسنیا	بوثنيا
بۆسنە	بوسن
بۆسەر	بوصر
بۆش	بوش
بۆق	بوق
بۆل	بول
بۆلتن	بولتن
بۆم	بوم
بۆمبای	بومباي
بۆن	بون
بۆنی	بوني
بۆنە	بون
بۆنەی	بوني
بۆنەیە	بوني
بۆڕی	بوري
بۆکرا	بوكرا
بۆڵتن	بولتن
بۆینس	بوينس
بی	بي
بیان	بيان
بیانو	بيانو
بیانوو	بيانو
بیانەوێ	بيانو
بیت	بيت
بیتا	بيتا
بیتر	بيطر
بیتی	بيتي
بیدەن	بيدن
بیر	بير
بیرا	بيرا
بیرت	بيرت
بیرم	بيرم
بیرو	بيرو
بیروت	بيروت
بیرە	بير
بیست	بيست
بیستێ	بيست
بیل	بيل
بیلاروسی	بيلاروسي
بین	بين
بینا	بينا
بینت	بينت
بینن	بينن
بینی	بيني
بینێت	بينت
بینە	بين
بینەوە	بينو
بیۆلۆجی	بيولوجي
بیێر	بير
بیە	بي
بیەوێت	بيوت
بێ	ب
بێت	بط
بێتر	بتر
بێتە	بط
بێخاڵ	بخال
بێخن	بخن
بێر	بر
بێرت	برت
بێرد	برد
بێرر	برر
بێرن	برن
بێرنز	برنز
بێری	بري
بێزار	بذار
بێسەر	بسر
بێل	بل
بێن	بن
بێنیت	بنيت
بێنین	بنين
بێنێ	بن
بێنێت	بنت
بێنە	بن
بێنەسەر	بنصر
بێوار	بوار
بێوێنەی	بوني
بێڕێزی	برزي
بێکەر	بكر
بێڵ	بل
بێڵن	بلن
بێی	بي
بێین	بين
بە	ب
بەئازار	بازار
بەئاست	باسط
بەئاستی	باسطي
بەئێران	بران
بەئێرانی	براني
بەئێمە	بم
بەئەرک	برك
بەئەرکی	بركي
بەئەستەم	بثتم
بەئەم	بم
بەتانک	بتانك
بەتاڵ	بطال
بەتیخ	بطيخ
بەتین	بتين
بەتێر	بتر
بەجل	بجل
بەجلی	بجلي
بەحر	بحر
بەحری	بحري
بەحرین	بحرين
بەحرەین	بحرين
بەحس	بحث
بەحسا	بحثا
بەحسێ	بحث
بەحەسەن	بحثن
بەخاڵ	بخال
بەخت	بخت
بەخوڕ	بخور
بەخێر	بخر
بەد	بد
بەدر	بدر
بەدوا	بدوا
بەدور	بدور
بەدوو	بدو
بەدوور	بدور
بەدووی	بدوي
بەدڵ	بدل
بەدڵی	بدلي
بەدی	بدي
بەدیع	بديع
بەدیل	بديل
بەدەر	بدر
بەدەل	بدل
بەر	بر
بەرا	برا
بەرابەر	برابر
بەراز	براز
بەرازی	برازي
بەرازیل	برازيل
بەرای	براي
بەرتلە	برطل
بەرتیل	برطيل
بەرد	برد
بەردا	بردا
بەردان	بردان
بەردی	بردي
بەرز	برز
بەرزان	برزان
بەرزن	برزن
بەرزی	برزي
بەرزە	برز
بەرزەی	برزي
بەرسڤا	برصوا
بەرلین	برلين
بەرلینێ	برلين
بەرمیل	برميل
بەرمیلە	برميل
بەرن	برن
بەرهەمی	برهمي
بەرڵین	برلين
بەری	بري
بەریا	بريا
بەرید	بريد
بەریدی	بريدي
بەرین	برين
بەریێ	بري
بەرێ	بر
بەرێت	برت
بەرێز	برز
بەرێزان	برزان
بەرێزی	برزي
بەرە	بر
بەرەد	برد
بەرەکانی	بركاني
بەرەکەت	بركت
بەرەی	بري
بەزاز	بزاز
بەزۆر	بذور
بەس	بس
بەسام	بسام
بەساڵ	بسال
بەست	بسط
بەسترا	بسترا
بەستن	بسطن
بەستی	بسطي
بەستەی	بسطي
بەسرا	بصرا
بەسری	بصري
بەسرە	بسر
بەسرەی	بصري
بەسڕە	بسر
بەسی	بثي
بەسێ	بس
بەسێیەم	بسيم
بەسە	بس
بەسەر	بسر
بەسەرا	بصرا
بەسەری	بصري
بەسەڕ	بسر
بەش	بش
بەشان	بشان
بەشن	بشن
بەشی	بشي
بەشیر	بشير
بەشێ	بش
بەشە	بش
بەشەش	بشش
بەشەڕ	بشر
بەشەڕی	بشري
بەشەی	بشي
بەعس	بعث
بەعسا	بعثا
بەعسن	بعثن
بەعسە	بعث
بەغداد	بغداد
بەغدادی	بغدادي
بەغدادیە	بغدادي
بەلجیکا	بلجيكا
بەلو	بلو
بەلۆ	بلو
بەلی	بلي
بەلێ	بل
بەلێدان	بلدان
بەلێن	بلن
بەلەد	بلد
بەلەدی	بلدي
بەلەم	بلم
بەم	بم
بەمن	بمن
بەمە	بم
بەن	بن
بەنا	بنا
بەند	بند
بەندە	بند
بەندەر	بندر
بەنزین	بنزين
بەنک	بنك
بەنۆ	بنو
بەنی	بني
بەنیوەی	بنيوي
بەنێو	بنو
بەنێوی	بنوي
بەنەوەی	بنوي
بەها	بها
بەهار	بهار
بەهارە	بهار
بەهجەت	بهجت
بەهرا	بهرا
بەهرام	بهرام
بەهی	بهي
بەهێز	بهظ
بەهێزن	بهظن
بەهێزی	بهذي
بەهێزە	بهظ
بەهەر	بهر
بەهەم	بهم
بەوادەی	بوادي
بەوانەی	بواني
بەوزەی	بوذي
بەوش	بوش
بەوێنە	بون
بەوێنەی	بوني
بەوەش	بوش
بەوەنا	بونا
بەڕ	بر
بەڕا	برا
بەڕازیل	برازيل
بەڕازیلی	برازيلي
بەڕای	براي
بەڕی	بري
بەڕێ	بر
بەڕێز	برز
بەڕێزان	برزان
بەڕێزی	برزي
بەڕێک	برك
بەڕە	بر
بەڕەوا	بروا
بەڕەی	بري
بەکتریا	بكتريا
بەکر	بكر
بەکری	بكري
بەکرێ	بكر
بەکرێی	بكري
بەکێ	بك
بەکەم	بكم
بەکەڵک	بكلك
بەڵا	بلا
بەڵی	بلي
بەڵین	بلين
بەڵێ	بل
بەڵێن	بلن
بەڵێی	بلي
بەی	بي
بەیات	بيات
بەیان	بيان
بەیانێ	بيان
بەیت	بيت
بەیتی	بيتي
بەیتەرەی	بيطري
بەیروت	بيروت
بەیرووت	بيروت
تا	تا
تائێستا	طاستا
تاج	تاج
تاخی	تآخي
تاخێ	تآخ
تاخێن	تآخن
تاد	طاد
تادێت	طادت
تار	طار
تارا	طارا
تارق	طارق
تاری	طاري
تاریخ	تاريخ
تاق	تاق
تاقم	طاقم
تالب	طالب
تالبی	طالبي
تالین	تالين
تام	تام
تامر	تامر
تامس	طامس
تامی	طامي
تان	تان
تانک	تانك
تانە	تان
تاها	تاها
تاهر	طاهر
تاون	تاون
تاکسی	تاكسي
تاڵ	طال
تاڵب	طالب
تاڵی	تالي
تایبەت	طايبت
تایبەتا	طايبتا
تایبەتم	طايبتم
تایبەتن	طايبتن
تایبەتێ	طايبت
تایبەتە	طايبت
تایسۆن	تايسون
تایلاند	تايلاند
تایلاندی	تايلاندي
تایلۆر	تايلور
تایلەند	تايلند
تایوان	تايوان
تایوانی	تايواني
تایەر	طاير
تبت	تبت
تبتی	تبتي
تحسین	تحسين
تدفین	تدفين
تر	تر
ترا	ترا
ترام	ترام
تردا	تردا
ترزی	ترضي
ترس	ترس
ترسا	ترسا
ترسان	ترسان
ترسی	طرسي
ترسیان	ترصيان
ترسەی	طرسي
ترش	ترش
ترشی	ترشي
ترمان	ترمان
ترن	ترن
ترو	ترو
ترکی	تركي
ترکیا	تركيا
ترکیێ	تركي
تری	طري
تریان	تريان
تریش	تريش
تریشی	تريشي
تریلیۆن	تريليون
ترین	ترين
ترێ	طر
ترە	طر
ترەبۆ	تربو
ترەو	طرو
ترەوە	طرو
ترەوەو	طرو
تسعین	تسعين
تسعینی	تسعيني
تسیبی	تثيبي
تشت	تشت
تشتێ	تشت
تشتێن	تشتن
تشتەکی	تشتكي
تشتەکێ	تشتك
تشرین	تشرين
تلوعی	تلوعي
تمر	تمر
تموز	تموز
تمەن	تمن
تنێ	تن
تنێسی	تنصي
تهران	تهران
تو	تو
توانی	تواني
توانیان	توانيان
توت	توت
توخمی	توخمي
تودەی	طودي
تورا	طورا
توران	طوران
تورقە	تورق
تورهان	تورهان
تورک	تورك
تورکی	توركي
تورکین	توركين
تورکیێ	توركي
تورێ	طور
تورێن	طورن
توز	توذ
توش	توش
توشی	توشي
توفیق	توفيق
توماس	توماس
تومەن	تومن
تونس	تونس
تونسی	تونسي
تونسێ	تونس
تونی	توني
توو	تو
تووتن	توطن
توورە	طور
تووسی	طوسي
تووش	توش
تووشی	توشي
توونس	تونس
تووی	طوي
توڕە	طور
توڕەبوون	توربون
توڕەن	طورن
توڕەی	طوري
توی	طوي
توێکڵی	توكلي
تکساس	تكساس
تۆ	تو
تۆبی	توبي
تۆتی	توطي
تۆرا	طورا
تۆران	طوران
تۆرهان	تورهان
تۆری	طوري
تۆریس	توريس
تۆرین	تورين
تۆرێ	طور
تۆرێس	تورث
تۆرێکی	توركي
تۆرەی	طوري
تۆز	توذ
تۆزی	توذي
تۆش	توش
تۆفان	طوفان
تۆفیق	توفيق
تۆم	توم
تۆماس	توماس
تۆن	تون
تۆنی	توني
تۆڕ	طور
تۆڕی	طوري
تۆڕێکی	توركي
تۆڕە	طور
تۆڕەکە	تورك
تۆکیۆ	طوكيو
تۆڵ	طول
تۆڵی	تولي
تۆڵە	طول
تۆڵەی	تولي
تۆی	طوي
تی	تي
تیر	طير
تیرانا	تيرانا
تیری	طيري
تیرەی	طيري
تیشی	طيشي
تیم	تيم
تیما	تيما
تیمۆر	تيمور
تیمی	تيمي
تیمێ	تيم
تیمێن	تيمن
تیمە	تيم
تیمەی	تيمي
تین	تين
تینا	طينا
تینی	طيني
تێ	ت
تێبینی	تبيني
تێبەر	تبر
تێبەردا	تبردا
تێد	تد
تێدا	تدا
تێدانیە	تداني
تێدەکەن	تدكن
تێر	طر
تێرو	طرو
تێرۆر	طرور
تێرۆن	طرون
تێری	طري
تێزی	تزي
تێست	طست
تێستی	تسطي
تێل	تل
تێلی	طلي
تێمێکی	تمكي
تێن	تن
تێنس	تنس
تێنستا	تنصتا
تێنسی	تنصي
تێوەردان	توردان
تێوەری	طوري
تێڤێز	توذ
تێکبدەن	تكبدن
تێکدا	تكدا
تێکدان	تكدان
تێکدەر	تكدر
تێکدەری	تكدري
تێکست	تكست
تێکستا	تكستا
تێکلی	تكلي
تێکلیێن	تكلين
تێکڕا	تكرا
تێکەل	تكل
تێکەلیێن	تكلين
تێکەڵ	تكل
تێکەڵی	تكلي
تێکەڵەی	تكلي
تێڵا	طلا
تێی	تي
تەئاخی	تآخي
تەبا	طبا
تەباخ	طباخ
تەبریزی	تبريزي
تەبلیسی	تبليسي
تەبەق	طبق
تەتەری	تتري
تەجاوز	تجاوز
تەجمید	تجميد
تەحریر	تحرير
تەحسین	تحسين
تەخ	تخ
تەخت	تخت
تەختی	تخطي
تەختەی	تخطي
تەخێ	تخ
تەخێن	تخن
تەدوین	تدوين
تەرابلس	طرابلس
تەرخان	ترخان
تەرخەم	ترخم
تەرخەمی	ترخمي
تەرزی	ترضي
تەرم	ترم
تەرمی	ترمي
تەرمیان	ترميان
تەرمێ	ترم
تەرمەی	ترمي
تەرکیز	تركيز
تەرەفی	ترفي
تەرەقی	ترقي
تەزووی	تضوي
تەزوی	تضوي
تەزویر	تزوير
تەسلیم	تسليم
تەسویر	تصوير
تەسک	تسك
تەسکی	تسكي
تەسەل	تصل
تەسەلی	تسلي
تەسەور	تسور
تەسەوف	تصوف
تەشریعی	تشريعي
تەشهیر	تشهير
تەشەنەی	تشني
تەعبیر	تعبير
تەعجیل	تعجيل
تەعریب	تعريب
تەعریف	تعريف
تەعز	تعز
تەعزی	تعضي
تەعمە	طعم
تەق	طق
تەقتەق	طقطق
تەقدیری	تقديري
تەقی	تقي
تەقینی	تقيني
تەقە	طق
تەقەو	تقو
تەقەی	تقي
تەقەیان	تقيآن
تەل	تل
تەلاق	طلاق
تەلال	تلال
تەلعەت	طلعت
تەلی	طلي
تەلەبە	طلب
تەلەفون	تلفون
تەلەفۆن	تلفون
تەم	طم
تەماتە	تمات
تەماتەی	تماتي
تەمر	طمر
تەمو	طمو
تەموز	تموز
تەمووز	تموز
تەمۆ	طمو
تەمیز	تميز
تەمیزی	تميزي
تەمیم	تميم
تەمییز	تمييز
تەمەر	طمر
تەمەن	تمن
تەمەنی	تمني
تەمەنێ	تمن
تەمەنە	تمن
تەمەنەی	تمني
تەن	تن
تەنا	طنا
تەناهی	تناهي
تەناهیا	تناهيا
تەناهیێ	تناهي
تەنبوور	طنبور
تەنتاوی	طنطاوي
تەندەر	تندر
تەندەری	تندري
تەندەرین	تندرين
تەنز	طنز
تەنسی	تنصي
تەنسیق	تنسيق
تەنفیزی	تنفيذي
تەنوور	تنور
تەنک	تنك
تەنکەر	تنكر
تەنی	طني
تەنیا	تنيا
تەنیێن	تنين
تەنێ	تن
تەنێن	طنن
تەنێک	تنك
تەنێکی	تنكي
تەها	طها
تەهران	طهران
تەهرانێ	طهران
تەوار	طوار
تەواری	تواري
تەوافق	توافق
تەوافقی	توافقي
تەوحید	توحيد
تەوفیق	توفيق
تەونی	توني
تەویل	طويل
تەوەر	طور
تەوەران	طوران
تەوەری	طوري
تەوەرێ	طور
تەوەرێن	طورن
تەوەرێک	تورك
تەوەرەکێ	تورك
تەوەرەی	طوري
تەڕ	طر
تەڤ	تو
تەڤایا	طوايا
تەڤی	طوي
تەکساس	تكساس
تەکسی	تكسي
تەکلیف	تكليف
تەکنیکی	تكنيكي
تەکەز	تكز
تەڵاق	طلاق
تەڵاقی	تلاقي
تەڵعەت	طلعت
تەڵی	طلي
تەڵەبە	طلب
تەڵەبەی	طلبي
تەیاب	طياب
تەیار	تيار
تەیب	طيب
تەیسیر	تيسير
تەیمور	تيمور
تەیموور	تيمور
جابر	جابر
جادا	جادا
جادر	جادر
جادێ	جاد
جادە	جاد
جار	جار
جارا	جارا
جاران	جاران
جاری	جاري
جارێ	جار
جارە	جار
جارەئەم	جارم
جارەم	جارم
جارەی	جاري
جارەیان	جاريان
جاز	جاز
جازی	جازي
جاسم	جاسم
جاش	جاش
جاشوا	جاشوا
جاف	جاف
جافی	جافي
جام	جام
جامایکا	جامايكا
جان	جان
جانتا	جانتا
جانی	جاني
جانێ	جان
جانێت	جانت
جاوید	جاويد
جاک	جاك
جاکارتا	جاكارتا
جاکسۆن	جاكسون
جبار	جبار
جبریل	جبريل
جبس	جبس
جبور	جبور
جددی	جددي
جدی	جدي
جری	جري
جرێمی	جرمي
جسر	جسر
جسی	جصي
جعفر	جعفر
جل	جل
جلال	جلال
جلو	جلو
جلی	جلي
جلیل	جليل
جم	جم
جمال	جمال
جمهوری	جمهوري
جمیل	جميل
جنان	جنان
جندی	جندي
جنسی	جنسي
جنوب	جنوب
جها	جها
جهان	جهان
جهی	جهي
جهێ	جه
جهێن	جهن
جو	جو
جواد	جواد
جوان	جوان
جوانی	جواني
جوانێ	جوان
جوانە	جوان
جود	جود
جودا	جودا
جودی	جودي
جور	جور
جورا	جورا
جورج	جورج
جوری	جوري
جورێ	جور
جورێن	جورن
جوزیف	جوزيف
جولی	جولي
جولەی	جولي
جومعە	جومع
جون	جون
جونەی	جوني
جوهر	جوهر
جوو	جو
جوولەی	جولي
جوون	جون
جوونی	جوني
جووڵە	جول
جووڵەی	جولي
جوڵەی	جولي
جڤیا	جويا
جڤینا	جوينا
جڤینێ	جوين
جۆ	جو
جۆئێل	جول
جۆدا	جودا
جۆدۆ	جودو
جۆر	جور
جۆرا	جورا
جۆرج	جورج
جۆرجی	جورجي
جۆرجیا	جورجيا
جۆرن	جورن
جۆری	جوري
جۆرێ	جور
جۆرێن	جورن
جۆرە	جور
جۆرەی	جوري
جۆرەیە	جوري
جۆزیف	جوزيف
جۆزێ	جوز
جۆزێف	جوزف
جۆش	جوش
جۆلان	جولان
جۆلی	جولي
جۆن	جون
جۆنس	جونس
جۆنسن	جونسن
جۆنی	جوني
جۆهەر	جوهر
جۆی	جوي
جیبۆتی	جيبوتي
جیران	جيران
جیف	جيف
جیل	جيل
جیم	جيم
جیمس	جيمس
جیهان	جيهان
جیهانێ	جيهان
جیهانە	جيهان
جیۆلۆجی	جيولوجي
جێ	ج
جێب	جب
جێبێڵن	جبلن
جێبێڵێت	جبلت
جێدێڵن	جدلن
جێدێڵێت	جدلت
جێرمان	جرمان
جێرمانی	جرماني
جێرمی	جرمي
جێری	جري
جێرێمی	جرمي
جێف	جف
جێم	جم
جێمز	جمز
جێمی	جمي
جێن	جن
جێنەوا	جنوا
جێهشت	جهشت
جێهێشت	جهشت
جێێ	ج
جەبار	جبار
جەبارە	جبار
جەبر	جبر
جەبەل	جبل
جەبەلی	جبلي
جەدوع	جدوع
جەراح	جراح
جەزا	جزا
جەزائر	جزار
جەستە	جصت
جەعفەر	جعفر
جەعفەری	جعفري
جەلا	جلا
جەلال	جلال
جەلاڵ	جلال
جەلی	جلي
جەلیل	جليل
جەلەبی	جلبي
جەم	جم
جەمال	جمال
جەماڵ	جمال
جەمیل	جميل
جەنابێ	جناب
جەنان	جنان
جەند	جند
جەنرال	جنرال
جەنڕاڵ	جنرال
جەنەرال	جنرال
جەنەراڵ	جنرال
جەنەوا	جنوا
جەنەڕاڵ	جنرال
جەهی	جهي
جەو	جو
جەواد	جواد
جەوان	جوان
جەودەت	جودت
جەولەی	جولي
جەوهەر	جوهر
جەوهەری	جوهري
جەڵال	جلال
جەڵتە	جلط
جەڵدەی	جلدي
جەیش	جيش
جەیشی	جيشي
جەیمس	جيمس
حاتم	حاتم
حاتەم	حاتم
حاج	حاج
حاجی	حاجي
حاجیان	حاجيان
حارس	حارس
حازر	حازر
حازم	حازم
حاشا	حاشا
حاشای	حاشاي
حافز	حافز
حافزی	حافظي
حالەت	حالت
حامد	حامد
حاکم	حاكم
حاکمی	حاكمي
حاڵ	حال
حاڵی	حالي
حاڵێک	حالك
حاڵەت	حالت
حاڵەتە	حالت
حبیب	حبيب
حجاب	حجاب
حجی	حجي
حدود	حدود
حزب	حزب
حزبا	حزبا
حزبی	حزبي
حزبە	حزب
حزبەی	حزبي
حساب	حساب
حسام	حسام
حسن	حسن
حسنی	حصني
حسو	حسو
حسیب	حسيب
حسین	حصين
حسینی	حسيني
حسێن	حصن
حسێنی	حصني
حف	حف
حللە	حلل
حلمی	حلمي
حلی	حلي
حلە	حل
حمد	حمد
حمس	حمس
حمسی	حمسي
حمو	حمو
حمود	حمود
حمودی	حمودي
حموود	حمود
حمید	حميد
حمە	حم
حوجەت	حوجت
حوسێن	حوسن
حوسەێن	حوسن
حوکم	حوكم
حکمت	حكمت
حکمەت	حكمت
حکومی	حكومي
حکومەی	حكومي
حکوومی	حكومي
حکیم	حكيم
حۆسێن	حوسن
حیدر	حيدر
حەب	حب
حەبی	حبي
حەبیب	حبيب
حەبێکی	حبكي
حەبە	حب
حەتا	حطا
حەتمی	حتمي
حەتمەن	حطمن
حەج	حج
حەجی	حجي
حەجیێ	حجي
حەداد	حداد
حەدبا	حدبا
حەدود	حدود
حەدیدی	حديدي
حەدەبا	حدبا
حەرام	حرام
حەرب	حرب
حەربی	حربي
حەریری	حريري
حەرەمی	حرمي
حەز	حظ
حەزا	حظا
حەزم	حزم
حەزمان	حزمان
حەزو	حذو
حەزی	حظي
حەسار	حصار
حەسان	حسان
حەسانە	حسان
حەسن	حصن
حەسون	حسون
حەسۆ	حسو
حەسیب	حسيب
حەسیر	حصير
حەسەن	حصن
حەسەنی	حصني
حەسەنێن	حصنن
حەسەنە	حصن
حەشار	حشار
حەشیش	حشيش
حەفت	حفت
حەفتا	حفتا
حەفتەم	حفتم
حەفید	حفيد
حەق	حق
حەقی	حقي
حەقیقی	حقيقي
حەلەب	حلب
حەما	حما
حەماس	حماس
حەمام	حمام
حەمای	حماي
حەمدان	حمدان
حەمدی	حمدي
حەمزە	حمض
حەمزەی	حمضي
حەمس	حمص
حەمود	حمود
حەمودی	حمودي
حەموودی	حمودي
حەمید	حميد
حەمە	حم
حەمەد	حمد
حەمەی	حمي
حەنا	حنا
حەنان	حنان
حەنیفی	حنيفي
حەنین	حنين
حەوا	حوا
حەواس	حواس
حەوت	حوت
حەوتی	حوطي
حەوز	حوض
حەوزی	حوذي
حەوزەی	حوذي
حەوشەی	حوشي
حەوێز	حوض
حەوێزی	حوذي
حەڤدە	حود
حەکیم	حكيم
حەکەم	حكم
حەڵەب	حلب
حەی	حي
حەیات	حيات
حەیاتی	حياتي
حەیدر	حيدر
حەیدەر	حيدر
حەیران	حيران
حەیفا	حيفا
خابوور	خابور
خاتری	خاطري
خازر	خازر
خاس	خاص
خافی	خافي
خافێر	خافر
خال	خال
خالا	خالا
خالد	خالد
خالس	خالس
خالقی	خالقي
خالی	خالي
خام	خام
خان	خان
خانا	خانا
خانە	خان
خاوی	خاوي
خاڵ	خال
خاڵس	خالص
خاڵسی	خالسي
خاڵقی	خالقي
خاڵی	خالي
خاڵە	خال
خاڵەی	خالي
خبر	خبر
خدا	خدا
خدر	خدر
خدران	خدران
خدری	خدري
خرا	خرا
خراب	خراب
خرانە	خران
خرما	خرما
خزر	خزر
خزری	خضري
خزم	خضم
خزمی	خضمي
خزمەت	خضمت
خزمەتا	خضمتا
خزمەتێن	خضمتن
خزێرە	خضر
خزەیر	خزير
خست	خست
خستن	خستن
خستنە	خستن
خستە	خست
خشت	خشت
خلف	خلف
خلیل	خليل
خو	خو
خوا	خوا
خوار	خوار
خوارێ	خوار
خواز	خواض
خوان	خوان
خور	خور
خورت	خورت
خورتا	خورتا
خورشید	خورشيد
خوری	خوري
خوزستان	خوزستان
خوست	خوست
خول	خول
خولا	خولا
خولان	خولان
خولانە	خولان
خولی	خولي
خولێ	خول
خولێن	خولن
خولە	خول
خولەی	خولي
خوو	خو
خوولی	خولي
خووی	خوي
خووە	خو
خوڵی	خولي
خوی	خوي
خویا	خويا
خویان	خويان
خوین	خوين
خوینا	خوينا
خوینێ	خوين
خویێ	خوي
خویێن	خوين
خوێ	خو
خوێن	خون
خوێنی	خوني
خوێنە	خون
خوێی	خوي
خوە	خو
خوەست	خوست
خوەل	خول
خوەو	خو
خوەیا	خويا
خوەیێ	خوي
خوەیێن	خوين
خڵەفان	خلفان
خۆ	خو
خۆت	خوت
خۆر	خور
خۆری	خوري
خۆزێ	خوذ
خۆسیە	خوصي
خۆسێ	خوص
خۆل	خول
خۆلا	خولا
خۆلان	خولان
خۆلی	خولي
خۆلێ	خول
خۆلێن	خولن
خۆڵ	خول
خۆڵی	خولي
خۆی	خوي
خۆیا	خويا
خۆیان	خويان
خۆیانە	خويان
خۆێ	خو
خیا	خيا
خیار	خيار
خێر	خر
خێرا	خرا
خێراش	خراش
خێری	خري
خێرێز	خرز
خێرێس	خرس
خێزان	خزان
خێزانێ	خزان
خێزانە	خزان
خێمە	خم
خێوەت	خوت
خێڵ	خل
خێڵی	خلي
خەبات	خباط
خەبەر	خبر
خەبەری	خبري
خەت	خط
خەتاب	خطاب
خەتارێ	ختار
خەتی	خطي
خەتیب	خطيب
خەرتوم	خرطوم
خەرج	خرج
خەرجی	خرجي
خەردەل	خردل
خەرمان	خرمان
خەزان	خزان
خەزرا	خزرا
خەزنەی	خزني
خەزێنەی	خزني
خەست	خست
خەفاف	خفاف
خەلات	خلاط
خەلاتێ	خلاط
خەلدون	خلدون
خەلفان	خلفان
خەلق	خلق
خەلقی	خلقي
خەلیفە	خليف
خەلیل	خليل
خەلەف	خلف
خەم	خم
خەمی	خمي
خەمیس	خميس
خەنجەر	خنجر
خەندقی	خندقي
خەو	خو
خەوتن	خوتن
خەون	خون
خەونا	خونا
خەونی	خوني
خەوی	خوي
خەویان	خويان
خەڵات	خلاط
خەڵاتە	خلاط
خەڵق	خلق
خەڵقی	خلقي
خەڵوەت	خلوت
خەڵی	خلي
خەڵەف	خلف
خەڵەفی	خلفي
خەیات	خياط
خەیار	خيار
خەیالی	خيالي
خەیام	خيام
خەیاڵ	خيال
خەیاڵی	خيالي
خەیری	خيري
خەیمە	خيم
دئەڤ	دو
دئەڤێ	دو
دا	دآ
داب	داب
دابڕان	دابران
دابێ	داب
داخل	داخل
داخلی	داخلي
داخڵ	داخل
داخڵی	داخلي
داد	داد
دادا	دادا
دادی	دادي
دادێ	داد
دادێت	دادت
دادەنێ	دادن
دار	دار
دارا	دارا
دارم	دارم
داروین	داروين
داری	داري
داریا	داريا
داریان	داريان
دارین	دارين
دارێن	دارن
دارە	دار
دارەکان	داركان
دافێنشی	دافنشي
دال	دال
دالاس	دالاس
دام	دام
دامەن	دامن
دان	دان
دانا	دانا
دانمارک	دانمارك
دانی	داني
دانیال	دانيال
دانیان	دانيان
دانیاڵ	دانيال
دانین	دانين
دانینا	دانينا
دانێ	دان
دانێن	دانن
دانە	دان
دانەی	داني
دانەیان	دانيان
داهێنا	داهنا
داهێنان	داهنان
داهێنانێ	داهنان
داهێنانە	داهنان
داو	داو
داود	داود
داوم	داوم
داون	داون
داوود	داوود
داوون	داون
داوی	داوي
داویا	داويا
داویان	داويان
داویانە	داويان
داوین	داوين
داویێ	داوي
داوێن	داون
داوە	داو
داوەئەم	داوم
داوەت	داوت
داوەتا	داوتا
داوەتێ	داوت
داوەتە	داوت
داوەران	داوران
داوەری	داوري
داوەو	داو
داڤێد	داود
داکا	داكا
داین	داين
داینی	دايني
داینە	داين
دبلۆم	دبلوم
دبن	دبن
دبێت	دبت
دبە	دب
دبەت	دبت
دجلە	دجل
ددت	ددت
ددەت	ددت
ددەن	ددن
در	در
درا	درا
دراما	دراما
درامی	درامي
دران	دران
درز	درز
درزی	درزي
درست	درست
درع	درع
درمی	درمي
درواسێ	درواس
درویش	درويش
درک	درك
درکی	دركي
دریم	دريم
درێ	در
درێسی	درسي
درێک	درك
درەما	درما
دست	دست
دشێت	دشت
دشێن	دشن
دل	دل
دلهی	دلهي
دلی	دلي
دلێ	دل
دن	دن
دنیا	دنيا
دنێڤ	دنو
دهێت	دهت
دهێن	دهن
دهەمان	دهمان
دهەمی	دهمي
دو	دو
دوا	دوا
دوارێ	دوار
دوانی	دواني
دور	دور
دورتموند	دورتموند
دورست	دورست
دوری	دوري
دورێن	دورن
دورە	دور
دوست	دوست
دولار	دولار
دوما	دوما
دونیا	دونيا
دوهی	دوهي
دوو	دو
دووا	دووا
دووانی	دواني
دووانەی	دواني
دووبرا	دوبرا
دوودا	دودا
دوور	دوور
دوورن	دوورن
دووری	دوري
دوورە	دور
دووست	دوست
دووف	دوف
دوولا	دوولا
دووم	دووم
دوومی	دومي
دووهەم	دوهم
دووک	دوك
دووکان	دوكان
دووی	دوي
دوویان	دويان
دوویێ	دوي
دووێ	دو
دووە	دو
دووەم	دوم
دووەمن	دومن
دووەمی	دومي
دووەمە	دوم
دووەکان	دوكان
دوکان	دوكان
دوینێ	دوين
دویێ	دوي
دوێ	دو
دوێت	دوت
دوێنی	دوني
دوێنێ	دون
دوێنێی	دوني
دوێیا	دويا
دوەم	دوم
دوەمی	دومي
دڤی	دوي
دڤیا	دويا
دڤێ	دو
دڤێت	دوت
دڤێد	دود
دکت	دكت
دکتاتۆر	دكتاتور
دکتور	دكتور
دکتۆر	دكتور
دکتۆرە	دكتور
دکن	دكن
دکێت	دكت
دکە	دك
دکەت	دكت
دکەن	دكن
دڵ	دل
دڵی	دلي
دڵیان	دليان
دڵێکی	دلكي
دڵە	دل
دڵەوە	دلو
دۆ	دو
دۆت	دوت
دۆحە	دوح
دۆحەی	دوحي
دۆخی	دوخي
دۆخە	دوخ
دۆخەی	دوخي
دۆر	دور
دۆرا	دورا
دۆران	دوران
دۆرێن	دورن
دۆرە	دور
دۆرەی	دوري
دۆس	دوس
دۆست	دوست
دۆسیە	دوسي
دۆسێی	دوسي
دۆق	دوق
دۆلار	دولار
دۆلارە	دولار
دۆما	دوما
دۆمینیکا	دومينيكا
دۆن	دون
دۆنم	دونم
دۆنی	دوني
دۆڕا	دورا
دۆڕان	دوران
دۆکان	دوكان
دۆڵار	دولار
دۆڵی	دولي
دی	دي
دیا	ديا
دیاب	دياب
دیار	ديار
دیارە	ديار
دیان	ديان
دیب	ديب
دید	ديد
دیدێ	ديد
دیر	دير
دیزنی	ديزني
دیس	ديس
دیسا	ديثا
دیسان	ديصان
دیسمبەر	ديسمبر
دیف	ديف
دیل	ديل
دیلی	ديلي
دین	دين
دینا	دينا
دینار	دينار
دینارە	دينار
دینامۆ	دينامو
دینی	ديني
دیوان	ديوان
دیک	ديك
دیکنز	ديكنز
دیکۆر	ديكور
دیکە	ديك
دیکەتا	ديكتا
دیۆن	ديون
دیێ	دي
دیێن	دين
دێ	د
دێر	در
دێربی	دربي
دێرک	درك
دێری	دري
دێرین	درين
دێل	دل
دێم	دم
دێمی	دمي
دێن	دن
دێنرێت	دنرت
دێنن	دنن
دێنین	دنين
دێنێ	دن
دێنێت	دنت
دێنێن	دنن
دێنە	دن
دێهقان	دهقان
دێو	دو
دێڤد	دود
دێڤێد	دود
دێڵن	دلن
دێڵێت	دلت
دێی	دي
دێین	دين
دە	د
دەبا	دبا
دەباغ	دباغ
دەبرێت	دبرت
دەبرێن	دبرن
دەبن	دبن
دەبنە	دبن
دەبوا	دبوا
دەبڕن	دبرن
دەبڕی	دبري
دەبڕێت	دبرت
دەبڵ	دبل
دەبی	دبي
دەبێ	دب
دەبێت	دبت
دەبێتە	دبت
دەبەست	دبست
دەبەستن	دبستن
دەبەستێ	دبست
دەبەن	دبن
دەبەی	دبي
دەخۆن	دخون
دەخیل	دخيل
دەخەن	دخن
دەخەنە	دخن
دەخەون	دخون
دەدن	ددن
دەدەن	ددن
دەدەنێ	ددن
دەدەنە	ددن
دەر	در
دەرباس	درباس
دەردی	دردي
دەرزی	درزي
دەرس	درس
دەرعا	درعا
دەرمان	درمان
دەرمانە	درمان
دەرویش	درويش
دەروێش	دروش
دەروێشی	دروشي
دەرک	درك
دەرکی	دركي
دەرکەت	دركت
دەری	دري
دەریا	دريا
دەرێ	در
دەرێت	درت
دەرەوەش	دروش
دەرەکی	دركي
دەس	دس
دەست	دست
دەستم	دستم
دەستن	دستن
دەستور	دستور
دەستوری	دستوري
دەستوریە	دستوري
دەستورێ	دستور
دەستورە	دستور
دەستورەی	دستوري
دەستوور	دستور
دەستوورێ	دستور
دەستێ	دست
دەستێن	دستن
دەستە	دست
دەسووتێن	دسوتن
دەشت	دشت
دەشنێ	دشن
دەشێ	دش
دەشێت	دشت
دەعوە	دعو
دەعوەو	دعو
دەغارە	دغار
دەغڵ	دغل
دەف	دف
دەفتەر	دفتر
دەفتەری	دفتري
دەفی	دفي
دەق	دق
دەقی	دقي
دەقێ	دق
دەقێن	دقن
دەقەی	دقي
دەلال	دلال
دەلۆ	دلو
دەلی	دلي
دەلێ	دل
دەلێت	دلت
دەلێن	دلن
دەم	دم
دەما	دما
دەمار	دمار
دەماغ	دماغ
دەمان	دمان
دەمرن	دمرن
دەمرێت	دمرت
دەمی	دمي
دەمێ	دم
دەمێن	دمن
دەمێنن	دمنن
دەمێنێ	دمن
دەمێنێت	دمنت
دەمەوەی	دموي
دەمەی	دمي
دەن	دن
دەنا	دنا
دەنرێت	دنرت
دەنرێن	دنرن
دەنوێنێ	دنون
دەنی	دني
دەنێ	دن
دەنێت	دنت
دەنێرن	دنرن
دەنێرێت	دنرت
دەنێن	دنن
دەنێین	دنين
دەهان	دهان
دەهێ	ده
دەهێنا	دهنا
دەهێنت	دهنت
دەهێنن	دهنن
دەهێنێ	دهن
دەهێنێت	دهنت
دەو	دو
دەوا	دوا
دەوام	دوام
دەوامی	دوامي
دەوحە	دوح
دەوحەی	دوحي
دەور	دور
دەوری	دوري
دەورەی	دوري
دەولی	دولي
دەولە	دول
دەولەت	دولت
دەولەتا	دولتا
دەولەتێ	دولت
دەولەتێن	دولتن
دەوڵەت	دولت
دەوڵەتە	دولت
دەوێ	دو
دەوێت	دوت
دەوەستن	دوستن
دەوەن	دون
دەڤ	دو
دەڤەر	دور
دەڤەرا	دورا
دەڤەران	دوران
دەڤەری	دوري
دەڤەرێ	دور
دەڤەرێن	دورن
دەڤەرە	دور
دەڤەرەکا	دوركا
دەڤەرەی	دوري
دەڤەڕێ	دور
دەکا	دكا
دەکاک	دكاك
دەکتۆر	دكتور
دەکەن	دكن
دەکەنە	دكن
دەکەی	دكي
دەکەێن	دكن
دەڵی	دلي
دەڵیت	دليت
دەڵین	دلين
دەڵێ	دل
دەڵێت	دلت
دەڵێن	دلن
دەڵێین	دلين
دەی	دي
دەیان	ديان
دەیدەن	ديدن
دەیلی	ديلي
دەین	دين
دەیڤس	ديوث
دەیڵێت	ديلت
دەیڵێم	ديلم
دەیەم	ديم
رائد	رائد
راب	راب
رادیۆ	راديو
رازی	راضي
راسێل	راسل
رافع	رافع
رامی	رامي
رامین	رامين
رایس	رايس
رقس	رقص
روزی	روضي
روسیا	روسيا
رووسی	روسي
رووسیا	روسيا
رۆبرت	روبرت
رۆبن	روبن
رۆبین	روبين
رۆبێرت	روبرت
رۆبێن	روبن
رۆبەرت	روبرت
رۆز	روض
رۆلێ	رول
رۆما	روما
رۆمان	رومان
رۆمانی	روماني
رۆمانیا	رومانيا
رۆمەن	رومن
رۆن	رون
رۆنالدۆ	رونالدو
رۆک	روك
رۆڵی	رولي
رۆی	روي
ریاز	رياض
ریازی	رياضي
ریال	ريال
ریان	ريان
ریشە	ريش
رێباز	رباض
رێبین	ربين
رێکەوت	ركوت
رەجەب	رجب
رەحمان	رحمان
رەحیم	رحيم
رەزا	رضا
رەسول	رسول
رەش	رش
رەشاد	رشاد
رەشید	رشيد
رەعد	رعد
رەفیق	رفيق
رەمەزان	رمضان
زاب	ذاب
زاتی	ذاتي
زاد	زاد
زادە	ضاد
زادەی	ضادي
زار	زار
زارا	زارا
زارع	زارع
زارعی	ضارعي
زاری	ضاري
زافر	زافر
زام	ذام
زامبیا	زامبيا
زاملی	زاملي
زامن	زامن
زامنی	زامني
زامی	ذامي
زانا	زانا
زانی	زاني
زاهر	زاهر
زاهی	زاهي
زاڤی	ذاوي
زاک	ذاك
زاڵ	ذال
زاڵە	ذال
زاید	زايد
زبر	زبر
زبل	زبل
زبڵ	ذبل
زبڵی	زبلي
زرار	زرار
زراری	ذراري
زریان	ذريان
زمار	زمار
زمان	زمان
زمانێ	زمان
زمانە	زمان
زمین	ضمين
زنار	زنار
زندی	زندي
زوانە	ذوان
زور	زور
زورا	زورا
زوری	زوري
زولم	ظولم
زوهێر	ظوهر
زوو	ذو
زووانە	ذوان
زوودا	ذودا
زوور	زور
زووی	ذوي
زووە	ذو
زوڕنا	زورنا
زوڵم	ظولم
زوی	ذوي
زکری	ذكري
زکی	ذكي
زۆر	زور
زۆرا	زورا
زۆربێت	ضوربت
زۆرن	زورن
زۆری	زوري
زۆرە	زور
زۆرەی	زوري
زۆی	ذوي
زی	ذي
زیا	زيا
زیاب	ذياب
زیاد	زياد
زیادە	زياد
زیان	ذيان
زیانە	ذيان
زیتا	زيتا
زیتون	زيتون
زید	زيد
زیدان	زيدان
زیر	زير
زین	ذين
زینا	زينا
زینب	زينب
زینی	زيني
زێد	ضد
زێدان	ضدان
زێدی	ضدي
زێر	زر
زێرو	ذرو
زێری	ضري
زێرین	ذرين
زێنێت	زنت
زێوە	ذو
زێڕ	زر
زێڕی	ضري
زێڕین	ذرين
زێی	ذي
زەبر	زبر
زەبری	زبري
زەبی	ظبي
زەحمەت	زحمت
زەحمەتە	زحمت
زەخت	زخت
زەرب	ذرب
زەربی	ضربي
زەرد	زرد
زەری	ضري
زەریا	ذريا
زەریف	ذريف
زەرەر	ضرر
زەرەری	ضرري
زەرەو	ذرو
زەرەی	ضري
زەعیم	زعيم
زەفەر	زفر
زەق	زق
زەقی	زقي
زەلام	ظلام
زەلامێ	ظلام
زەمان	زمان
زەمانە	زمان
زەمین	ضمين
زەمینە	ضمين
زەمەن	ضمن
زەمەنی	ضمني
زەن	ضن
زەند	زند
زەندی	زندي
زەهرا	زهرا
زەهەبی	ذهبي
زەواج	زواج
زەوت	ضوت
زەورا	زورا
زەوی	ذوي
زەویدا	زويدا
زەوین	ضوين
زەویە	ذوي
زەکریا	زكريا
زەکی	ذكي
زەکەریا	زكريا
زەیت	ذيت
زەیتون	زيتون
زەیتوون	زيتون
زەیتی	زيتي
زەید	زيد
زەیدی	زيدي
زەین	ذين
زەینی	زيني
زەینەب	زينب
سائب	سائب
سائر	سائر
سائیر	ساير
سابت	سابت
سابح	صباح
سابر	سابر
سابر	صابر
سابری	ثابري
سابوون	صابون
سات	صات
ساتی	ساطي
ساحب	ساحب
ساحل	ساحل
ساحلی	ساحلي
ساحەی	صاحي
ساخ	ساخ
ساختە	ساخط
سادات	سادات
سادق	صادق
سادقی	صادقي
سادە	صاد
سادەی	سادي
سار	سار
سارا	سارا
سارد	سارد
سارکوزی	ساركوزي
سارکۆزی	ساركوزي
ساری	صاري
سارێن	سارن
سارە	صار
ساعدی	ساعدي
ساغ	ساغ
ساغی	صاغي
سافی	صافي
سافینا	صافينا
ساقی	ساقي
سال	سال
سالا	سالا
سالت	سالت
سالح	صالح
سالحی	صالحي
سالم	سالم
سالمی	سالمي
سالی	صالي
سالیێ	صالي
سالێ	سال
سالێک	سالك
سالە	سال
سالەک	سالك
سالەکێ	سالك
سام	سام
سامح	سامح
سامر	سامر
سامی	سامي
سامەرا	سامرا
سامەڕا	سامرا
سان	سان
سانا	صانا
سانت	صانت
سانتا	صانتا
ساندی	ساندي
سانی	ثاني
ساهر	ساهر
ساڤینا	ساوينا
ساڵ	سال
ساڵا	صالا
ساڵح	صالح
ساڵحی	صالحي
ساڵم	سالم
ساڵی	صالي
ساڵیێ	صالي
ساڵێ	سال
ساڵێک	سالك
ساڵێکە	سالك
ساڵە	سال
ساڵەئەم	سالم
ساڵەی	صالي
ساڵەیە	صالي
سبەی	صبي
سبەینێ	ثبين
ست	ست
ستار	ستار
ستان	سطان
ستانلی	ستانلي
ستران	سطران
سترانێ	سطران
ستون	ستون
ستۆن	ستون
ستی	سطي
ستیت	سطيت
ستیف	سطيف
ستیفن	ستيفن
ستین	ستين
ستەیت	سطيت
سدقی	صدقي
سدیق	صديق
سراج	سراج
سربی	صربي
سربیا	صربيا
سرت	سرت
سرود	صرود
سروود	صرود
سروە	سرو
سری	ثري
سریان	سريان
سرینا	سرينا
سست	سست
سعد	سعد
سعدو	سعدو
سعدون	سعدون
سعدی	صعدي
سعود	سعود
سعودی	سعودي
سعودیە	سعودي
سعوود	سعود
سعوودی	سعودي
سعوودیە	سعودي
سعید	صعيد
سفر	سفر
سفری	سفري
سفید	سفيد
سلام	سلام
سلبی	سلبي
سلفادۆر	سلفادور
سلفەی	سلفي
سلمان	سلمان
سلو	سلو
سلوفاکیا	سلوفاكيا
سلیم	سليم
سلیمان	سليمان
سلێمان	ثلمان
سم	سم
سمو	سمو
سمۆ	سمو
سمیت	سميط
سمیر	سمير
سمیس	سميث
سمین	سمين
سمێل	سمل
سمێڵ	سمل
سناعە	صناع
سنان	سنان
سندوق	صندوق
سندووق	صندوق
سندی	سندي
سنور	سنور
سنورێ	سنور
سنورە	سنور
سنونێ	سنون
سنوور	سنور
سنوورێ	سنور
سنوورە	سنور
سنۆ	صنو
سنۆرێ	سنور
سنی	ثني
سنێد	سند
سنە	سن
سنەدا	سندا
سنەو	صنو
سنەی	ثني
سنەیە	ثني
سوات	سواط
سوار	سوار
سواری	صواري
سوارە	سوار
سوارەی	صواري
سوان	صوان
سوتا	سوتا
سوتان	سوطان
سوتنا	سوطنا
سود	سود
سودان	سودان
سودانی	سوداني
سودی	سودي
سور	سور
سوران	سوران
سورمێ	صورم
سورن	سورن
سوری	سوري
سوریا	سوريا
سورین	سورين
سوریە	سوري
سورە	ثور
سورەیا	سوريا
سوفیا	صوفيا
سوق	سوق
سومال	صومال
سوماڵ	صومال
سون	سون
سوننە	صونن
سونی	صوني
سوهێل	سوهل
سوو	صو
سووتا	سوطا
سووتان	سوطان
سوود	سوود
سوودان	سودان
سوودانی	سوداني
سوودم	صودم
سوودی	سودي
سوودە	سود
سوور	سوور
سوورن	سوورن
سووری	سوري
سووریا	سوريا
سوورین	سورين
سووریێ	سوري
سوورە	ثور
سوورەی	سوري
سووننە	صونن
سوونی	صوني
سووڕی	سوري
سووک	سوك
سووکە	سوك
سوک	سوك
سوید	سويد
سویدێ	سويد
سویدە	سويد
سویس	سويس
سویسرا	سويسرا
سویفت	سويفت
سوێد	سود
سوێدی	سودي
سوێری	سوري
سوێس	سوس
سوێند	سوند
سڕبی	صربي
سڕبیا	صربيا
سڤک	سوك
سڤیل	سويل
سڤیلن	سويلن
سک	سك
سکات	سكات
سکان	سكان
سکتان	سكتان
سکرتیری	سكرتيري
سکرین	سكرين
سکرێ	سكر
سکوت	سكوت
سکۆت	سكوت
سکی	سكي
سکەی	سكي
سۆدیۆم	صوديوم
سۆران	ثوران
سۆفی	صوفي
سۆفیا	صوفيا
سۆل	سول
سۆلی	سولي
سۆما	صوما
سۆمال	صومال
سۆماڵ	صومال
سۆماڵی	صومالي
سۆمەر	سومر
سۆن	صون
سۆنی	صوني
سۆڤیەت	سوويت
سۆیا	صويا
سی	سي
سیئۆل	سيول
سیا	سيا
سیاسی	صياصي
سیاسیە	صياصي
سیان	سيان
سیبا	ثيبا
سیحەت	سيحت
سید	صيد
سیدا	سيدا
سیدان	صيدان
سیدی	صيدي
سیر	سير
سیرا	سيرا
سیریێ	سيري
سیستم	سيستم
سیستمە	سيستم
سیستەم	سيستم
سیستەمێ	سيستم
سیستەمە	سيستم
سیفر	صفر
سیفەت	صيفت
سیل	ثيل
سیلڤا	سيلوا
سیلی	سيلي
سیم	صيم
سیما	سيما
سین	سين
سینا	صينا
سیناتۆر	سيناتور
سیناریۆ	سيناريو
سینان	سينان
سینما	سينما
سینی	صيني
سینەما	سينما
سیڤان	صيوان
سیۆل	سيول
سیێ	سي
سیێنا	صينا
سێ	ث
سێبەر	سبر
سێبەری	صبري
سێت	ست
سێتار	ستار
سێجا	ثجا
سێدا	سدا
سێدارە	صدار
سێر	سر
سێرت	صرط
سێرجی	سرجي
سێری	ثري
سێل	سل
سێمێل	سمل
سێمێلی	سملي
سێمێلێ	سمل
سێمێڵ	سمل
سێنت	سنط
سێهەم	سهم
سێو	صو
سێودین	صودين
سێوسێنان	سوسنان
سێوی	سوي
سێوەی	سوي
سێڵ	سل
سێی	سي
سێیان	سيان
سێیێ	سي
سێیە	سي
سێیەم	صيم
سێیەمە	صيم
سەبا	صبا
سەباح	صباح
سەباحەت	صباحت
سەباغ	صباغ
سەبر	سبر
سەبری	صبري
سەتا	سطا
سەتار	ستار
سەجاد	سجاد
سەحنە	صحن
سەحوە	صحو
سەحوەو	صحو
سەحەر	سحر
سەحەری	سحري
سەخت	سخط
سەختە	سخط
سەد	سد
سەدا	سدا
سەدام	ثدام
سەدان	سدان
سەدر	سدر
سەدرن	سدرن
سەدری	صدري
سەدرە	سدر
سەدی	ثدي
سەدیر	سدير
سەدیق	صديق
سەدە	سد
سەدەما	صدما
سەدەی	ثدي
سەدەیا	صديا
سەر	سر
سەرا	صرا
سەراج	سراج
سەران	صران
سەرب	سرب
سەربی	صربي
سەربە	سرب
سەردا	صردا
سەردان	صردان
سەردانە	صردان
سەرف	صرف
سەرفی	صرفي
سەرم	صرم
سەرما	صرما
سەرمان	صرمان
سەرمەد	سرمد
سەرو	سرو
سەروو	سرو
سەروەت	ثروت
سەروەر	سرور
سەرک	سرك
سەرۆ	سرو
سەری	ثري
سەریان	سريان
سەرێ	سر
سەرە	سر
سەرەتا	سرطا
سەرەوت	ثروت
سەرەوە	سرو
سەرەک	سرك
سەعد	صعد
سەعدون	سعدون
سەعدوون	سعدون
سەعدی	صعدي
سەعدیە	صعدي
سەعودی	سعودي
سەعید	صعيد
سەعەد	صعد
سەغیر	صغير
سەفا	صفا
سەفار	سفار
سەفوان	صفوان
سەفوەت	صفوت
سەفیر	سفير
سەفین	سفين
سەفەر	سفر
سەفەری	سفري
سەفەرەی	سفري
سەقا	سقا
سەقفی	ثقفي
سەقەر	سقر
سەلاح	سلاح
سەلاحی	صلاحي
سەلام	سلام
سەلبی	سلبي
سەلجەن	ثلجن
سەلما	ثلما
سەلمان	ثلمان
سەلوا	صلوا
سەلوان	سلوان
سەلیم	سليم
سەلەفی	سلفي
سەم	ثم
سەما	صما
سەمفۆنی	سمفوني
سەمیر	سمير
سەمیرە	سمير
سەمیع	سميع
سەمین	سمين
سەمەد	صمد
سەمەدی	صمدي
سەن	سن
سەنا	صنا
سەناعە	صناع
سەنت	سنط
سەنتوور	سنطور
سەنتی	ثنتي
سەند	سند
سەندوق	صندوق
سەندەی	سندي
سەنعا	صنعا
سەنی	ثني
سەنەد	سند
سەنەدی	سندي
سەهم	سهم
سەهۆڵ	سهول
سەهیم	سهيم
سەهەم	سهم
سەوا	سوا
سەواد	سواد
سەودا	صودا
سەورە	ثور
سەورەی	سوري
سەڕ	سر
سەکتەی	سكتي
سەکران	سكران
سەڵاح	سلاح
سەڵاحی	صلاحي
سەڵت	سلط
سەیاد	صياد
سەید	صيد
سەیدا	سيدا
سەیدی	صيدي
سەیر	سير
سەیران	ثيران
سەیری	سيري
سەیرە	سير
سەیف	سيف
سەیفی	صيفي
سەیوان	صيوان
شاتێر	شاطر
شاخ	شاخ
شاد	شاد
شادان	شادان
شادی	شادي
شار	شار
شارلۆت	شارلوت
شاری	شاري
شاریا	شاريا
شاریان	شاريان
شارێک	شارك
شارێکی	شاركي
شارە	شار
شارەبان	شاربان
شارەدێ	شارد
شارەن	شارن
شارەکان	شاركان
شارەکە	شارك
شارەکەی	شاركي
شارەکەیە	شاركي
شارەی	شاري
شارەیان	شاريان
شارەیە	شاري
شاز	شاذ
شالیت	شاليط
شام	شام
شامل	شامل
شامی	شامي
شان	شان
شانا	شانا
شانە	شان
شاهد	شاهد
شاهی	شاهي
شاهین	شاهين
شاهێد	شاهد
شاهێدی	شاهدي
شاکر	شاكر
شاکەلی	شاكلي
شای	شاي
شب	شب
شبیب	شبيب
شت	شت
شتانە	شتان
شتمان	شتمان
شتۆن	شتون
شتی	شتي
شتیان	شتيان
شتێ	شت
شتە	شت
شتەی	شتي
شدا	شدا
شریف	شريف
شرین	شرين
شرێک	شرك
شفیق	شفيق
شل	شل
شلی	شلي
شمال	شمال
شمولی	شمولي
شهاب	شهاب
شهر	شهر
شواری	شواري
شوت	شوت
شوتی	شوطي
شود	شود
شورا	شورا
شورتە	شورت
شوشتن	شوشتن
شوشە	شوش
شوشەی	شوشي
شوقی	شوقي
شوقەی	شوقي
شون	شون
شوو	شو
شووتی	شوطي
شوور	شوور
شووشە	شوش
شووشەی	شوشي
شووی	شوي
شوڕتە	شورت
شوکت	شوكت
شوین	شوين
شوێن	شون
شوێنانە	شونان
شوێنن	شونن
شوێنی	شوني
شوێنێ	شون
شوێنە	شون
شوێنەی	شوني
شک	شك
شکا	شكا
شکان	شكان
شکر	شكر
شکست	شكست
شکور	شكور
شکۆ	شكو
شۆر	شور
شۆرین	شورين
شۆن	شون
شۆک	شوك
شی	شي
شیا	شيآ
شیان	شيان
شیخ	شيخ
شیر	شير
شیراز	شيراز
شیراک	شيراك
شیرین	شيرين
شیش	شيش
شیعی	شيعي
شیعە	شيع
شیعەن	شيعن
شیعەی	شيعي
شیعەیە	شيعي
شیلا	شيلا
شیلان	شيلان
شیلی	شيلي
شیلەی	شيلي
شین	شين
شینە	شين
شیوعی	شيوعي
شێت	شت
شێتی	شتي
شێخ	شخ
شێخان	شخان
شێخی	شخي
شێخە	شخ
شێر	شر
شێری	شري
شێرێ	شر
شێرەی	شري
شێست	شصت
شێعر	شعر
شێعری	شعري
شێل	شل
شێن	شن
شێنێ	شن
شێواز	شواظ
شێوازێ	شواظ
شێوازە	شواظ
شێوێ	شو
شێوە	شو
شێوەش	شوش
شێوەو	شو
شێوەکی	شوكي
شێوەکێ	شوك
شێوەکەی	شوكي
شێوەی	شوي
شێوەیان	شويان
شێوەیێ	شوي
شێوەیە	شوي
شێوەیەن	شوين
شەباب	شباب
شەبیب	شبيب
شەبەک	شبك
شەبەکی	شبكي
شەبەکەی	شبكي
شەترەنج	شطرنج
شەحن	شحن
شەخسی	شخصي
شەدا	شدا
شەر	شر
شەربەت	شربت
شەرع	شرع
شەرعی	شرعي
شەرق	شرق
شەرقی	شرقي
شەرم	شرم
شەرو	شرو
شەرۆ	شرو
شەری	شري
شەریف	شريف
شەریک	شريك
شەرێ	شر
شەرێکی	شركي
شەرەف	شرف
شەرەفی	شرفي
شەرەم	شرم
شەزا	شذا
شەست	شصت
شەعب	شعب
شەعبان	شعبان
شەعبی	شعبي
شەعلان	شعلان
شەفاف	شفاف
شەفیع	شفيع
شەفیق	شفيق
شەفەق	شفق
شەق	شق
شەلا	شلا
شەلال	شلال
شەم	شم
شەماخ	شماخ
شەمال	شمال
شەماڵ	شمال
شەمس	شمس
شەمسی	شمسي
شەمعون	شمعون
شەممە	شمم
شەممەی	شممي
شەمیێ	شمي
شەمە	شم
شەمەر	شمر
شەمەری	شمري
شەمەی	شمي
شەهاب	شهاب
شەهر	شهر
شەهرام	شهرام
شەهرزاد	شهرزاد
شەهلا	شهلا
شەهناز	شهناز
شەهید	شهيد
شەهیدە	شهيد
شەهێن	شهن
شەو	شو
شەودا	شودا
شەوقی	شوقي
شەوکەت	شوكت
شەوی	شوي
شەوێک	شوك
شەوێکی	شوكي
شەوەدا	شودا
شەڕ	شر
شەڕدا	شردا
شەڕمان	شرمان
شەڕو	شرو
شەڕی	شري
شەڕیان	شريان
شەڕێ	شر
شەڕێک	شرك
شەڕێکی	شركي
شەڕە	شر
شەڕەدا	شردا
شەڕەکان	شركان
شەڕەکە	شرك
شەڕەکەی	شركي
شەڕەی	شري
شەڤ	شو
شەڤا	شوا
شەڤێ	شو
شەکر	شكر
شەکرە	شكر
شەکیب	شكيب
شەیتان	شيطان
شەیخی	شيخي
شەیدا	شيدا
شەین	شين
عابد	عابد
عاج	عاج
عادل	عادل
عادڵ	عادل
عارف	عارف
عارفێ	عارف
عارەب	عارب
عاسف	عاسف
عاسم	عاصم
عاسی	عاصي
عاشق	عاشق
عاشور	عاشور
عاشوور	عاشور
عالمی	عالمي
عالی	عالي
عالەم	عالم
عامر	عامر
عامل	عامل
عاملی	عاملي
عامێر	عامر
عانی	عاني
عباس	عباس
عبد	عبد
عبور	عبور
عبید	عبيد
عدنان	عدنان
عراق	عراق
عرب	عرب
عرفان	عرفان
عروبە	عروب
عروس	عروس
عزت	عزت
عزیز	عزيز
عزەت	عزت
عسام	عصام
عسمەت	عصمت
عشق	عشق
علو	علو
علوم	علوم
علی	علي
علیکم	عليكم
عماد	عماد
عمر	عمر
عمران	عمران
عود	عود
عودەی	عودي
عولا	عولا
عومان	عومان
عونی	عوني
عوود	عوود
عیزەت	عيذت
عیسا	عيثا
عیسی	عيثي
عێرا	عرا
عێراق	عراق
عێراقێ	عراق
عێراقە	عراق
عێرق	عرق
عێرقی	عرقي
عێززەت	عززت
عێزەت	عزت
عێڕاق	عراق
عەباس	عباث
عەباسی	عباسي
عەبد	عبد
عەبدی	عبدي
عەبود	عبود
عەتا	عطا
عەتار	عطار
عەتری	عطري
عەتوف	عطوف
عەتیە	عتي
عەجرەم	عجرم
عەدل	عدل
عەدلی	عدلي
عەدنان	عدنان
عەدەن	عدن
عەدەنی	عدني
عەرب	عرب
عەربی	عربي
عەربەت	عربت
عەریف	عريف
عەرەب	عرب
عەرەبدا	عربدا
عەرەبن	عربن
عەرەبی	عربي
عەرەبیە	عربي
عەرەبە	عرب
عەرەفات	عرفات
عەزام	عظام
عەزیز	عزيز
عەزیم	عزيم
عەسائب	عصاب
عەساف	عساف
عەسر	عصر
عەسری	عصري
عەسکەر	عسكر
عەسکەری	عسكري
عەسەل	عسل
عەشق	عشق
عەفان	عفان
عەقار	عقار
عەقاری	عقاري
عەقڵ	عقل
عەقڵی	عقلي
عەقید	عقيد
عەقیل	عقيل
عەلا	علا
عەلاوی	علاوي
عەلمانی	علماني
عەلوەی	علوي
عەلی	علي
عەلیان	عليان
عەلەم	علم
عەلەوی	علوي
عەلەیان	عليان
عەمار	عمار
عەمارە	عمار
عەمان	عمان
عەمر	عمر
عەمرو	عمرو
عەمری	عمري
عەمرە	عمر
عەمرەی	عمري
عەممان	عممان
عەمید	عميد
عەمەر	عمر
عەمەلی	عملي
عەنان	عنان
عەنتاب	عنتاب
عەنتەر	عنتر
عەهد	عهد
عەواد	عواد
عەوادی	عوادي
عەونی	عوني
عەوڵا	عولا
عەڕەب	عرب
عەڕەبی	عربي
عەڕەفات	عرفات
عەیار	عيار
عەین	عين
عەینی	عيني
غاز	غاز
غازی	غازي
غالب	غالب
غانا	غانا
غانم	غانم
غریب	غريب
غرێب	غرب
غرێبی	غربي
غفور	غفور
غلام	غلام
غیابی	غيابي
غێت	غط
غێدان	غدان
غەدر	غدر
غەدیر	غدير
غەراف	غراف
غەرافە	غراف
غەرامە	غرام
غەرامەی	غرامي
غەرب	غرب
غەربی	غربي
غەریب	غريب
غەزال	غزال
غەززە	غضض
غەززەی	غضضي
غەزە	غض
غەزەل	غزل
غەزەو	غزو
غەزەی	غذي
غەسان	غسان
غەفار	غفار
غەفور	غفور
غەفوور	غفور
غەلیون	غليون
غەم	غم
غەنی	غني
غەوسی	غوصي
غەیدان	غيدان
غەیری	غيري
فؤاد	فؤاد
فائق	فائق
فاتح	فاتح
فاتحی	فاتحي
فاتیکان	فاتيكان
فاتێ	فات
فاخر	فاخر
فارابی	فارابي
فارس	فارس
فارسی	فارسي
فاروق	فاروق
فاروقی	فاروقي
فارووق	فاروق
فازل	فاضل
فازڵ	فاضل
فاس	فاس
فاسۆ	فاسو
فالح	فالح
فاو	فاو
فاکس	فاكس
فاید	فايد
فایز	فايز
فایق	فايق
فایەق	فايق
فبرایر	فبراير
فبرایەر	فبراير
فتاح	فتاح
فتوا	فتوا
فرات	فرات
فراس	فراس
فراق	فراق
فرانسیس	فرانسيس
فرانکلین	فرانكلين
فرانکۆ	فرانكو
فرت	فرت
فرج	فرج
فرحان	فرحان
فرسەت	فرست
فرش	فرش
فرقەی	فرقي
فرهاد	فرهاد
فرۆش	فروش
فری	فري
فریا	فريا
فرید	فريد
فریش	فريش
فریق	فريق
فرین	فرين
فرێ	فر
فرێد	فرد
فرێدانی	فرداني
فرێدی	فردي
فرێس	فرس
فرە	فر
فرەنسا	فرنسا
فستق	فستق
فقی	فقي
فلستین	فلسطين
فلستینی	فلسطيني
فلم	فلم
فلما	فلما
فلمێ	فلم
فلمێن	فلمن
فلکلوری	فلكلوري
فندی	فندي
فنلەندا	فنلندا
فهمی	فهمي
فوت	فوت
فوزی	فوزي
فولکلوری	فولكلوري
فڕانکۆ	فرانكو
فڕی	فري
فڕین	فرين
فڕێ	فر
فڕێدانی	فرداني
فڕەنسا	فرنسا
فکری	فكري
فۆر	فور
فۆرت	فورط
فۆلکلۆر	فولكلور
فۆلکلۆرە	فولكلور
فی	في
فیتوو	فيتو
فیدرالی	فيدرالي
فیدراڵی	فيدرالي
فیدڕالی	فيدرالي
فیدڕاڵی	فيدرالي
فیر	فير
فیش	فيش
فیل	فيل
فیلم	فيلم
فیلمی	فيلمي
فیلمە	فيلم
فیلمەی	فيلمي
فیلمەیە	فيلمي
فیلی	فيلي
فیلیب	فيليب
فێدراڵی	فدرالي
فێر	فر
فێرس	فرس
فێری	فري
فێرێر	فرر
فێست	فصت
فێنک	فنك
فێڵ	فل
فێڵی	فلي
فەتات	فتات
فەتاح	فتاح
فەتح	فتح
فەتحی	فتحي
فەتوا	فتوا
فەجر	فجر
فەجری	فجري
فەحس	فحص
فەخری	فخري
فەر	فر
فەرج	فرج
فەرحان	فرحان
فەرد	فرد
فەردا	فردا
فەرز	فرض
فەرزی	فرزي
فەرسەت	فرست
فەرش	فرش
فەرشی	فرشي
فەرق	فرق
فەرنسا	فرنسا
فەرهاد	فرهاد
فەرید	فريد
فەریق	فريق
فەرەج	فرج
فەرەجی	فرجي
فەرەح	فرح
فەرەنسا	فرنسا
فەزل	فظل
فەزلی	فضلي
فەزڵ	فظل
فەزیلە	فضيل
فەسڵ	فسل
فەقی	فقي
فەقیر	فقير
فەقێ	فق
فەلاح	فلاح
فەلستین	فلسطين
فەلستینی	فلسطيني
فەلسەفی	فلسفي
فەلسەفە	فلسف
فەلەکی	فلكي
فەن	فن
فەندی	فندي
فەنی	فني
فەهد	فهد
فەهمی	فهمي
فەهیم	فهيم
فەواز	فواز
فەوتان	فوطان
فەوج	فوج
فەوجی	فوجي
فەوزا	فوزا
فەوزی	فوزي
فەڕش	فرش
فەڕەنسا	فرنسا
فەککە	فكك
فەککەی	فككي
فەیاز	فياض
فەیروز	فيروز
فەیزی	فيضي
فەیسەل	فيصل
فەیسەڵ	فيصل
فەیلی	فيلي
قابیل	قابيل
قات	قات
قادر	قادر
قادری	قادري
قار	قار
قازان	قازان
قازی	قاضي
قاسم	قاسم
قاسمی	قاسمي
قانع	قانع
قانون	قانون
قانونی	قانوني
قانونێ	قانون
قانوون	قانون
قانوونی	قانوني
قاوەی	قاوي
قاڵی	قالي
قبول	قبول
قبوول	قبول
قبووڵ	قبول
قبوڵ	قبول
قرش	قرش
قرمز	قرمز
قرو	قرو
قسانە	قسان
قسە	قس
قسەم	قسم
قسەمان	قسمان
قسەو	قثو
قسەی	قسي
قسەیان	قسيان
قسەیە	قسي
قوت	قوت
قورئان	قوران
قورس	قورص
قورسە	قورص
قورنە	قورن
قوسەی	قوسي
قولی	قولي
قوم	قوم
قومی	قومي
قووڵ	قول
قووڵی	قولي
قوڕ	قور
قوڵ	قول
قوڵی	قولي
قوە	قو
قوەی	قوي
قۆلی	قولي
قۆڵ	قول
قۆڵۆن	قولون
قۆڵی	قولي
قیام	قيام
قیر	قير
قیست	قيست
قەبانی	قباني
قەبول	قبول
قەبوول	قبول
قەبووڵ	قبول
قەبوڵ	قبول
قەت	قط
قەتران	قطران
قەتەر	قطر
قەتەری	قطري
قەتەڕ	قطر
قەد	قد
قەدر	قدر
قەدری	قدري
قەدەر	قدر
قەدەری	قدري
قەدەم	قدم
قەرز	قرض
قەرزی	قرضي
قەرزە	قرض
قەرزەی	قرضي
قەزا	قضا
قەزاز	قذاذ
قەزوین	قزوين
قەساب	قصاب
قەستا	قسطا
قەسر	قصر
قەسری	قصري
قەسرێ	قصر
قەسەب	قصب
قەشە	قش
قەشەی	قشي
قەفەس	قفص
قەفەسا	قفصا
قەفەسی	قفصي
قەلا	قلا
قەلەم	قلم
قەلەمی	قلمي
قەمەر	قمر
قەنات	قنات
قەندیل	قنديل
قەهار	قهار
قەوارە	قوار
قەوارەی	قواري
قەوقاز	قوقاز
قەومی	قومي
قەڵا	قلا
قەڵەم	قلم
قەڵەمی	قلمي
قەڵەو	قلو
قەڵەون	قلون
قەڵەوی	قلوي
قەیس	قيص
قەیسی	قيسي
قەیسەر	قيصر
لئۆن	لون
لا	لا
لاتینی	لاتيني
لادا	لادا
لادان	لادان
لادن	لادن
لادێ	لاد
لادێی	لادي
لادەن	لادن
لازقیە	لاذقي
لاس	لاث
لاسلکی	لاسلكي
لاشەی	لاشي
لام	لام
لاما	لاما
لامی	لامي
لانە	لان
لاهای	لاهاي
لاهور	لاهور
لاوی	لاوي
لاین	لاين
لایێن	لاين
لایەن	لاين
لایەنان	لاينان
لایەنی	لايني
لایەنێ	لاين
لایەنێن	لاينن
لایەنە	لاين
لایەنەی	لايني
لایەنەیە	لايني
لبنان	لبنان
لبنانی	لبناني
لبنانێ	لبنان
لتر	لتر
لعێبی	لعبي
لق	لق
لقا	لقا
لقمان	لقمان
لقی	لقي
لقێ	لق
لم	لم
لهێبی	لهبي
لو	لو
لوئیز	لويز
لوئیس	لويس
لوئەی	لوي
لوت	لوت
لوتی	لوطي
لوس	لوث
لوسی	لوثي
لولا	لولا
لومت	لومت
لوو	لو
لووت	لوط
لووتی	لوطي
لووی	لوي
لوک	لوك
لوکا	لوكا
لوی	لوي
لویز	لويز
لویس	لويس
لوێ	لو
لڤین	لوين
لڤێ	لو
لۆبی	لوبي
لۆجستی	لوجستي
لۆرد	لورد
لۆس	لوث
لۆست	لوثت
لۆسی	لوثي
لۆف	لوف
لۆلا	لولا
لۆمەی	لومي
لۆهان	لوهان
لۆک	لوك
لۆکا	لوكا
لۆکەربی	لوكربي
لۆی	لوي
لی	لي
لیا	ليا
لیبرالی	ليبرالي
لیبراڵی	ليبرالي
لیبی	ليبي
لیبیا	ليبيا
لیتر	ليتر
لیدز	ليدز
لیزا	ليزا
لیسا	ليسا
لیست	ليست
لیستا	ليستا
لیستێ	ليست
لیستێن	ليستن
لیستە	ليست
لیل	ليل
لیلی	ليلي
لیما	ليما
لین	لين
لینا	لينا
لیون	ليون
لیۆن	ليون
لیۆنیل	ليونيل
لێ	ل
لێئۆنێ	لون
لێبدەن	لبدن
لێبکەن	لبكن
لێبێت	لبط
لێت	لط
لێتوانیا	لتوانيا
لێدا	لدا
لێدان	لدان
لێدێت	لدت
لێدەدا	لددا
لێدەدەن	لددن
لێم	لم
لێمان	لمان
لێنان	لنان
لێو	لو
لێوی	لوي
لێوە	لو
لێوەی	لوي
لێک	لك
لێکی	لكي
لێی	لي
لێیان	ليان
لێیە	لي
لێیەتی	ليتي
لە	ل
لەئاست	لاثت
لەئامێز	لامز
لەئاوی	لاوي
لەئاینی	لايني
لەئێستا	لصتا
لەئێوە	لو
لەئێوەو	لو
لەئەم	لم
لەئەو	لو
لەبا	لبا
لەبن	لبن
لەبیب	لبيب
لەبێ	لب
لەت	لط
لەتیف	لطيف
لەجۆن	لجون
لەجێ	لج
لەجێی	لجي
لەحەسەن	لحسن
لەحەفتا	لحفتا
لەحەما	لحما
لەحەوت	لحوت
لەخوا	لخوا
لەخوێن	لخون
لەخۆ	لخو
لەخەو	لخو
لەد	لد
لەدوا	لدوا
لەزێی	لذي
لەسان	لسان
لەسنە	لسن
لەسی	لصي
لەسێ	لص
لەسێی	لصي
لەسەتا	لصتا
لەعەلی	لعلي
لەق	لق
لەم	لم
لەمانە	لمان
لەمن	لمن
لەمیا	لميا
لەمین	لمين
لەمە	لم
لەندن	لندن
لەندەن	لندن
لەهی	لهي
لەهێزی	لهذي
لەهەست	لهثت
لەو	لو
لەوتەی	لوطي
لەوحەی	لوحي
لەوزەی	لوزي
لەوما	لوما
لەوی	لوي
لەوێ	لو
لەوێدا	لودا
لەوێن	لون
لەوێنەی	لوني
لەوێوە	لو
لەوە	لو
لەوەتەی	لوطي
لەوەدا	لودا
لەوەها	لوها
لەوەو	لو
لەوەی	لوي
لەک	لك
لەکان	لكان
لەکەم	لكم
لەی	لي
لەیس	ليس
لەیلی	ليلي
لەیەک	ليك
لەیەکێ	ليك
ما	ما
مائی	ماي
مات	مات
ماتا	ماتا
ماتیاس	ماتياس
ماجد	ماجد
مادام	مادام
ماددێ	مادد
ماددێن	ماددن
ماددە	مادد
مادلین	مادلين
مادی	مادي
مادێ	ماد
مادێن	مادن
مادە	ماد
مادەی	مادي
مادەیە	مادي
مادەەی	مادي
مار	مار
مارا	مارا
ماراسۆن	ماراثون
ماراسۆنە	ماراثون
مارتا	مارتا
مارتن	مارتن
مارس	مارس
مارسی	مارسي
مارشال	مارشال
مارشاڵ	مارشال
ماری	ماري
ماریا	ماريا
مارین	مارين
مارینا	مارينا
مارینز	مارينز
مارە	مار
مازن	مازن
مازی	ماضي
ماس	ماس
ماست	ماست
ماسی	مآسي
ماسێ	ماس
ماشێن	ماشن
مافیا	مافيا
مال	مال
مالا	مالا
مالاوی	مالاوي
مالتا	مالتا
مالک	مالك
مالکی	مالكي
مالی	مالي
مالیزی	ماليزي
مالیزیا	ماليزيا
مالێ	مال
مالێک	مالك
مان	مان
ماهر	ماهر
ماوی	مآوي
ماوێ	ماو
ماوە	ماو
ماوەو	ماو
ماوەی	مآوي
ماوەیێ	مآوي
ماوەیە	مآوي
ماڤی	مآوي
ماکس	ماكث
ماکسی	ماكسي
ماکین	ماكين
ماڵ	مال
ماڵتا	مالطا
ماڵی	مالي
ماڵێک	مالك
ماڵێکی	مالكي
ماڵە	مال
ماڵەکە	مالك
ماڵەکەی	مالكي
ماڵەی	مالي
مای	ماي
مایو	مايو
مایک	مايك
مایکل	مايكل
مایکڵ	مايكل
مایۆ	مايو
مایە	ماي
مایەوە	مايو
مایەوەو	مايو
ماە	ما
مبارک	مبارك
مبارەک	مبارك
مت	مت
متران	مطران
مجید	مجيد
محسن	محسن
محمد	محمد
محمود	محمود
محمەد	محمد
محی	محي
محەمەد	محمد
محەمەدە	محمد
مخمور	مخمور
مدحت	مدحت
مراد	مراد
مراسم	مراسم
مرد	مرد
مردن	مردن
مرز	مرض
مرن	مرن
مرنا	مرنا
مرنێ	مرن
مرکز	مركز
مرۆی	مروي
مری	مري
مریم	مريم
مریەم	مريم
مس	مس
مسافی	مصافي
مستند	مستند
مستەر	مسطر
مسر	مسر
مسری	مثري
مسرێ	مصر
مسعود	مسعود
مسقاڵ	مثقال
مسلم	مسلم
مش	مش
مشت	مشت
مشعەل	مشعل
مشک	مشك
مشکو	مشكو
مشکۆ	مشكو
مشیر	مشير
معروف	معروف
معەمەر	معمر
مفەوەز	مفوض
مقداد	مقداد
مل	مل
ملا	ملا
ملازم	ملازم
ملت	ملت
مللەت	مللت
مللەتێ	مللت
ملم	ملم
ململانێ	ململان
ملی	ملي
ملیار	مليار
ملیم	مليم
ملیمەتر	مليمتر
ملیون	مليون
ملیۆن	مليون
ملێ	مل
ملێون	ملون
ملێۆن	ملون
مم	مم
من	من
منا	منا
مناڵ	منال
منحەی	منحي
منن	منن
منی	مني
منیان	منيان
منێ	من
منە	من
مهدی	مهدي
مهر	مهر
مور	مور
موری	موري
موس	موس
موسا	موسا
موساد	موساد
موسل	موصل
موسلێ	موصل
موسکۆ	موسكو
موسڵ	موصل
موسڵن	موثلن
موسڵە	موصل
موسی	موصي
موشی	موشي
موشەک	موشك
موفق	موفق
موفەق	موفق
مولا	مولا
مولود	مولود
مومبای	مومباي
مون	مون
مونا	مونا
مونی	موني
موود	مود
مووسا	موسا
مووسل	موصل
مووسڵ	موصل
مووشەک	موشك
موون	مون
موونی	موني
موەفەق	موفق
مڕ	مر
مکوڕ	مكور
مۆتا	موتا
مۆتێل	موطل
مۆدیل	موديل
مۆر	مور
مۆرای	موراي
مۆری	موري
مۆریس	موريس
مۆز	موز
مۆسکۆ	موسكو
مۆسکۆی	موسكوي
مۆفق	موفق
مۆفەق	موفق
مۆلن	مولن
مۆلەت	مولت
مۆمبای	مومباي
مۆن	مون
مۆنا	مونا
مۆناکۆ	موناكو
مۆنتریال	مونتريال
مۆندیال	مونديال
مۆنی	موني
مۆڵ	مول
مۆڵن	مولن
مۆڵەت	مولت
مۆڵەتە	مولت
می	مي
میا	ميا
میامی	ميامي
میانمار	ميانمار
میت	ميت
میر	مير
میرا	ميرا
میرێ	مير
میرە	مير
میز	ميز
میساق	ميثاق
میسان	ميسان
میسر	ميسر
میسرە	ميسر
میسڕ	ميسر
میسی	ميسي
میشیل	ميشيل
میل	ميل
میلا	ميلا
میلاد	ميلاد
میلان	ميلان
میلانۆ	ميلانو
میلی	ميلي
میلەت	ميلت
مینا	مينا
میونخ	ميونخ
میکرۆب	ميكروب
مێ	م
مێترۆ	مترو
مێجەر	مجر
مێدەئا	مدا
مێر	مر
مێرد	مرد
مێردی	مردي
مێز	مذ
مێزی	مضي
مێسی	مسي
مێش	مش
مێشک	مشك
مێشکەوە	مشكو
مێل	مل
مێلی	ملي
مێن	من
مێهدی	مهدي
مێهر	مهر
مە	م
مەئمون	ممون
مەبستە	مبسط
مەبەست	مبسط
مەبەستێ	مبسط
مەبەستە	مبسط
مەت	مت
مەتر	متر
مەتران	مطران
مەترو	مترو
مەترە	متر
مەترەو	مترو
مەتی	مطي
مەتین	متين
مەجدی	مجدي
مەجنون	مجنون
مەجید	مجيد
مەجەر	مجر
مەجەری	مجري
مەحاڵ	محال
مەحاڵە	محال
مەحجوب	محجوب
مەحروس	محروس
مەحسود	محسود
مەحفوز	محفوظ
مەحمود	محمود
مەحموود	محمود
مەحمەد	محمد
مەحوی	محوي
مەحکوم	محكوم
مەحکووم	محكوم
مەحەمەد	محمد
مەحەک	محك
مەخمور	مخمور
مەخموور	مخمور
مەد	مد
مەدا	مدا
مەدحەت	مدحت
مەدرید	مدريد
مەدریدە	مدريد
مەدفەعی	مدفعي
مەدنی	مدني
مەدینە	مدين
مەدینەی	مديني
مەدەنی	مدني
مەر	مر
مەراح	مراح
مەراسیم	مراسيم
مەراسیمە	مراسيم
مەرام	مرام
مەرامی	مرامي
مەراکش	مراكش
مەرج	مرج
مەرجان	مرجان
مەرجانە	مرجان
مەرجی	مرجي
مەرجێن	مرجن
مەرجە	مرج
مەرجەی	مرجي
مەردان	مردان
مەردوم	مردوم
مەرزوق	مرزوق
مەرزی	مرضي
مەرسیلیا	مرسيليا
مەرعی	مرعي
مەرکەزی	مركزي
مەریخ	مريخ
مەرید	مريد
مەریەم	مريم
مەزاد	مزاد
مەزار	مضار
مەزاری	مذاري
مەزری	مزري
مەزن	مضن
مەزنا	مضنا
مەزنان	مضنان
مەزنی	مضني
مەزنێ	مضن
مەزنە	مضن
مەزهەب	مذهب
مەزهەر	مزهر
مەساج	مساج
مەسافی	مصافي
مەست	مست
مەسرور	مسرور
مەسروور	مسرور
مەسعود	مسعود
مەسعوود	مسعود
مەسعەب	مصعب
مەسقەت	مسقط
مەسیح	مسيح
مەسیحی	مسيحي
مەسەلانە	مثلان
مەسەلە	مثل
مەسەلەی	مثلي
مەشعەل	مشعل
مەشق	مشق
مەشقی	مشقي
مەشقە	مشق
مەشهەد	مشهد
مەعروف	معروف
مەعرووف	معروف
مەعسوم	معصوم
مەعسووم	معصوم
مەعسوومی	معصومي
مەعنەوی	معنوي
مەعنەوەی	معنوي
مەعەمەر	معمر
مەغرب	مغرب
مەغربی	مغربي
مەقام	مقام
مەقان	مقان
مەقدۆنیا	مقدونيا
مەل	مل
مەلا	ملا
مەلاریا	ملاريا
مەلیک	مليك
مەلە	مل
مەلەف	ملف
مەلەک	ملك
مەلەکان	ملكان
مەلەکی	ملكي
مەلەی	ملي
مەم	مم
مەمەد	ممد
مەن	من
مەنامە	منام
مەنتقی	منتقي
مەندی	مندي
مەندێس	مندس
مەنسور	منصور
مەنسوور	منصور
مەنهەجی	منهجي
مەها	مها
مەهان	مهان
مەهدی	مهدي
مەهین	مهين
مەهێ	مه
مەهێن	مهن
مەودا	مودا
مەولود	مولود
مەولوود	مولود
مەولەوی	مولوي
مەڕ	مر
مەڕو	مرو
مەڕی	مري
مەک	مك
مەکبێس	مكبس
مەکتوب	مكتوب
مەکتەب	مكتب
مەکس	مكث
مەکسیک	مكسيك
مەکسیکۆ	مكسيكو
مەکو	مكو
مەککە	مكك
مەککەی	مككي
مەکی	مكي
مەکین	مكين
مەکە	مك
مەکەن	مكن
مەی	مي
مەیا	ميا
مەیامی	ميامي
مەیدان	ميدان
مەیسون	ميسون
مەیسەم	ميسم
مەیل	ميل
مەیلی	ميلي
مەیمون	ميمون
مەیموون	ميمون
مەیێ	مي
مەیەر	مير
نابی	نابي
نابێ	ناب
نابێت	نابت
نابێتە	نابت
نابەجێ	نابج
ناجح	ناجح
ناجی	ناجي
ناحیە	ناحي
نادر	نادر
نادرێ	نادر
نادیا	ناديا
نادین	نادين
نادەم	نادم
نادەن	نادن
نادەین	نادين
ناز	ناض
نازری	ناظري
نازم	ناظم
نازک	نازك
نازی	نازي
نازێ	ناض
نازێری	ناظري
ناس	ناس
ناسا	ناسا
ناسح	ناسح
ناسر	ناثر
ناسرا	ناصرا
ناسری	ناصري
ناسریە	ناصري
ناسک	ناسك
ناسی	ناسي
ناشبێت	ناشبت
ناشێت	ناشط
ناعم	ناعم
ناف	ناف
نافع	نافع
نالی	نالي
نام	نام
ناما	ناما
نامق	نامق
ناموس	ناموس
نامووس	ناموس
نامێ	نام
نامێنێ	نامن
نامە	نام
نامەی	نامي
نامەیە	نامي
ناهێت	ناهت
ناوی	ناوي
ناوێرن	ناورن
ناوەوەی	ناوي
ناوەی	ناوي
ناڕەوا	ناروا
ناڤا	ناوآ
ناڤی	ناوي
ناکازاکی	ناكازاكي
ناکرێ	ناكر
ناڵێت	نالت
ناڵەی	نالي
نای	ناي
نایف	نايف
نایە	ناي
نبی	نبي
نجم	نجم
نجێفی	نجفي
ندارە	ندار
نرخ	نرخ
نرخی	نرخي
نرخە	نرخ
نرخەی	نرخي
نزا	نزا
نزار	نزار
نزم	نزم
نزمی	نظمي
نزمە	نظم
نزێک	نزك
نزێکەی	نزكي
نسار	نسار
نشب	نشب
نشین	نشين
نعمان	نعمان
نعمت	نعمت
نعمەت	نعمت
نغرۆ	نغرو
نقوم	نقوم
نما	نما
نمر	نمر
نمرە	نمر
نمرەی	نمري
نمونە	نمون
نموونە	نمون
نها	نها
نهۆم	نهوم
نهیان	نهيان
نو	نو
نوئێل	نول
نوبڵ	نوبل
نوح	نوح
نور	نور
نورا	نورا
نوری	نوري
نوستن	نوستن
نوسین	نوصين
نوسەر	نوسر
نوها	نوها
نوو	نو
نوور	نوور
نوورانی	نوراني
نووری	نوري
نووس	نوس
نووستن	نوسطن
نووسرا	نوصرا
نووسی	نوسي
نووسین	نوصين
نووسەر	نوسر
نووسەرە	نوسر
نوکەل	نوكل
نوی	نوي
نویا	نويا
نویێ	نوي
نویێن	نوين
نویە	نوي
نوێ	نو
نوێش	نوش
نوێم	نوم
نوێمان	نومان
نوێن	نون
نوێوە	نو
نوێی	نوي
نوێیان	نويان
نوێیانە	نويان
نوێیە	نوي
نوێێ	نو
نڤێسەر	نوسر
نڤێسەرێن	نوسرن
نۆ	نو
نۆئێل	نول
نۆبل	نوبل
نۆبڵ	نوبل
نۆرس	نورس
نۆرمەن	نورمن
نۆرەی	نوري
نۆسەد	نوسد
نۆلان	نولان
نۆڤا	نووا
نۆی	نوي
نۆێ	نو
نی	ني
نیا	نيا
نیازی	نيازي
نیان	نيان
نیت	نيط
نیجیریا	نيجيريا
نیس	نيس
نیسان	نيسان
نیسانێ	نيسان
نیشا	نيشا
نیشان	نيشان
نیشانە	نيشان
نیشتە	نيشت
نیقۆسیا	نيقوسيا
نیل	نيل
نیلسۆن	نيلسون
نیلووفەر	نيلوفر
نیم	نيم
نیما	نيما
نین	نين
نینە	نين
نیه	نيه
نیو	نيو
نیوتن	نيوتن
نیوجێرسی	نيوجرسي
نیودلهی	نيودلهي
نیودەلهی	نيودلهي
نیویۆرک	نيويورك
نیویۆرکی	نيويوركي
نیوە	نيو
نیڤ	نيو
نیکولا	نيكولا
نیکۆتین	نيكوتين
نیکۆل	نيكول
نیکۆلا	نيكولا
نیکۆڵ	نيكول
نیۆ	نيو
نیۆرک	نيورك
نیۆیۆرک	نيويورك
نیۆیۆرکێ	نيويورك
نیە	ني
نیەئەو	نيو
نیەتی	نيطي
نیەو	نيو
نێت	نت
نێد	ند
نێدا	ندا
نێر	نر
نێردەی	نردي
نێرن	نرن
نێرو	نرو
نێروەو	نرو
نێستا	نصتا
نێسۆن	نصون
نێو	نو
نێوی	نوي
نێوەی	نوي
نێڤ	نو
نە	ن
نەئەو	نو
نەبات	نبات
نەبرد	نبرد
نەبن	نبن
نەبو	نبو
نەبون	نبون
نەبونا	نبونا
نەبوو	نبو
نەبوون	نبون
نەبوونا	نبونا
نەبوونە	نبون
نەبووە	نبو
نەبوە	نبو
نەبۆ	نبو
نەبی	نبي
نەبیت	نبيت
نەبیل	نبيل
نەبین	نبين
نەبێ	نب
نەبێت	نبط
نەبێتە	نبط
نەبەرد	نبرد
نەبەز	نبذ
نەبەن	نبن
نەتوانین	نتوانين
نەتوانێ	نتوان
نەتەوا	نتوا
نەتەوی	نطوي
نەتەوێن	نتون
نەتەوە	نتو
نەتەوەبێ	نتوب
نەتەوەو	نتو
نەتەوەی	نطوي
نەتەوەیە	نطوي
نەجات	نجات
نەجاح	نجاح
نەجار	نجار
نەجاری	نجاري
نەجدەت	نجدت
نەجم	نجم
نەجمان	نجمان
نەجوا	نجوا
نەجیب	نجيب
نەجەف	نجف
نەجەفی	نجفي
نەخات	نخات
نەخاسم	نخاصم
نەختی	نخطي
نەخرێت	نخرت
نەخش	نخش
نەخشی	نخشي
نەخشێ	نخش
نەخشە	نخش
نەخشەی	نخشي
نەخۆن	نخون
نەخێر	نخر
نەدا	ندا
نەداری	نداري
نەدان	ندان
نەدانی	نداني
نەداوە	نداو
نەداوەو	نداو
نەدرا	ندرا
نەدرێ	ندر
نەدرێت	ندرت
نەدیم	نديم
نەدەدا	نددا
نەدەن	ندن
نەدەهێنا	ندهنا
نەدەین	ندين
نەرم	نرم
نەرمی	نرمي
نەرمین	نرمين
نەرویج	نرويج
نەرۆز	نروض
نەرێ	نر
نەرێنی	نرني
نەزار	نظار
نەزان	نزان
نەزانن	نزانن
نەزانێ	نزان
نەزاهە	نزاه
نەزاهەی	نضاهي
نەزمی	نظمي
نەزیر	نزير
نەزیف	نزيف
نەزەری	نظري
نەزەند	نزند
نەسار	نثار
نەسر	نسر
نەسری	نصري
نەسرین	نسرين
نەسیر	نصير
نەسیف	نسيف
نەسیم	نسيم
نەشئەت	نشط
نەشتەر	نشطر
نەشوان	نشوان
نەشیا	نشيا
نەشێت	نشط
نەعمەت	نعمت
نەعیم	نعيم
نەغەدە	نغد
نەفت	نفط
نەفتی	نفتي
نەفرتیتی	نفرتيتي
نەفرەت	نفرت
نەفەر	نفر
نەفەری	نفري
نەفەسی	نفسي
نەقدی	نقدي
نەقی	نقي
نەقیب	نقيب
نەقیبێ	نقيب
نەل	نل
نەم	نم
نەما	نما
نەمام	نمام
نەمان	نمان
نەمر	نمر
نەمری	نمري
نەمسا	نمسا
نەمساوی	نمساوي
نەمێنن	نمنن
نەمێنێ	نمن
نەنوێنن	ننونن
نەنێت	ننت
نەها	نها
نەهات	نهات
نەهی	نهي
نەهیان	نهيان
نەهێ	نه
نەهێشت	نهشت
نەهێشتن	نهشتن
نەهێلان	نهلان
نەهێلن	نهلن
نەهێنا	نهنا
نەهێنن	نهنن
نەهێڵن	نهلن
نەهێڵێت	نهلت
نەو	نو
نەوا	نوا
نەواز	نواز
نەواف	نواف
نەوال	نوال
نەوت	نوط
نەوتی	نوتي
نەوتە	نوط
نەوتەی	نوتي
نەوروز	نوروز
نەوروزێ	نوروز
نەورۆز	نوروز
نەورۆزێ	نوروز
نەورەس	نورس
نەوعی	نوعي
نەوەت	نوط
نەوەد	نود
نەوەدی	نودي
نەوەی	نوي
نەڕەی	نري
نەڤیا	نويا
نەکا	نكآ
نەکات	نكات
نەکر	نكر
نەکرا	نكرا
نەکران	نكران
نەکریە	نكري
نەکرێ	نكر
نەکرێت	نكرت
نەکرێن	نكرن
نەکو	نكو
نەکەت	نكت
نەکەم	نكم
نەکەن	نكن
نەکەون	نكون
نەکەین	نكين
نەی	ني
نەیار	نيار
نەیان	نيان
نەیجەر	نيجر
نەیەت	نيط
نەیەتە	نيط
ها	ها
هائیتی	هايتي
هات	هات
هاتم	هاتم
هاتی	هاتي
هاتین	هاتين
هاتینە	هاتين
هاتیە	هاتي
هاتە	هات
هاجەر	هاجر
هادی	هادي
هارت	هارت
هارون	هارون
هاری	هاري
هاریسۆن	هاريسون
هاس	هاث
هاشم	هاشم
هاشمی	هاشمي
هال	هال
هالک	هالك
هالی	هالي
هالە	هال
هام	هام
هان	هان
هانا	هانا
هانی	هاني
هانیبال	هانيبال
هاوای	هاواي
هاوشان	هاوشان
هاوەن	هاون
هاوەنی	هاوني
هاک	هاك
هاڵ	هال
هایتی	هايتي
هزار	هزار
هزر	هزر
هزرا	هزرا
هزرێ	هذر
هزرێن	هذرن
هشام	هشام
هلسنکی	هلسنكي
هلێن	هلن
همین	همين
هن	هن
هند	هند
هندۆراس	هندوراس
هندی	هندي
هندیە	هندي
هندێ	هند
هنری	هنري
هو	هو
هوا	هوا
هود	هود
هودا	هودا
هوزان	هوزان
هوسا	هوسا
هولا	هولا
هولی	هولي
هولیۆد	هوليود
هولێن	هولن
هولەندا	هولندا
هوما	هوما
هومەر	هومر
هومەن	هومن
هون	هون
هونەی	هوني
هوو	هو
هوود	هوود
هوور	هور
هوومەن	هومن
هوون	هوون
هۆ	هو
هۆرمۆنی	هورموني
هۆرە	هور
هۆز	هوز
هۆزان	هوزان
هۆزانێ	هوزان
هۆزی	هوزي
هۆش	هوش
هۆشی	هوشي
هۆل	هول
هۆلا	هولا
هۆلۆکۆست	هولوكوست
هۆلی	هولي
هۆلیود	هوليود
هۆلیوود	هوليود
هۆلیوودە	هوليود
هۆلیۆد	هوليود
هۆلێن	هولن
هۆلەندا	هولندا
هۆم	هوم
هۆمەر	هومر
هۆڵ	هول
هۆڵندا	هولندا
هۆڵی	هولي
هۆڵیوود	هوليود
هۆڵەندا	هولندا
هۆی	هوي
هی	هي
هیت	هيت
هیتی	هيطي
هیج	هيج
هیشتا	هيشتا
هیل	هيل
هیلاری	هيلاري
هیلی	هيلي
هیمن	هيمن
هیمەت	هيمت
هینان	هينان
هیڵ	هيل
هیڵی	هيلي
هێت	هت
هێتلەر	هتلر
هێدی	هدي
هێرتا	هرتا
هێرش	هرش
هێرشا	هرشا
هێرشان	هرشان
هێرشانە	هرشان
هێرشی	هرشي
هێرشێت	هرشت
هێرشێن	هرشن
هێرشە	هرش
هێرشەی	هرشي
هێرمان	هرمان
هێز	هز
هێزا	هذا
هێزانە	هذان
هێزی	هذي
هێزێت	هزت
هێزێن	هزن
هێزە	هز
هێزەی	هذي
هێشت	هشت
هێشتا	هشتا
هێل	هل
هێلا	هلا
هێلکە	هلك
هێلکەی	هلكي
هێلی	هلي
هێلێن	هلن
هێلێکی	هلكي
هێما	هما
هێمن	همن
هێمنانە	همنان
هێن	هن
هێنا	هنا
هێنان	هنان
هێنانە	هنان
هێند	هند
هێندی	هندي
هێندە	هند
هێندەی	هندي
هێنری	هنري
هێنەری	هنري
هێواش	هواش
هێور	هور
هێڕش	هرش
هێڕشی	هرشي
هێڤی	هوي
هێکتار	هكتار
هێڵ	هل
هێڵی	هلي
هێڵێکی	هلكي
هێڵە	هل
هێڵەکان	هلكان
هەاڵی	هالي
هەبن	هبن
هەبو	هبو
هەبوو	هبو
هەبوون	هبون
هەبوونا	هبونا
هەبووە	هبو
هەبوە	هبو
هەبوەو	هبو
هەبی	هبي
هەبیت	هبيت
هەبێ	هب
هەبێت	هبط
هەتا	هتا
هەر	هر
هەرا	هرا
هەردی	هردي
هەرس	هرس
هەرسک	هرسك
هەرسی	هرسي
هەرسێ	هرس
هەرسێک	هرسك
هەرمان	هرمان
هەروا	هروا
هەری	هري
هەریر	هرير
هەریس	هريس
هەرێم	هرم
هەرێما	هرما
هەرێمان	هرمان
هەرێمن	هرمن
هەرێمی	هرمي
هەرێمێ	هرم
هەرێمە	هرم
هەرێمەی	هرمي
هەرێی	هري
هەرە	هر
هەرەس	هرس
هەرەسی	هرسي
هەرەشەی	هرشي
هەزار	هزار
هەزارە	هزار
هەست	هست
هەستا	هستا
هەستم	هستم
هەستن	هستن
هەستە	هست
هەشت	هشت
هەشتا	هشتا
هەشتێ	هشت
هەشتەم	هشتم
هەفت	هفت
هەفتا	هفتا
هەفتێ	هفت
هەفتە	هفت
هەفتەم	هفتم
هەل	هل
هەلی	هلي
هەلێک	هلك
هەلێکی	هلكي
هەلەی	هلي
هەم	هم
هەمام	همام
هەمان	همان
هەمانە	همان
هەمزە	همز
هەمی	همي
هەمیا	هميا
هەمین	همين
هەمە	هم
هەمەدان	همدان
هەن	هن
هەند	هند
هەندی	هندي
هەندێ	هند
هەنە	هن
هەو	هو
هەوا	هوا
هەواڵێک	هوالك
هەور	هور
هەوری	هوري
هەول	هول
هەولا	هولا
هەولی	هولي
هەولێن	هولن
هەوڵ	هول
هەوڵانە	هولان
هەوڵی	هولي
هەوڵە	هول
هەوڵەی	هولي
هەوێ	هو
هەوێن	هون
هەوێنی	هوني
هەڕ	هر
هەڕێمی	هرمي
هەڕەشە	هرش
هەڕەشەن	هرشن
هەڕەشەی	هرشي
هەڤ	هو
هەڤدیتن	هوديتن
هەڤدیتنێ	هوديتن
هەڤرا	هورا
هەڵ	هل
هەڵم	هلم
هەڵی	هلي
هەڵێکی	هلكي
هەڵە	هل
هەڵەن	هلن
هەڵەکان	هلكان
هەڵەی	هلي
هەڵەیە	هلي
هەی	هي
هەیانە	هيان
هەیبەت	هيبت
هەیسەم	هيثم
هەیفا	هيفا
هەین	هين
هەیکەل	هيكل
هەیکەلی	هيكلي
هەیە	هي
هەیەئەم	هيم
هەیەبێ	هيب
هەیەتا	هيطا
هەیەتی	هيطي
هەێمی	همي
هەێنی	هني
و	و
وئێستا	وسطا
وا	وا
وائل	وائل
وائلی	والي
واتا	واطآ
واحد	واحد
وادا	وادا
وادی	وادي
وادەی	وادي
وادەیە	وادي
وار	وار
وارد	وارد
وارسۆ	وارسو
وارن	وارن
واری	واري
وارێ	وار
وارێن	وارن
واز	واز
وازی	وازي
وازیان	وازيان
واست	واست
واسق	واسق
واسیت	واسيت
واشنتن	واشنطن
واشنتون	واشنطون
واشنتۆن	واشنطون
واقع	واقع
واقعی	واقعي
وال	وال
والت	والت
والی	والي
وانی	واني
وانەی	واني
واڵ	وال
واڵت	والت
وبێ	وب
وبە	وب
وت	وط
وتا	وطا
وتار	وتار
وتن	وتن
وتنی	وطني
وتوون	وتون
وتی	وتي
وتێدا	وطدا
وتەی	وتي
وجدان	وجدان
ودی	ودي
ودێ	ود
ورد	ورد
وردی	وردي
وردە	ورد
ورمێ	ورم
وریا	وريا
ورەی	وري
وزاری	وزاري
وزە	وز
وزەو	وذو
وزەی	وذي
وساب	وثاب
وسام	وسام
وست	وست
وسمان	وسمان
وسێ	وص
وسێیەم	وسيم
وشک	وشك
وشە	وش
وشەکان	وشكان
وشەی	وشي
وشەیەک	وشيك
ول	ول
ولات	ولات
ولاتێ	ولات
ولاتە	ولات
ولی	ولي
ولید	وليد
ولە	ول
ولەم	ولم
ولەو	ولو
ومن	ومن
ون	ون
وهاب	وهاب
وهێزی	وهذي
وهەتا	وهتا
وهەوا	وهوا
ووت	وط
ووتار	وتار
ووتنی	وطني
ووتی	وتي
ووتەی	وتي
وود	وود
وودی	ودي
وورد	وورد
ووردی	وردي
وورک	ورك
ووزە	وز
ووزەو	وذو
ووزەی	وذي
ووشک	وشك
ووشەی	وشي
وولات	ولات
وون	ون
ووڵات	ولات
ووڵاتە	ولات
وڵات	ولات
وڵاتە	ولات
وۆتەر	ووتر
وۆرد	وورد
وۆلف	وولف
وۆڵف	وولف
وی	وي
ویس	ويس
ویل	ويل
ویلسۆن	ويلسون
ویلی	ويلي
ویلیام	ويليام
ویلیامز	ويليامز
وین	وين
ویێ	وي
ویێن	وين
وێ	و
وێب	وب
وێردی	وردي
وێرێ	ور
وێزەی	وذي
وێس	وص
وێست	وسط
وێل	ول
وێلزی	ولذي
وێن	ون
وێنێ	ون
وێنێن	ونن
وێنە	ون
وێنەی	وني
وێنەیان	ونيان
وێنەیێ	وني
وێنەیێن	ونين
وێنەیە	وني
وێڵ	ول
وە	و
وەئێستا	وسطا
وەبەر	وبر
وەتا	وطا
وەتەن	وطن
وەتەنی	وطني
وەجبەی	وجبي
وەحدە	وحد
وەحدەت	وحدت
وەحدەی	وحدي
وەحشی	وحشي
وەحید	وحيد
وەخت	وخط
وەختێ	وخط
وەدی	ودي
وەر	ور
وەرتێ	ورط
وەرشەی	ورشي
وەرعی	ورعي
وەرن	ورن
وەری	وري
وەریان	وريان
وەرەقەی	ورقي
وەزاری	وزاري
وەزعی	وضعي
وەزی	وذي
وەزیر	وزير
وەزیرێ	وزير
وەزیرە	وزير
وەزیفی	وظيفي
وەزیفەی	وظيفي
وەزەی	وذي
وەسا	وصا
وەستا	وسطا
وەستان	وسطان
وەسف	وصف
وەسفی	وثفي
وەسوف	وسوف
وەسڵی	وصلي
وەسەت	وسط
وەعد	وعد
وەغەرا	وغرا
وەفا	وفا
وەفدی	وفدي
وەفیق	وفيق
وەقفی	وقفي
وەلا	ولا
وەلات	ولات
وەلاتێ	ولات
وەلی	ولي
وەلیان	وليان
وەلید	وليد
وەلێ	ول
وەلەم	ولم
وەلەو	ولو
وەن	ون
وەهاب	وهاب
وەهابی	وهابي
وەهمی	وهمي
وەهەتا	وهتا
وەو	و
وەڕێ	ور
وەکی	وكي
وەڵات	ولات
وەی	وي
وەیس	ويس
ڕؤوف	رؤوف
ڕا	رآ
ڕائب	راب
ڕائد	راد
ڕاب	راب
ڕابن	رابن
ڕابیت	رابيت
ڕابین	رابين
ڕاد	راد
ڕادار	رادار
ڕادان	رادان
ڕادی	رادي
ڕادیو	راديو
ڕادیۆ	راديو
ڕادەی	رادي
ڕادەیە	رادي
ڕاز	راض
ڕازی	راضي
ڕازین	راضين
ڕاس	راص
ڕاست	راست
ڕاستە	راست
ڕاسل	راسل
ڕاسێل	راسل
ڕاش	راش
ڕاشد	راشد
ڕاشی	راشي
ڕاغب	راغب
ڕافد	رافد
ڕافع	رافع
ڕام	رام
ڕامی	رامي
ڕامین	رامين
ڕان	ران
ڕاهێنان	راهنان
ڕاهێنانێ	راهنان
ڕاوی	راوي
ڕایس	رايس
ڕحمان	رحمان
ڕحمن	رحمن
ڕحیم	رحيم
ڕزا	رضا
ڕستم	رستم
ڕستن	رثتن
ڕسول	رسول
ڕسومات	رسومات
ڕشاد	رشاد
ڕشتن	رشتن
ڕشو	رشو
ڕشید	رشيد
ڕفعت	رفعت
ڕفو	رفو
ڕفیق	رفيق
ڕق	رق
ڕقی	رقي
ڕقیب	رقيب
ڕمزی	رمزي
ڕوئیا	رويا
ڕواندا	رواندا
ڕوبن	روبن
ڕوبین	روبين
ڕوح	روح
ڕوحانی	روحاني
ڕوحی	روحي
ڕود	رود
ڕوز	روض
ڕوزی	روضي
ڕوس	روث
ڕوسی	روسي
ڕوسیا	روسيا
ڕوسیاو	روسياو
ڕول	رول
ڕولی	رولي
ڕولێ	رول
ڕولێن	رولن
ڕوما	روما
ڕومان	رومان
ڕومانی	روماني
ڕومانیا	رومانيا
ڕون	رون
ڕوناڵدۆ	رونالدو
ڕوو	رو
ڕووت	روت
ڕووحانی	روحاني
ڕووحی	روحي
ڕوودانێ	رودان
ڕووس	روث
ڕووسی	روسي
ڕووسیا	روسيا
ڕووسیاو	روسياو
ڕووم	روم
ڕوون	رون
ڕوونە	رون
ڕووی	روي
ڕوویان	رويان
ڕووە	رو
ڕووەک	روك
ڕوڵی	رولي
ڕوی	روي
ڕویان	رويان
ڕویێ	روي
ڕوەو	رو
ڕوەوە	رو
ڕک	رك
ڕکن	ركن
ڕۆب	روب
ڕۆبرت	روبرت
ڕۆبن	روبن
ڕۆبۆت	روبوت
ڕۆبۆتە	روبوت
ڕۆبین	روبين
ڕۆبێرت	روبرت
ڕۆبێن	روبن
ڕۆبەرت	روبرت
ڕۆتین	روتين
ڕۆتینی	روتيني
ڕۆح	روح
ڕۆحانی	روحاني
ڕۆحی	روحي
ڕۆد	رود
ڕۆز	روض
ڕۆزا	روضا
ڕۆس	روث
ڕۆسی	روسي
ڕۆسێل	روسل
ڕۆشن	روشن
ڕۆل	رول
ڕۆلا	رولا
ڕۆلی	رولي
ڕۆلێ	رول
ڕۆم	روم
ڕۆما	روما
ڕۆمان	رومان
ڕۆمانسی	رومانسي
ڕۆمانی	روماني
ڕۆمانیا	رومانيا
ڕۆمانێ	رومان
ڕۆمانە	رومان
ڕۆمانەی	روماني
ڕۆمی	رومي
ڕۆمەن	رومن
ڕۆن	رون
ڕۆنالدۆ	رونالدو
ڕۆناڵد	رونالد
ڕۆناڵدۆ	رونالدو
ڕۆک	روك
ڕۆڵ	رول
ڕۆڵی	رولي
ڕۆڵە	رول
ڕۆڵەی	رولي
ڕۆی	روي
ڕی	ري
ڕیا	ريا
ڕیاز	رياض
ڕیازی	رياضي
ڕیال	ريال
ڕیان	ريان
ڕیاڵ	ريال
ڕید	ريد
ڕیز	ريض
ڕیزا	ريضا
ڕیس	ريث
ڕیسوا	ريثوا
ڕیش	ريش
ڕیشە	ريش
ڕیشەی	ريشي
ڕیمی	ريمي
ڕین	رين
ڕیێس	ريث
ڕێ	ر
ڕێباز	رباض
ڕێبین	ربين
ڕێز	رز
ڕێزا	رضا
ڕێزان	رزان
ڕێزم	رزم
ڕێزمان	رزمان
ڕێزن	رزن
ڕێزو	رضو
ڕێزی	رضي
ڕێزیان	رضيان
ڕێزێ	رز
ڕێزێن	رزن
ڕێسا	رثا
ڕێمان	رمان
ڕێنما	رنما
ڕێو	رو
ڕێڤین	روين
ڕێک	رك
ڕێکا	ركا
ڕێکان	ركان
ڕێکی	ركي
ڕێکێ	رك
ڕێکێن	ركن
ڕێکەوت	ركوت
ڕێکەوتن	ركوتن
ڕێکەوتنە	ركوتن
ڕێی	ري
ڕێیا	ريا
ڕێیان	ريان
ڕەئس	رث
ڕەئی	ري
ڕەبان	ربان
ڕەبانی	رباني
ڕەبۆ	ربو
ڕەبیعە	ربيع
ڕەبیعەی	ربيعي
ڕەت	رت
ڕەتی	رتي
ڕەجەب	رجب
ڕەجەبی	رجبي
ڕەحمان	رحمان
ڕەحمەت	رحمت
ڕەحۆ	رحو
ڕەحیم	رحيم
ڕەحیمە	رحيم
ڕەخ	رخ
ڕەخسا	رخصا
ڕەخنێ	رخن
ڕەخنە	رخن
ڕەد	رد
ڕەدی	ردي
ڕەدیف	رديف
ڕەز	رز
ڕەزا	رضا
ڕەزاق	رزاق
ڕەزم	رزم
ڕەزو	رضو
ڕەزوان	رضوان
ڕەسام	رسام
ڕەستەن	رثتن
ڕەسمی	رسمي
ڕەسول	رسول
ڕەسوول	رسول
ڕەسووڵ	رسول
ڕەسووڵی	رسولي
ڕەسوڵ	رسول
ڕەسوڵی	رسولي
ڕەسەن	رسن
ڕەسەنن	رصنن
ڕەسەنی	رصني
ڕەسەنێ	رسن
ڕەش	رش
ڕەشاد	رشاد
ڕەشت	رشت
ڕەشدا	رشدا
ڕەشوان	رشوان
ڕەشی	رشي
ڕەشید	رشيد
ڕەشە	رش
ڕەشەوە	رشو
ڕەعد	رعد
ڕەفعەت	رفعت
ڕەفیق	رفيق
ڕەفەح	رفح
ڕەق	رق
ڕەقیب	رقيب
ڕەقەمی	رقمي
ڕەمادی	رمادي
ڕەمزی	رمزي
ڕەمەزان	رمضان
ڕەمەزانێ	رمضان
ڕەمەزانە	رمضان
ڕەها	رها
ڕەوا	روا
ڕەوت	روت
ڕەوتا	روتا
ڕەوش	روش
ڕەوشا	روشا
ڕەوشی	روشي
ڕەوشە	روش
ڕەوشەن	روشن
ڕەوشەی	روشي
ڕەوی	روي
ڕەوەز	روض
ڕەوەشی	روشي
ڕەوەند	روند
ڕەی	ري
ڕەیان	ريان
ڤارت	وارت
ڤاری	واري
ڤی	وي
ڤیلا	ويلا
ڤیلیام	ويليام
ڤین	وين
ڤێ	و
ڤێرا	ورآ
ڤێلا	ولا
ڤە	و
ڤەب	وب
ڤەد	ود
ڤەدیتن	وديتن
ڤەدێ	ود
ڤەل	ول
ڤەلەد	ولد
ڤەکر	وكر
ڤەکرن	وكرن
ڤەکرنا	وكرنا
ڤەکری	وكري
ڤەکەن	وكن
کابول	كابول
کابوڵ	كابول
کابۆل	كابول
کات	كات
کاتیوشا	كاتيوشا
کاتیۆشا	كاتيوشا
کاتێ	كات
کاتە	كات
کادر	كادر
کادرێ	كادر
کار	كار
کارئینان	كارينان
کارا	كارا
کارت	كارت
کارتۆن	كارتون
کارتە	كارت
کارتەر	كارتر
کارل	كارل
کارلوس	كارلوس
کارلۆ	كارلو
کارلۆس	كارلوس
کارم	كارم
کارمان	كارمان
کارن	كارن
کارڵ	كارل
کارۆلینا	كارولينا
کاری	كاري
کاریان	كاريان
کاریبی	كاريبي
کارین	كارين
کارینا	كارينا
کارێ	كار
کارێن	كارن
کارە	كار
کارەب	كارب
کارەبێ	كارب
کارەم	كارم
کارەمان	كارمان
کارەی	كاري
کارەیان	كاريان
کازخستان	كازخستان
کازم	كاظم
کازمە	كاظم
کازینۆ	كازينو
کاستا	كاستا
کاسۆلیک	كاثوليك
کاسی	كاسي
کاسێت	كاست
کافی	كافي
کال	كال
کالۆری	كالوري
کامل	كامل
کامڵ	كامل
کامیرا	كاميرا
کامیرون	كاميرون
کامیرۆن	كاميرون
کان	كان
کانون	كانون
کانێ	كان
کانە	كان
کاهێل	كاهل
کاوەی	كاوي
کاکاو	كاكاو
کاڵ	كال
کاڵا	كالا
کاڵی	كالي
کاڵێ	كال
کتاب	كتاب
کتی	كتي
کتێب	كتب
کتێبی	كتبي
کتێبە	كتب
کتێبەی	كتبي
کحول	كحول
کر	كر
کرا	كرا
کراس	كراث
کراسی	كراسي
کرام	كرام
کران	كران
کراوین	كراوين
کربوون	كربون
کردستان	كردستان
کردی	كردي
کردەی	كردي
کرس	كرس
کرم	كرم
کرمان	کرمان
کرملین	كرملين
کرمی	كرمي
کرن	كرن
کرنا	كرنا
کرنێ	كرن
کرو	كرو
کرواتی	كرواتي
کرواتیا	كرواتيا
کروز	كروز
کروو	كرو
کرۆ	كرو
کرۆز	كروز
کرۆم	كروم
کری	كري
کریم	كريم
کرین	كرين
کرینا	كرينا
کرینە	كرين
کریک	كريك
کریە	كري
کرێ	كر
کرێدان	كردان
کرێم	كرم
کرێن	كرن
کرێک	كرك
کرێی	كري
کشت	كشط
کشمیر	كشمير
کفاح	كفاح
کفری	كفري
کلارک	كلارك
کلاسیکی	كلاسيكي
کلدانی	كلداني
کلم	كلم
کلک	كلك
کلۆر	كلور
کلی	كلي
کلینتۆن	كلينتون
کلینیکی	كلينيكي
کلێسەی	كلسي
کم	كم
کمال	كمال
کهول	كهول
کو	كو
کوبا	كوبا
کوبای	كوباي
کوبرا	كوبرا
کوت	كوت
کوخ	كوخ
کور	كور
کوران	كوران
کورت	كورت
کورتە	كورت
کورسیەکی	كورسيكي
کوری	كوري
کوریا	كوريا
کورێ	كور
کورێن	كورن
کورە	كور
کورەی	كوري
کوفی	كوفي
کولومبیا	كولومبيا
کوم	كوم
کوما	كوما
کومیدی	كوميدي
کون	كون
کونی	كوني
کوو	كو
کووریا	كوريا
کوڕ	كور
کوڕان	كوران
کوڕن	كورن
کوڕی	كوري
کوڕە	كور
کوڕەی	كوري
کویت	كويت
کوین	كوين
کوێ	كو
کوێت	كوت
کوێر	كور
کوێری	كوري
کوێی	كوي
کوەیت	كويت
کوەیتی	كويتي
کوەێت	كوت
کڕی	كري
کڕین	كرين
کڵێسا	كلسا
کڵێسەی	كلسي
کۆ	كو
کۆئێن	كون
کۆت	كوت
کۆتا	كوتا
کۆد	كود
کۆدی	كودي
کۆر	كور
کۆرا	كورا
کۆرت	كورت
کۆری	كوري
کۆریا	كوريا
کۆستی	كوستي
کۆسرەت	كوثرت
کۆفی	كوفي
کۆلا	كولا
کۆلۆمبی	كولومبي
کۆلۆن	كولون
کۆم	كوم
کۆما	كوما
کۆمان	كومان
کۆمیدی	كوميدي
کۆن	كون
کۆنان	كونان
کۆنن	كونن
کۆنی	كوني
کۆنە	كون
کۆڕ	كور
کۆڕی	كوري
کۆڕێ	كور
کۆک	كوك
کۆکا	كوكا
کۆڵۆمبی	كولومبي
کۆڵۆن	كولون
کۆی	كوي
کۆیان	كويان
کۆیە	كوي
کی	كي
کیان	كيان
کیت	كيت
کیدمان	كيدمان
کیر	كير
کیری	كيري
کیس	كيس
کیسەی	كيسي
کیف	كيف
کیفن	كيفن
کیلو	كيلو
کیلومەتر	كيلومتر
کیلۆ	كيلو
کیلی	كيلي
کیمیاوی	كيمياوي
کین	كين
کینی	كيني
کینیا	كينيا
کینیدی	كينيدي
کێ	ك
کێبڵی	كبلي
کێبەریێ	كبري
کێت	كت
کێر	كر
کێری	كري
کێش	كش
کێشا	كشا
کێشان	كشان
کێشانە	كشان
کێشی	كشي
کێشێ	كش
کێشێن	كشن
کێشە	كش
کێشەکە	كشك
کێشەکەش	كشكش
کێشەی	كشي
کێشەیە	كشي
کێشەیەش	كشيش
کێف	كف
کێلی	كلي
کێلێ	كل
کێم	كم
کێمی	كمي
کێن	كن
کێنت	كنت
کێوی	كوي
کێڤین	كوين
کێڵی	كلي
کێی	كي
کێیت	كيت
کێیە	كي
کە	ك
کەئافرەت	كافرت
کەئاوی	كاوي
کەئیستا	كيستا
کەئێران	كران
کەئێستا	كثتا
کەئێمەش	كمش
کەئەبو	كبو
کەئەرکی	كركي
کەئەم	كم
کەئەمەش	كمش
کەئەمەی	كمي
کەئەو	كو
کەئەوەی	كوي
کەباس	كباس
کەبری	كبري
کەبوو	كبو
کەبڕوا	كبروا
کەبڕی	كبري
کەبۆ	كبو
کەبیر	كبير
کەبێ	كب
کەبە	كب
کەبەبێ	كبب
کەبەر	كبر
کەبەرەی	كبري
کەبەشی	كبشي
کەبەو	كبو
کەت	كت
کەتا	كتا
کەتاب	كتاب
کەتی	كتي
کەد	كد
کەدان	كدان
کەدوا	كدوا
کەدوو	كدو
کەدوێنێ	كدون
کەدەست	كدست
کەر	كر
کەرار	كرار
کەرت	كرت
کەرتێ	كرت
کەرتە	كرت
کەرستێن	كرستن
کەرواتی	كرواتي
کەرواتیا	كرواتيا
کەرکەدەن	كركدن
کەری	كري
کەریم	كريم
کەرەستێ	كرست
کەرەستە	كرست
کەرەم	كرم
کەرەمی	كرمي
کەرەوەی	كروي
کەس	كث
کەسا	كسا
کەسان	كثان
کەسانە	كثان
کەسبەی	كسبي
کەسدا	كسدا
کەسم	كثم
کەسن	كثن
کەسو	كسو
کەسوود	كسود
کەسی	كثي
کەسێ	كث
کەسێت	كثت
کەسێن	كثن
کەسە	كث
کەسەدا	كسدا
کەسەر	كسر
کەسەو	كسو
کەسەوە	كسو
کەسەی	كثي
کەش	كش
کەشان	كشان
کەشمیر	كشمير
کەشی	كشي
کەشێک	كشك
کەشە	كش
کەشەڕ	كشر
کەشەڕی	كشري
کەل	كل
کەلا	كلا
کەلها	كلها
کەلێن	كلن
کەلێوەی	كلوي
کەلێی	كلي
کەلە	كل
کەلەسێ	كلس
کەلەف	كلف
کەلەم	كلم
کەلەک	كلك
کەم	كم
کەمال	كمال
کەمالی	كمالي
کەمان	كمان
کەماڵ	كمال
کەماڵی	كمالي
کەمبۆدیا	كمبوديا
کەمدا	كمدا
کەممان	كممان
کەمن	كمن
کەمی	كمي
کەمین	كمين
کەمینە	كمين
کەمە	كم
کەن	كن
کەنا	كنا
کەناری	كناري
کەنان	كنان
کەندا	كندا
کەنعان	كنعان
کەنعانی	كنعاني
کەننا	كننا
کەنەدا	كندا
کەهی	كهي
کەهێزی	كهذي
کەهەم	كهم
کەهەن	كهن
کەهەوڵ	كهول
کەهەیە	كهي
کەو	كو
کەوت	كوت
کەوتبێت	كوتبت
کەوتە	كوت
کەوسەر	كوثر
کەوی	كوي
کەوێت	كوت
کەوێنەی	كوني
کەوەک	كوك
کەڕ	كر
کەڕوو	كرو
کەڕوون	كرون
کەڕووی	كروي
کەڕێ	كر
کەڕێز	كرز
کەڤن	كون
کەڤنێن	كونن
کەڵک	كلك
کەڵکم	كلكم
کەی	كي
کەیان	كيان
کەیت	كيت
کەیس	كيس
کەیسی	كيسي
کەیسە	كيس
کەیف	كيف
کەیفی	كيفي
کەین	كين
یا	يا
یابان	يابان
یابانی	ياباني
یادی	يادي
یاریێن	يارين
یاسر	ياسر
یاسری	ياسري
یاسین	ياسين
یاسەمین	ياسمين
یحیی	يحيي
یدا	يدآ
یش	يش
یشدا	يشدا
یشی	يشي
یشیان	يشيآن
یعقوب	يعقوب
یلینا	يلينا
ینایر	يناير
ینک	ينك
یه	يه
یوئێن	يون
یوتا	يوطا
یورۆ	يورو
یوری	يوري
یوسا	يوصا
یوسف	يوسف
یوسفی	يوسفي
یوسی	يوصي
یولیا	يوليا
یولیۆ	يوليو
یون	يون
یونان	يونان
یونس	يونس
یونیسکۆ	يونيسكو
یونیۆ	يونيو
یووسف	يوسف
یوونس	يونس
یۆتا	يوطا
یۆرو	يورو
یۆرک	يورك
یۆرۆ	يورو
یۆزێف	يوزف
یۆسف	يوسف
یۆسفی	يوسفي
یۆلیۆ	يوليو
یۆن	يون
یۆنان	يونان
یۆنس	يونس
یۆنیسکۆ	يونيسكو
یۆنیۆ	يونيو
یۆهان	يوهان
یۆڕانیۆم	يورانيوم
یۆڕانیۆم	يورانيومئا	آ
یێ	ي
یێن	ين
یە	ي
یەحیا	يحيا
یەد	يد
یەدەک	يدك
یەرموک	يرموك
یەرموکی	يرموكي
یەزد	يضد
یەزدان	يضدان
یەزیدی	يزيدي
یەشار	يشار
یەعقوب	يعقوب
یەعقووب	يعقوب
یەل	يل
یەلدا	يلدا
یەم	يم
یەمین	يمين
یەمینی	يميني
یەمەن	يمن
یەمەنی	يمني
یەمەنیان	يمنيان
یەن	ين
یەنایەر	يناير
یەنی	يني
یەهودی	يهودي
یەکان	يكان
یەکانە	يكان
یەکبوون	يكبون
یەکتر	يكتر
یەکترن	يكترن
یەکتری	يكتري
یەکترین	يكترين
یەکدا	يكدا
یەکدی	يكدي
یەکرن	يكرن
یەکسان	يكثان
یەکسەر	يكسر
یەکلا	يكلا
یەکم	يكم
یەکمان	يكمان
یەکن	يكن
یەکو	يكو
یەکێتێ	يكت
یەکەم	يكم
یەکەمدا	يكمدا
یەکەممان	يكممان
یەکەمن	يكمن
یەکەمی	يكمي
یەکەمین	يكمين
یەکەمە	يكم
یەکەو	يكو
یەکەوە	يكو
یەڵدا	يلدا
ەو	و
ەوە	و
ەوەتا	وطا